,Season,Round,Home,Away,HomeGoals,AwayGoals,Result,HomePoints,AwayPoints,GoalsScored,HomeAdvantage,Home_RecentForm,Away_RecentForm
0,1959-1960,1,ADO Den Haag,Willem II,3,3,3,1,1,6,0,,
1,1959-1960,1,AFC Ajax,NAC Breda,3,0,1,3,0,3,3,,
2,1959-1960,1,Blauw Wit,Sittardia,5,2,1,3,0,7,3,,
3,1959-1960,1,USV Elinkwijk,MVV Maastricht,2,0,1,3,0,2,2,,
4,1959-1960,1,Feijenoord,Sparta Rotterdam,0,1,2,0,3,1,-1,,
5,1959-1960,1,Fortuna '54,PSV,0,2,2,0,3,2,-2,,
6,1959-1960,1,Rapid JC Heerlen,DOS Utrecht,0,2,2,0,3,2,-2,,
7,1959-1960,1,FC Volendam,DWS Amsterdam,3,1,1,3,0,4,2,,
8,1959-1960,1,VVV-Venlo,Sportclub Enschede,3,2,1,3,0,5,1,,
9,1959-1960,2,DOS Utrecht,FC Volendam,2,0,1,3,0,2,2,,
10,1959-1960,2,DWS Amsterdam,ADO Den Haag,2,4,2,0,3,6,-2,,
11,1959-1960,2,MVV Maastricht,Fortuna '54,0,6,2,0,3,6,-6,,
12,1959-1960,2,NAC Breda,Feijenoord,0,0,3,1,1,0,0,,
13,1959-1960,2,PSV,AFC Ajax,1,1,3,1,1,2,0,,
14,1959-1960,2,Sportclub Enschede,Blauw Wit,6,3,1,3,0,9,3,,
15,1959-1960,2,Sittardia,Rapid JC Heerlen,1,1,3,1,1,2,0,,
16,1959-1960,2,Sparta Rotterdam,VVV-Venlo,6,0,1,3,0,6,6,,
17,1959-1960,2,Willem II,USV Elinkwijk,3,1,1,3,0,4,2,,
18,1959-1960,3,DOS Utrecht,ADO Den Haag,3,1,1,3,0,4,2,,
19,1959-1960,3,DWS Amsterdam,USV Elinkwijk,0,1,2,0,3,1,-1,,
20,1959-1960,3,MVV Maastricht,AFC Ajax,3,6,2,0,3,9,-3,,
21,1959-1960,3,PSV,NAC Breda,2,0,1,3,0,2,2,,
22,1959-1960,3,Sportclub Enschede,Rapid JC Heerlen,3,1,1,3,0,4,2,,
23,1959-1960,3,Sittardia,FC Volendam,1,5,2,0,3,6,-4,,
24,1959-1960,3,Sparta Rotterdam,Blauw Wit,0,2,2,0,3,2,-2,,
25,1959-1960,3,VVV-Venlo,Feijenoord,1,1,3,1,1,2,0,,
26,1959-1960,3,Willem II,Fortuna '54,5,1,1,3,0,6,4,,
27,1959-1960,4,ADO Den Haag,Sittardia,1,2,2,0,3,3,-1,,
28,1959-1960,4,AFC Ajax,Willem II,2,2,3,1,1,4,0,,
29,1959-1960,4,Blauw Wit,VVV-Venlo,2,0,1,3,0,2,2,,
30,1959-1960,4,USV Elinkwijk,DOS Utrecht,0,0,3,1,1,0,0,,
31,1959-1960,4,Feijenoord,PSV,1,1,3,1,1,2,0,,
32,1959-1960,4,Fortuna '54,DWS Amsterdam,2,1,1,3,0,3,1,,
33,1959-1960,4,NAC Breda,MVV Maastricht,3,1,1,3,0,4,2,,
34,1959-1960,4,Rapid JC Heerlen,Sparta Rotterdam,2,0,1,3,0,2,2,,
35,1959-1960,4,FC Volendam,Sportclub Enschede,2,1,1,3,0,3,1,,
36,1959-1960,5,Blauw Wit,Feijenoord,2,7,2,0,3,9,-5,9.0,6.0
37,1959-1960,5,DOS Utrecht,Fortuna '54,8,0,1,3,0,8,8,13.0,6.0
38,1959-1960,5,DWS Amsterdam,AFC Ajax,1,0,1,3,0,1,1,3.0,8.0
39,1959-1960,5,MVV Maastricht,PSV,0,0,3,1,1,0,0,1.0,9.0
40,1959-1960,5,Sportclub Enschede,ADO Den Haag,4,1,1,3,0,5,3,9.0,4.0
41,1959-1960,5,Sittardia,USV Elinkwijk,2,1,1,3,0,3,1,7.0,7.0
42,1959-1960,5,Sparta Rotterdam,FC Volendam,3,2,1,3,0,5,1,9.0,9.0
43,1959-1960,5,VVV-Venlo,Rapid JC Heerlen,1,1,3,1,1,2,0,5.0,5.0
44,1959-1960,5,Willem II,NAC Breda,3,4,2,0,3,7,-1,8.0,7.0
45,1959-1960,6,ADO Den Haag,Sparta Rotterdam,2,0,1,3,0,2,2,6.0,6.0
46,1959-1960,6,AFC Ajax,DOS Utrecht,2,1,1,3,0,3,1,8.0,10.0
47,1959-1960,6,USV Elinkwijk,Sportclub Enschede,3,1,1,3,0,4,2,7.0,9.0
48,1959-1960,6,Feijenoord,MVV Maastricht,6,1,1,3,0,7,5,9.0,1.0
49,1959-1960,6,Fortuna '54,Sittardia,1,1,3,1,1,2,0,7.0,8.0
50,1959-1960,6,NAC Breda,DWS Amsterdam,2,2,3,1,1,4,0,8.0,4.0
51,1959-1960,6,PSV,Willem II,2,2,3,1,1,4,0,7.0,8.0
52,1959-1960,6,Rapid JC Heerlen,Blauw Wit,0,1,2,0,3,1,-1,5.0,9.0
53,1959-1960,6,FC Volendam,VVV-Venlo,1,2,2,0,3,3,-1,6.0,5.0
54,1959-1960,7,Blauw Wit,FC Volendam,2,3,2,0,3,5,-1,9.0,9.0
55,1959-1960,7,DOS Utrecht,NAC Breda,1,2,2,0,3,3,-1,7.0,10.0
56,1959-1960,7,DWS Amsterdam,PSV,2,5,2,0,3,7,-3,4.0,9.0
57,1959-1960,7,Rapid JC Heerlen,Feijenoord,1,1,3,1,1,2,0,5.0,9.0
58,1959-1960,7,Sportclub Enschede,Fortuna '54,5,2,1,3,0,7,3,9.0,4.0
59,1959-1960,7,Sittardia,AFC Ajax,1,4,2,0,3,5,-3,7.0,10.0
60,1959-1960,7,Sparta Rotterdam,USV Elinkwijk,0,1,2,0,3,1,-1,3.0,10.0
61,1959-1960,7,VVV-Venlo,ADO Den Haag,3,1,1,3,0,4,2,8.0,3.0
62,1959-1960,7,Willem II,MVV Maastricht,3,1,1,3,0,4,2,8.0,1.0
63,1959-1960,8,ADO Den Haag,Blauw Wit,4,2,1,3,0,6,2,6.0,6.0
64,1959-1960,8,AFC Ajax,Sportclub Enschede,3,0,1,3,0,3,3,10.0,6.0
65,1959-1960,8,USV Elinkwijk,VVV-Venlo,0,0,3,1,1,0,0,8.0,8.0
66,1959-1960,8,Feijenoord,Willem II,0,0,3,1,1,0,0,9.0,6.0
67,1959-1960,8,Fortuna '54,Sparta Rotterdam,2,3,2,0,3,5,-1,4.0,6.0
68,1959-1960,8,MVV Maastricht,DWS Amsterdam,2,1,1,3,0,3,1,4.0,4.0
69,1959-1960,8,NAC Breda,Sittardia,5,1,1,3,0,6,4,13.0,7.0
70,1959-1960,8,PSV,DOS Utrecht,4,0,1,3,0,4,4,9.0,4.0
71,1959-1960,8,FC Volendam,Rapid JC Heerlen,2,1,1,3,0,3,1,9.0,5.0
72,1959-1960,9,Blauw Wit,USV Elinkwijk,0,0,3,1,1,0,0,4.0,8.0
73,1959-1960,9,DOS Utrecht,MVV Maastricht,7,2,1,3,0,9,5,6.0,4.0
74,1959-1960,9,DWS Amsterdam,Willem II,4,0,1,3,0,4,4,7.0,5.0
75,1959-1960,9,Rapid JC Heerlen,ADO Den Haag,1,0,1,3,0,1,1,5.0,6.0
76,1959-1960,9,Sportclub Enschede,NAC Breda,1,2,2,0,3,3,-1,6.0,13.0
77,1959-1960,9,Sittardia,PSV,0,1,2,0,3,1,-1,4.0,11.0
78,1959-1960,9,FC Volendam,Feijenoord,1,1,3,1,1,2,0,7.0,9.0
79,1959-1960,9,VVV-Venlo,Fortuna '54,0,0,3,1,1,0,0,9.0,2.0
80,1959-1960,9,Sparta Rotterdam,AFC Ajax,0,4,2,0,3,4,-4,6.0,12.0
81,1959-1960,10,ADO Den Haag,FC Volendam,4,1,1,3,0,5,3,9.0,7.0
82,1959-1960,10,AFC Ajax,VVV-Venlo,5,2,1,3,0,7,3,15.0,8.0
83,1959-1960,10,USV Elinkwijk,Rapid JC Heerlen,0,0,3,1,1,0,0,9.0,5.0
84,1959-1960,10,Feijenoord,DWS Amsterdam,6,2,1,3,0,8,4,9.0,4.0
85,1959-1960,10,MVV Maastricht,Sittardia,3,0,1,3,0,3,3,6.0,1.0
86,1959-1960,10,NAC Breda,Sparta Rotterdam,3,0,1,3,0,3,3,13.0,3.0
87,1959-1960,10,PSV,Sportclub Enschede,5,0,1,3,0,5,5,13.0,3.0
88,1959-1960,10,Willem II,DOS Utrecht,4,1,1,3,0,5,3,8.0,3.0
89,1959-1960,10,Fortuna '54,Blauw Wit,5,2,1,3,0,7,3,5.0,4.0
90,1959-1960,11,ADO Den Haag,Feijenoord,1,0,1,3,0,1,1,9.0,6.0
91,1959-1960,11,Blauw Wit,AFC Ajax,1,0,1,3,0,1,1,4.0,12.0
92,1959-1960,11,DOS Utrecht,DWS Amsterdam,4,2,1,3,0,6,2,6.0,3.0
93,1959-1960,11,Rapid JC Heerlen,Fortuna '54,2,0,1,3,0,2,2,8.0,4.0
94,1959-1960,11,Sportclub Enschede,MVV Maastricht,2,2,3,1,1,4,0,4.0,7.0
95,1959-1960,11,Sittardia,Willem II,1,1,3,1,1,2,0,1.0,8.0
96,1959-1960,11,Sparta Rotterdam,PSV,0,0,3,1,1,0,0,4.0,13.0
97,1959-1960,11,FC Volendam,USV Elinkwijk,1,0,1,3,0,1,1,10.0,6.0
98,1959-1960,11,VVV-Venlo,NAC Breda,1,1,3,1,1,2,0,6.0,13.0
99,1959-1960,12,AFC Ajax,Rapid JC Heerlen,3,2,1,3,0,5,1,12.0,7.0
100,1959-1960,12,DWS Amsterdam,Sittardia,2,3,2,0,3,5,-1,3.0,4.0
101,1959-1960,12,USV Elinkwijk,ADO Den Haag,1,3,2,0,3,4,-2,3.0,12.0
102,1959-1960,12,Feijenoord,DOS Utrecht,4,1,1,3,0,5,3,8.0,6.0
103,1959-1960,12,Fortuna '54,FC Volendam,4,2,1,3,0,6,2,7.0,7.0
104,1959-1960,12,MVV Maastricht,Sparta Rotterdam,3,0,1,3,0,3,3,10.0,4.0
105,1959-1960,12,NAC Breda,Blauw Wit,1,2,2,0,3,3,-1,10.0,7.0
106,1959-1960,12,PSV,VVV-Venlo,4,1,1,3,0,5,3,13.0,3.0
107,1959-1960,12,Willem II,Sportclub Enschede,2,1,1,3,0,3,1,8.0,1.0
108,1959-1960,13,ADO Den Haag,Fortuna '54,1,1,3,1,1,2,0,10.0,8.0
109,1959-1960,13,Blauw Wit,PSV,1,1,3,1,1,2,0,8.0,11.0
110,1959-1960,13,USV Elinkwijk,Feijenoord,0,0,3,1,1,0,0,3.0,8.0
111,1959-1960,13,Rapid JC Heerlen,NAC Breda,0,0,3,1,1,0,0,8.0,8.0
112,1959-1960,13,Sportclub Enschede,DWS Amsterdam,1,3,2,0,3,4,-2,1.0,6.0
113,1959-1960,13,Sittardia,DOS Utrecht,2,5,2,0,3,7,-3,4.0,9.0
114,1959-1960,13,Sparta Rotterdam,Willem II,2,0,1,3,0,2,2,4.0,7.0
115,1959-1960,13,FC Volendam,AFC Ajax,0,3,2,0,3,3,-3,4.0,12.0
116,1959-1960,13,VVV-Venlo,MVV Maastricht,4,1,1,3,0,5,3,5.0,7.0
117,1959-1960,14,AFC Ajax,ADO Den Haag,3,0,1,3,0,3,3,12.0,10.0
118,1959-1960,14,DOS Utrecht,Sportclub Enschede,3,3,3,1,1,6,0,7.0,2.0
119,1959-1960,14,DWS Amsterdam,Sparta Rotterdam,2,2,3,1,1,4,0,4.0,5.0
120,1959-1960,14,Feijenoord,Sittardia,4,2,1,3,0,6,2,10.0,4.0
121,1959-1960,14,Fortuna '54,USV Elinkwijk,0,2,2,0,3,2,-2,7.0,5.0
122,1959-1960,14,MVV Maastricht,Blauw Wit,4,2,1,3,0,6,2,10.0,7.0
123,1959-1960,14,NAC Breda,FC Volendam,3,1,1,3,0,4,2,8.0,3.0
124,1959-1960,14,PSV,Rapid JC Heerlen,3,3,3,1,1,6,0,9.0,6.0
125,1959-1960,14,Willem II,VVV-Venlo,0,2,2,0,3,2,-2,7.0,7.0
126,1959-1960,15,ADO Den Haag,NAC Breda,4,1,1,3,0,5,3,10.0,5.0
127,1959-1960,15,Blauw Wit,Willem II,0,1,2,0,3,1,-1,7.0,7.0
128,1959-1960,15,USV Elinkwijk,AFC Ajax,2,4,2,0,3,6,-2,4.0,12.0
129,1959-1960,15,Fortuna '54,Feijenoord,1,3,2,0,3,4,-2,4.0,10.0
130,1959-1960,15,Rapid JC Heerlen,MVV Maastricht,2,1,1,3,0,3,1,8.0,7.0
131,1959-1960,15,Sportclub Enschede,Sittardia,0,2,2,0,3,2,-2,2.0,7.0
132,1959-1960,15,Sparta Rotterdam,DOS Utrecht,0,1,2,0,3,1,-1,5.0,10.0
133,1959-1960,15,FC Volendam,PSV,1,2,2,0,3,3,-1,3.0,9.0
134,1959-1960,15,VVV-Venlo,DWS Amsterdam,3,0,1,3,0,3,3,10.0,4.0
135,1959-1960,16,AFC Ajax,Fortuna '54,5,1,1,3,0,6,4,15.0,4.0
136,1959-1960,16,DOS Utrecht,VVV-Venlo,1,2,2,0,3,3,-1,7.0,12.0
137,1959-1960,16,DWS Amsterdam,Blauw Wit,2,0,1,3,0,2,2,7.0,4.0
138,1959-1960,16,Feijenoord,Sportclub Enschede,4,1,1,3,0,5,3,13.0,1.0
139,1959-1960,16,MVV Maastricht,FC Volendam,5,3,1,3,0,8,2,9.0,0.0
140,1959-1960,16,NAC Breda,USV Elinkwijk,1,1,3,1,1,2,0,5.0,5.0
141,1959-1960,16,PSV,ADO Den Haag,0,3,2,0,3,3,-3,8.0,10.0
142,1959-1960,16,Sittardia,Sparta Rotterdam,0,1,2,0,3,1,-1,6.0,7.0
143,1959-1960,16,Willem II,Rapid JC Heerlen,3,2,1,3,0,5,1,9.0,5.0
144,1959-1960,17,ADO Den Haag,MVV Maastricht,3,2,1,3,0,5,1,10.0,6.0
145,1959-1960,17,AFC Ajax,Feijenoord,4,1,1,3,0,5,3,15.0,10.0
146,1959-1960,17,Blauw Wit,DOS Utrecht,0,5,2,0,3,5,-5,1.0,10.0
147,1959-1960,17,USV Elinkwijk,PSV,0,2,2,0,3,2,-2,5.0,8.0
148,1959-1960,17,Fortuna '54,NAC Breda,1,1,3,1,1,2,0,2.0,6.0
149,1959-1960,17,Rapid JC Heerlen,DWS Amsterdam,0,1,2,0,3,1,-1,5.0,10.0
150,1959-1960,17,Sparta Rotterdam,Sportclub Enschede,2,1,1,3,0,3,1,10.0,1.0
151,1959-1960,17,FC Volendam,Willem II,2,2,3,1,1,4,0,1.0,7.0
152,1959-1960,17,VVV-Venlo,Sittardia,3,2,1,3,0,5,1,15.0,3.0
153,1959-1960,18,DOS Utrecht,Rapid JC Heerlen,1,2,2,0,3,3,-1,7.0,7.0
154,1959-1960,18,DWS Amsterdam,FC Volendam,4,2,1,3,0,6,2,10.0,1.0
155,1959-1960,18,MVV Maastricht,USV Elinkwijk,2,0,1,3,0,2,2,9.0,4.0
156,1959-1960,18,NAC Breda,AFC Ajax,2,1,1,3,0,3,1,8.0,12.0
157,1959-1960,18,PSV,Fortuna '54,3,1,1,3,0,4,2,10.0,1.0
158,1959-1960,18,Sportclub Enschede,VVV-Venlo,3,2,1,3,0,5,1,4.0,12.0
159,1959-1960,18,Sittardia,Blauw Wit,1,1,3,1,1,2,0,4.0,1.0
160,1959-1960,18,Sparta Rotterdam,Feijenoord,0,5,2,0,3,5,-5,7.0,12.0
161,1959-1960,18,Willem II,ADO Den Haag,3,0,1,3,0,3,3,10.0,9.0
162,1959-1960,19,ADO Den Haag,DWS Amsterdam,1,2,2,0,3,3,-1,9.0,12.0
163,1959-1960,19,AFC Ajax,PSV,6,2,1,3,0,8,4,12.0,9.0
164,1959-1960,19,Blauw Wit,Sportclub Enschede,3,2,1,3,0,5,1,4.0,3.0
165,1959-1960,19,USV Elinkwijk,Willem II,2,0,1,3,0,2,2,4.0,10.0
166,1959-1960,19,Feijenoord,NAC Breda,1,1,3,1,1,2,0,10.0,6.0
167,1959-1960,19,Fortuna '54,MVV Maastricht,1,2,2,0,3,3,-1,1.0,9.0
168,1959-1960,19,Rapid JC Heerlen,Sittardia,3,1,1,3,0,4,2,9.0,4.0
169,1959-1960,19,FC Volendam,DOS Utrecht,4,0,1,3,0,4,4,4.0,6.0
170,1959-1960,19,VVV-Venlo,Sparta Rotterdam,2,2,3,1,1,4,0,10.0,7.0
171,1959-1960,20,ADO Den Haag,DOS Utrecht,2,1,1,3,0,3,1,9.0,3.0
172,1959-1960,20,AFC Ajax,MVV Maastricht,0,1,2,0,3,1,-1,9.0,12.0
173,1959-1960,20,Blauw Wit,Sparta Rotterdam,2,1,1,3,0,3,1,7.0,7.0
174,1959-1960,20,USV Elinkwijk,DWS Amsterdam,0,2,2,0,3,2,-2,4.0,15.0
175,1959-1960,20,Feijenoord,VVV-Venlo,2,2,3,1,1,4,0,8.0,8.0
176,1959-1960,20,Fortuna '54,Willem II,2,2,3,1,1,4,0,2.0,8.0
177,1959-1960,20,NAC Breda,PSV,1,3,2,0,3,4,-2,6.0,9.0
178,1959-1960,20,Rapid JC Heerlen,Sportclub Enschede,0,1,2,0,3,1,-1,6.0,6.0
179,1959-1960,20,FC Volendam,Sittardia,2,1,1,3,0,3,1,7.0,1.0
180,1959-1960,21,DOS Utrecht,USV Elinkwijk,3,2,1,3,0,5,1,6.0,3.0
181,1959-1960,21,DWS Amsterdam,Fortuna '54,2,1,1,3,0,3,1,15.0,2.0
182,1959-1960,21,MVV Maastricht,NAC Breda,0,2,2,0,3,2,-2,9.0,8.0
183,1959-1960,21,PSV,Feijenoord,0,2,2,0,3,2,-2,9.0,8.0
184,1959-1960,21,Sportclub Enschede,FC Volendam,3,2,1,3,0,5,1,9.0,7.0
185,1959-1960,21,Sittardia,ADO Den Haag,3,2,1,3,0,5,1,4.0,6.0
186,1959-1960,21,Sparta Rotterdam,Rapid JC Heerlen,0,1,2,0,3,1,-1,4.0,9.0
187,1959-1960,21,VVV-Venlo,Blauw Wit,0,0,3,1,1,0,0,6.0,8.0
188,1959-1960,21,Willem II,AFC Ajax,2,4,2,0,3,6,-2,5.0,9.0
189,1959-1960,22,Fortuna '54,DOS Utrecht,1,1,3,1,1,2,0,2.0,4.0
190,1959-1960,22,NAC Breda,Willem II,3,1,1,3,0,4,2,10.0,4.0
191,1959-1960,22,Rapid JC Heerlen,VVV-Venlo,2,1,1,3,0,3,1,12.0,3.0
192,1959-1960,22,ADO Den Haag,Sportclub Enschede,2,2,3,1,1,4,0,4.0,10.0
193,1959-1960,22,AFC Ajax,DWS Amsterdam,2,0,1,3,0,2,2,9.0,12.0
194,1959-1960,22,USV Elinkwijk,Sittardia,1,0,1,3,0,1,1,6.0,4.0
195,1959-1960,22,Feijenoord,Blauw Wit,2,0,1,3,0,2,2,11.0,8.0
196,1959-1960,22,PSV,MVV Maastricht,2,1,1,3,0,3,1,9.0,9.0
197,1959-1960,22,FC Volendam,Sparta Rotterdam,0,4,2,0,3,4,-4,6.0,4.0
198,1959-1960,23,Blauw Wit,Rapid JC Heerlen,3,1,1,3,0,4,2,10.0,9.0
199,1959-1960,23,DOS Utrecht,AFC Ajax,2,2,3,1,1,4,0,5.0,10.0
200,1959-1960,23,DWS Amsterdam,NAC Breda,1,2,2,0,3,3,-1,9.0,10.0
201,1959-1960,23,MVV Maastricht,Feijenoord,2,0,1,3,0,2,2,9.0,8.0
202,1959-1960,23,Sportclub Enschede,USV Elinkwijk,2,0,1,3,0,2,2,10.0,6.0
203,1959-1960,23,Sittardia,Fortuna '54,0,3,2,0,3,3,-3,3.0,5.0
204,1959-1960,23,Sparta Rotterdam,ADO Den Haag,6,0,1,3,0,6,6,7.0,4.0
205,1959-1960,23,VVV-Venlo,FC Volendam,4,2,1,3,0,6,2,6.0,6.0
206,1959-1960,23,Willem II,PSV,3,4,2,0,3,7,-1,1.0,9.0
207,1959-1960,24,ADO Den Haag,VVV-Venlo,1,4,2,0,3,5,-3,4.0,8.0
208,1959-1960,24,AFC Ajax,Sittardia,4,2,1,3,0,6,2,10.0,3.0
209,1959-1960,24,USV Elinkwijk,Sparta Rotterdam,1,1,3,1,1,2,0,4.0,7.0
210,1959-1960,24,Feijenoord,Rapid JC Heerlen,5,0,1,3,0,5,5,10.0,6.0
211,1959-1960,24,Fortuna '54,Sportclub Enschede,4,2,1,3,0,6,2,8.0,10.0
212,1959-1960,24,MVV Maastricht,Willem II,2,3,2,0,3,5,-1,6.0,4.0
213,1959-1960,24,NAC Breda,DOS Utrecht,1,4,2,0,3,5,-3,9.0,8.0
214,1959-1960,24,PSV,DWS Amsterdam,1,1,3,1,1,2,0,10.0,7.0
215,1959-1960,24,FC Volendam,Blauw Wit,2,1,1,3,0,3,1,6.0,7.0
216,1959-1960,25,Blauw Wit,ADO Den Haag,2,1,1,3,0,3,1,7.0,1.0
217,1959-1960,25,DOS Utrecht,PSV,2,1,1,3,0,3,1,11.0,7.0
218,1959-1960,25,DWS Amsterdam,MVV Maastricht,0,0,3,1,1,0,0,5.0,4.0
219,1959-1960,25,Rapid JC Heerlen,FC Volendam,2,2,3,1,1,4,0,7.0,4.0
220,1959-1960,25,Sportclub Enschede,AFC Ajax,3,3,3,1,1,6,0,8.0,11.0
221,1959-1960,25,Sittardia,NAC Breda,0,1,2,0,3,1,-1,3.0,12.0
222,1959-1960,25,Sparta Rotterdam,Fortuna '54,4,0,1,3,0,4,4,10.0,7.0
223,1959-1960,25,VVV-Venlo,USV Elinkwijk,2,2,3,1,1,4,0,8.0,5.0
224,1959-1960,25,Willem II,Feijenoord,0,4,2,0,3,4,-4,3.0,12.0
225,1959-1960,26,ADO Den Haag,Rapid JC Heerlen,5,1,1,3,0,6,4,4.0,4.0
226,1959-1960,26,AFC Ajax,Sparta Rotterdam,5,0,1,3,0,5,5,11.0,10.0
227,1959-1960,26,USV Elinkwijk,Blauw Wit,1,3,2,0,3,4,-2,5.0,9.0
228,1959-1960,26,Feijenoord,FC Volendam,6,1,1,3,0,7,5,12.0,4.0
229,1959-1960,26,Fortuna '54,VVV-Venlo,4,1,1,3,0,5,3,10.0,7.0
230,1959-1960,26,MVV Maastricht,DOS Utrecht,2,3,2,0,3,5,-1,4.0,11.0
231,1959-1960,26,NAC Breda,Sportclub Enschede,2,1,1,3,0,3,1,12.0,5.0
232,1959-1960,26,PSV,Sittardia,4,1,1,3,0,5,3,10.0,0.0
233,1959-1960,26,Willem II,DWS Amsterdam,1,2,2,0,3,3,-1,3.0,5.0
234,1960-1961,1,ADO Den Haag,Groninger VAV,0,2,2,0,3,2,-2,3.0,
235,1960-1961,1,AFC Ajax,VVV-Venlo,2,0,1,3,0,2,2,11.0,7.0
236,1960-1961,1,VV Alkmaar '54,DWS Amsterdam,2,1,1,3,0,3,1,,5.0
237,1960-1961,1,USV Elinkwijk,Rapid JC Heerlen,0,4,2,0,3,4,-4,2.0,4.0
238,1960-1961,1,Fortuna '54,NOAD Tilburg,3,2,1,3,0,5,1,12.0,
239,1960-1961,1,PSV,Feijenoord,4,2,1,3,0,6,2,10.0,9.0
240,1960-1961,1,Sportclub Enschede,DOS Utrecht,3,2,1,3,0,5,1,7.0,10.0
241,1960-1961,1,Sparta Rotterdam,NAC Breda,3,1,1,3,0,4,2,10.0,9.0
242,1960-1961,1,Willem II,MVV Maastricht,2,2,3,1,1,4,0,4.0,5.0
243,1960-1961,2,DOS Utrecht,VV Alkmaar '54,2,2,3,1,1,4,0,10.0,
244,1960-1961,2,DWS Amsterdam,ADO Den Haag,4,0,1,3,0,4,4,8.0,3.0
245,1960-1961,2,Feijenoord,AFC Ajax,9,5,1,3,0,14,4,12.0,10.0
246,1960-1961,2,Groninger VAV,Sparta Rotterdam,2,2,3,1,1,4,0,,8.0
247,1960-1961,2,MVV Maastricht,Fortuna '54,3,1,1,3,0,4,2,5.0,9.0
248,1960-1961,2,NAC Breda,PSV,4,2,1,3,0,6,2,9.0,7.0
249,1960-1961,2,NOAD Tilburg,Sportclub Enschede,1,1,3,1,1,2,0,,5.0
250,1960-1961,2,Rapid JC Heerlen,Willem II,4,0,1,3,0,4,4,7.0,4.0
251,1960-1961,2,VVV-Venlo,USV Elinkwijk,5,1,1,3,0,6,4,7.0,2.0
252,1960-1961,3,AFC Ajax,PSV,0,0,3,1,1,0,0,8.0,7.0
253,1960-1961,3,VV Alkmaar '54,NOAD Tilburg,0,0,3,1,1,0,0,,
254,1960-1961,3,USV Elinkwijk,Feijenoord,0,3,2,0,3,3,-3,1.0,12.0
255,1960-1961,3,Fortuna '54,Rapid JC Heerlen,2,1,1,3,0,3,1,9.0,7.0
256,1960-1961,3,Groninger VAV,NAC Breda,2,1,1,3,0,3,1,,9.0
257,1960-1961,3,Sportclub Enschede,MVV Maastricht,1,0,1,3,0,1,1,8.0,5.0
258,1960-1961,3,Sparta Rotterdam,DWS Amsterdam,3,1,1,3,0,4,2,10.0,7.0
259,1960-1961,3,Willem II,VVV-Venlo,2,3,2,0,3,5,-1,1.0,7.0
260,1960-1961,3,ADO Den Haag,DOS Utrecht,4,1,1,3,0,5,3,6.0,7.0
261,1960-1961,4,DOS Utrecht,Sparta Rotterdam,3,5,2,0,3,8,-2,4.0,10.0
262,1960-1961,4,DWS Amsterdam,Groninger VAV,2,2,3,1,1,4,0,7.0,
263,1960-1961,4,Feijenoord,Willem II,7,1,1,3,0,8,6,12.0,1.0
264,1960-1961,4,MVV Maastricht,VV Alkmaar '54,2,1,1,3,0,3,1,7.0,
265,1960-1961,4,NAC Breda,AFC Ajax,1,3,2,0,3,4,-2,6.0,10.0
266,1960-1961,4,NOAD Tilburg,ADO Den Haag,3,5,2,0,3,8,-2,,9.0
267,1960-1961,4,PSV,USV Elinkwijk,1,0,1,3,0,1,1,10.0,0.0
268,1960-1961,4,Rapid JC Heerlen,Sportclub Enschede,1,2,2,0,3,3,-1,6.0,10.0
269,1960-1961,4,VVV-Venlo,Fortuna '54,0,0,3,1,1,0,0,7.0,10.0
270,1960-1961,5,ADO Den Haag,MVV Maastricht,2,1,1,3,0,3,1,9.0,7.0
271,1960-1961,5,VV Alkmaar '54,Rapid JC Heerlen,1,1,3,1,1,2,0,6.0,7.0
272,1960-1961,5,DWS Amsterdam,NAC Breda,5,2,1,3,0,7,3,7.0,3.0
273,1960-1961,5,USV Elinkwijk,AFC Ajax,3,3,3,1,1,6,0,1.0,8.0
274,1960-1961,5,Fortuna '54,Feijenoord,1,4,2,0,3,5,-3,7.0,12.0
275,1960-1961,5,Groninger VAV,DOS Utrecht,1,1,3,1,1,2,0,9.0,2.0
276,1960-1961,5,Sportclub Enschede,VVV-Venlo,0,1,2,0,3,1,-1,10.0,10.0
277,1960-1961,5,Sparta Rotterdam,NOAD Tilburg,0,2,2,0,3,2,-2,10.0,5.0
278,1960-1961,5,Willem II,PSV,3,2,1,3,0,5,1,4.0,7.0
279,1960-1961,6,AFC Ajax,Willem II,6,0,1,3,0,6,6,8.0,3.0
280,1960-1961,6,DOS Utrecht,DWS Amsterdam,1,1,3,1,1,2,0,3.0,8.0
281,1960-1961,6,Feijenoord,Sportclub Enschede,4,0,1,3,0,4,4,15.0,7.0
282,1960-1961,6,MVV Maastricht,Sparta Rotterdam,1,0,1,3,0,1,1,9.0,7.0
283,1960-1961,6,NAC Breda,USV Elinkwijk,4,1,1,3,0,5,3,6.0,1.0
284,1960-1961,6,NOAD Tilburg,Groninger VAV,0,2,2,0,3,2,-2,5.0,9.0
285,1960-1961,6,PSV,Fortuna '54,4,1,1,3,0,5,3,7.0,4.0
286,1960-1961,6,Rapid JC Heerlen,ADO Den Haag,1,0,1,3,0,1,1,7.0,9.0
287,1960-1961,6,VVV-Venlo,VV Alkmaar '54,1,3,2,0,3,4,-2,10.0,6.0
288,1960-1961,7,ADO Den Haag,VVV-Venlo,0,2,2,0,3,2,-2,9.0,10.0
289,1960-1961,7,VV Alkmaar '54,Feijenoord,2,4,2,0,3,6,-2,5.0,15.0
290,1960-1961,7,DOS Utrecht,NAC Breda,0,4,2,0,3,4,-4,2.0,6.0
291,1960-1961,7,DWS Amsterdam,NOAD Tilburg,0,0,3,1,1,0,0,6.0,5.0
292,1960-1961,7,Fortuna '54,AFC Ajax,2,3,2,0,3,5,-1,4.0,11.0
293,1960-1961,7,Groninger VAV,MVV Maastricht,1,0,1,3,0,1,1,11.0,6.0
294,1960-1961,7,Sportclub Enschede,PSV,2,4,2,0,3,6,-2,6.0,10.0
295,1960-1961,7,Sparta Rotterdam,Rapid JC Heerlen,3,1,1,3,0,4,2,9.0,4.0
296,1960-1961,7,Willem II,USV Elinkwijk,4,1,1,3,0,5,3,6.0,1.0
297,1960-1961,8,AFC Ajax,Sportclub Enschede,1,1,3,1,1,2,0,11.0,4.0
298,1960-1961,8,USV Elinkwijk,Fortuna '54,0,0,3,1,1,0,0,2.0,2.0
299,1960-1961,8,Feijenoord,ADO Den Haag,7,1,1,3,0,8,6,15.0,6.0
300,1960-1961,8,MVV Maastricht,DWS Amsterdam,2,1,1,3,0,3,1,9.0,6.0
301,1960-1961,8,NAC Breda,Willem II,2,1,1,3,0,3,1,9.0,6.0
302,1960-1961,8,NOAD Tilburg,DOS Utrecht,1,1,3,1,1,2,0,5.0,3.0
303,1960-1961,8,PSV,VV Alkmaar '54,2,1,1,3,0,3,1,12.0,4.0
304,1960-1961,8,Rapid JC Heerlen,Groninger VAV,1,0,1,3,0,1,1,7.0,8.0
305,1960-1961,8,VVV-Venlo,Sparta Rotterdam,1,1,3,1,1,2,0,8.0,7.0
306,1960-1961,9,VV Alkmaar '54,AFC Ajax,2,0,1,3,0,2,2,7.0,8.0
307,1960-1961,9,DOS Utrecht,MVV Maastricht,3,1,1,3,0,4,2,6.0,6.0
308,1960-1961,9,DWS Amsterdam,Rapid JC Heerlen,0,0,3,1,1,0,0,6.0,8.0
309,1960-1961,9,Fortuna '54,Willem II,2,2,3,1,1,4,0,2.0,7.0
310,1960-1961,9,Groninger VAV,VVV-Venlo,5,2,1,3,0,7,3,10.0,7.0
311,1960-1961,9,NOAD Tilburg,NAC Breda,2,3,2,0,3,5,-1,5.0,12.0
312,1960-1961,9,Sportclub Enschede,USV Elinkwijk,2,0,1,3,0,2,2,4.0,2.0
313,1960-1961,9,Sparta Rotterdam,Feijenoord,1,2,2,0,3,3,-1,4.0,15.0
314,1960-1961,9,ADO Den Haag,PSV,2,1,1,3,0,3,1,6.0,9.0
315,1960-1961,10,AFC Ajax,ADO Den Haag,4,2,1,3,0,6,2,10.0,3.0
316,1960-1961,10,USV Elinkwijk,VV Alkmaar '54,2,0,1,3,0,2,2,4.0,6.0
317,1960-1961,10,Feijenoord,Groninger VAV,1,3,2,0,3,4,-2,12.0,12.0
318,1960-1961,10,MVV Maastricht,NOAD Tilburg,2,0,1,3,0,2,2,9.0,2.0
319,1960-1961,10,NAC Breda,Fortuna '54,2,1,1,3,0,3,1,15.0,2.0
320,1960-1961,10,PSV,Sparta Rotterdam,5,4,1,3,0,9,1,12.0,4.0
321,1960-1961,10,Rapid JC Heerlen,DOS Utrecht,0,4,2,0,3,4,-4,7.0,8.0
322,1960-1961,10,VVV-Venlo,DWS Amsterdam,2,0,1,3,0,2,2,7.0,3.0
323,1960-1961,10,Willem II,Sportclub Enschede,0,1,2,0,3,1,-1,4.0,7.0
324,1960-1961,11,ADO Den Haag,USV Elinkwijk,2,1,1,3,0,3,1,6.0,4.0
325,1960-1961,11,VV Alkmaar '54,Willem II,1,2,2,0,3,3,-1,3.0,7.0
326,1960-1961,11,DOS Utrecht,VVV-Venlo,4,1,1,3,0,5,3,10.0,7.0
327,1960-1961,11,DWS Amsterdam,Feijenoord,1,1,3,1,1,2,0,3.0,10.0
328,1960-1961,11,Groninger VAV,PSV,2,0,1,3,0,2,2,12.0,9.0
329,1960-1961,11,MVV Maastricht,NAC Breda,1,1,3,1,1,2,0,7.0,13.0
330,1960-1961,11,NOAD Tilburg,Rapid JC Heerlen,1,2,2,0,3,3,-1,2.0,7.0
331,1960-1961,11,Sportclub Enschede,Fortuna '54,3,0,1,3,0,3,3,10.0,2.0
332,1960-1961,11,Sparta Rotterdam,AFC Ajax,1,4,2,0,3,5,-3,4.0,10.0
333,1960-1961,12,AFC Ajax,Groninger VAV,5,2,1,3,0,7,3,10.0,9.0
334,1960-1961,12,Feijenoord,DOS Utrecht,4,3,1,3,0,7,1,10.0,10.0
335,1960-1961,12,Fortuna '54,VV Alkmaar '54,2,1,1,3,0,3,1,5.0,3.0
336,1960-1961,12,NAC Breda,Sportclub Enschede,5,1,1,3,0,6,4,13.0,10.0
337,1960-1961,12,PSV,DWS Amsterdam,3,2,1,3,0,5,1,9.0,2.0
338,1960-1961,12,Rapid JC Heerlen,MVV Maastricht,1,1,3,1,1,2,0,8.0,8.0
339,1960-1961,12,VVV-Venlo,NOAD Tilburg,8,1,1,3,0,9,7,7.0,1.0
340,1960-1961,12,Willem II,ADO Den Haag,4,0,1,3,0,4,4,7.0,6.0
341,1960-1961,12,USV Elinkwijk,Sparta Rotterdam,1,3,2,0,3,4,-2,4.0,4.0
342,1960-1961,13,ADO Den Haag,Fortuna '54,3,2,1,3,0,5,1,9.0,4.0
343,1960-1961,13,VV Alkmaar '54,Sportclub Enschede,2,1,1,3,0,3,1,6.0,9.0
344,1960-1961,13,DOS Utrecht,PSV,1,2,2,0,3,3,-1,9.0,9.0
345,1960-1961,13,DWS Amsterdam,AFC Ajax,1,1,3,1,1,2,0,3.0,10.0
346,1960-1961,13,Groninger VAV,USV Elinkwijk,1,0,1,3,0,1,1,12.0,3.0
347,1960-1961,13,MVV Maastricht,VVV-Venlo,0,3,2,0,3,3,-3,5.0,9.0
348,1960-1961,13,NOAD Tilburg,Feijenoord,1,5,2,0,3,6,-4,0.0,10.0
349,1960-1961,13,Rapid JC Heerlen,NAC Breda,1,3,2,0,3,4,-2,5.0,13.0
350,1960-1961,13,Sparta Rotterdam,Willem II,3,0,1,3,0,3,3,6.0,7.0
351,1960-1961,14,AFC Ajax,DOS Utrecht,3,1,1,3,0,4,2,13.0,6.0
352,1960-1961,14,USV Elinkwijk,DWS Amsterdam,2,1,1,3,0,3,1,6.0,2.0
353,1960-1961,14,Feijenoord,MVV Maastricht,2,2,3,1,1,4,0,8.0,6.0
354,1960-1961,14,Fortuna '54,Sparta Rotterdam,1,2,2,0,3,3,-1,3.0,9.0
355,1960-1961,14,NAC Breda,VV Alkmaar '54,3,1,1,3,0,4,2,13.0,3.0
356,1960-1961,14,PSV,NOAD Tilburg,1,1,3,1,1,2,0,10.0,1.0
357,1960-1961,14,Sportclub Enschede,ADO Den Haag,2,5,2,0,3,7,-3,6.0,9.0
358,1960-1961,14,VVV-Venlo,Rapid JC Heerlen,2,4,2,0,3,6,-2,9.0,7.0
359,1960-1961,14,Willem II,Groninger VAV,2,2,3,1,1,4,0,7.0,10.0
360,1960-1961,15,ADO Den Haag,VV Alkmaar '54,1,1,3,1,1,2,0,10.0,4.0
361,1960-1961,15,DOS Utrecht,USV Elinkwijk,1,0,1,3,0,1,1,6.0,3.0
362,1960-1961,15,DWS Amsterdam,Willem II,3,1,1,3,0,4,2,5.0,7.0
363,1960-1961,15,Groninger VAV,Fortuna '54,3,1,1,3,0,4,2,10.0,3.0
364,1960-1961,15,MVV Maastricht,PSV,3,3,3,1,1,6,0,4.0,8.0
365,1960-1961,15,NOAD Tilburg,AFC Ajax,1,4,2,0,3,5,-3,1.0,13.0
366,1960-1961,15,Rapid JC Heerlen,Feijenoord,1,4,2,0,3,5,-3,7.0,11.0
367,1960-1961,15,Sparta Rotterdam,Sportclub Enschede,0,2,2,0,3,2,-2,9.0,6.0
368,1960-1961,15,VVV-Venlo,NAC Breda,6,1,1,3,0,7,5,9.0,10.0
369,1960-1961,16,ADO Den Haag,NAC Breda,2,3,2,0,3,5,-1,7.0,12.0
370,1960-1961,16,AFC Ajax,MVV Maastricht,4,0,1,3,0,4,4,13.0,3.0
371,1960-1961,16,VV Alkmaar '54,Sparta Rotterdam,0,0,3,1,1,0,0,5.0,10.0
372,1960-1961,16,USV Elinkwijk,NOAD Tilburg,6,0,1,3,0,6,6,6.0,1.0
373,1960-1961,16,Feijenoord,VVV-Venlo,3,3,3,1,1,6,0,11.0,10.0
374,1960-1961,16,Fortuna '54,DWS Amsterdam,1,1,3,1,1,2,0,4.0,5.0
375,1960-1961,16,PSV,Rapid JC Heerlen,1,1,3,1,1,2,0,9.0,5.0
376,1960-1961,16,Sportclub Enschede,Groninger VAV,0,1,2,0,3,1,-1,3.0,10.0
377,1960-1961,16,Willem II,DOS Utrecht,2,2,3,1,1,4,0,5.0,4.0
378,1960-1961,17,DOS Utrecht,Sportclub Enschede,1,2,2,0,3,3,-1,4.0,6.0
379,1960-1961,17,DWS Amsterdam,VV Alkmaar '54,4,2,1,3,0,6,2,8.0,5.0
380,1960-1961,17,Feijenoord,PSV,1,3,2,0,3,4,-2,8.0,9.0
381,1960-1961,17,Groninger VAV,ADO Den Haag,0,2,2,0,3,2,-2,10.0,10.0
382,1960-1961,17,MVV Maastricht,Willem II,2,0,1,3,0,2,2,5.0,2.0
383,1960-1961,17,NAC Breda,Sparta Rotterdam,0,0,3,1,1,0,0,10.0,8.0
384,1960-1961,17,NOAD Tilburg,Fortuna '54,0,3,2,0,3,3,-3,1.0,4.0
385,1960-1961,17,Rapid JC Heerlen,USV Elinkwijk,3,1,1,3,0,4,2,7.0,6.0
386,1960-1961,17,VVV-Venlo,AFC Ajax,2,0,1,3,0,2,2,10.0,10.0
387,1960-1961,18,ADO Den Haag,DWS Amsterdam,0,2,2,0,3,2,-2,7.0,10.0
388,1960-1961,18,AFC Ajax,Feijenoord,0,1,2,0,3,1,-1,9.0,8.0
389,1960-1961,18,VV Alkmaar '54,DOS Utrecht,1,4,2,0,3,5,-3,2.0,7.0
390,1960-1961,18,USV Elinkwijk,VVV-Venlo,0,2,2,0,3,2,-2,6.0,10.0
391,1960-1961,18,Fortuna '54,MVV Maastricht,4,1,1,3,0,5,3,7.0,5.0
392,1960-1961,18,PSV,NAC Breda,2,2,3,1,1,4,0,7.0,8.0
393,1960-1961,18,Sportclub Enschede,NOAD Tilburg,3,0,1,3,0,3,3,9.0,1.0
394,1960-1961,18,Sparta Rotterdam,Groninger VAV,4,3,1,3,0,7,1,8.0,7.0
395,1960-1961,18,Willem II,Rapid JC Heerlen,1,0,1,3,0,1,1,5.0,7.0
396,1960-1961,19,DOS Utrecht,ADO Den Haag,0,1,2,0,3,1,-1,7.0,7.0
397,1960-1961,19,DWS Amsterdam,Sparta Rotterdam,1,1,3,1,1,2,0,11.0,6.0
398,1960-1961,19,Feijenoord,USV Elinkwijk,3,1,1,3,0,4,2,10.0,3.0
399,1960-1961,19,MVV Maastricht,Sportclub Enschede,1,0,1,3,0,1,1,7.0,9.0
400,1960-1961,19,NAC Breda,Groninger VAV,2,1,1,3,0,3,1,8.0,6.0
401,1960-1961,19,NOAD Tilburg,VV Alkmaar '54,0,0,3,1,1,0,0,1.0,3.0
402,1960-1961,19,PSV,AFC Ajax,1,3,2,0,3,4,-2,6.0,9.0
403,1960-1961,19,Rapid JC Heerlen,Fortuna '54,2,1,1,3,0,3,1,7.0,7.0
404,1960-1961,19,VVV-Venlo,Willem II,1,2,2,0,3,3,-1,10.0,7.0
405,1960-1961,20,ADO Den Haag,NOAD Tilburg,3,1,1,3,0,4,2,9.0,1.0
406,1960-1961,20,AFC Ajax,NAC Breda,4,1,1,3,0,5,3,9.0,8.0
407,1960-1961,20,VV Alkmaar '54,MVV Maastricht,0,0,3,1,1,0,0,3.0,7.0
408,1960-1961,20,USV Elinkwijk,PSV,3,2,1,3,0,5,1,6.0,5.0
409,1960-1961,20,Fortuna '54,VVV-Venlo,0,3,2,0,3,3,-3,7.0,10.0
410,1960-1961,20,Groninger VAV,DWS Amsterdam,2,4,2,0,3,6,-2,3.0,11.0
411,1960-1961,20,Sportclub Enschede,Rapid JC Heerlen,0,2,2,0,3,2,-2,6.0,10.0
412,1960-1961,20,Sparta Rotterdam,DOS Utrecht,0,0,3,1,1,0,0,7.0,5.0
413,1960-1961,20,Willem II,Feijenoord,0,4,2,0,3,4,-4,7.0,10.0
414,1960-1961,21,AFC Ajax,USV Elinkwijk,6,1,1,3,0,7,5,9.0,3.0
415,1960-1961,21,DOS Utrecht,Groninger VAV,7,2,1,3,0,9,5,7.0,0.0
416,1960-1961,21,Feijenoord,Fortuna '54,1,1,3,1,1,2,0,10.0,7.0
417,1960-1961,21,MVV Maastricht,ADO Den Haag,3,2,1,3,0,5,1,10.0,9.0
418,1960-1961,21,NAC Breda,DWS Amsterdam,0,1,2,0,3,1,-1,5.0,13.0
419,1960-1961,21,NOAD Tilburg,Sparta Rotterdam,0,2,2,0,3,2,-2,1.0,9.0
420,1960-1961,21,PSV,Willem II,1,2,2,0,3,3,-1,4.0,9.0
421,1960-1961,21,Rapid JC Heerlen,VV Alkmaar '54,1,1,3,1,1,2,0,10.0,3.0
422,1960-1961,21,VVV-Venlo,Sportclub Enschede,1,0,1,3,0,1,1,12.0,6.0
423,1960-1961,22,ADO Den Haag,Rapid JC Heerlen,2,1,1,3,0,3,1,9.0,7.0
424,1960-1961,22,VV Alkmaar '54,VVV-Venlo,2,4,2,0,3,6,-2,3.0,12.0
425,1960-1961,22,DWS Amsterdam,DOS Utrecht,2,3,2,0,3,5,-1,10.0,10.0
426,1960-1961,22,USV Elinkwijk,NAC Breda,1,2,2,0,3,3,-1,3.0,7.0
427,1960-1961,22,Fortuna '54,PSV,0,5,2,0,3,5,-5,4.0,4.0
428,1960-1961,22,Groninger VAV,NOAD Tilburg,3,0,1,3,0,3,3,3.0,1.0
429,1960-1961,22,Sportclub Enschede,Feijenoord,0,2,2,0,3,2,-2,3.0,13.0
430,1960-1961,22,Sparta Rotterdam,MVV Maastricht,3,2,1,3,0,5,1,11.0,7.0
431,1960-1961,22,Willem II,AFC Ajax,3,5,2,0,3,8,-2,9.0,12.0
432,1960-1961,23,AFC Ajax,Fortuna '54,7,4,1,3,0,11,3,15.0,1.0
433,1960-1961,23,USV Elinkwijk,Willem II,1,4,2,0,3,5,-3,3.0,9.0
434,1960-1961,23,Feijenoord,VV Alkmaar '54,6,0,1,3,0,6,6,13.0,3.0
435,1960-1961,23,MVV Maastricht,Groninger VAV,4,3,1,3,0,7,1,10.0,3.0
436,1960-1961,23,NAC Breda,DOS Utrecht,0,2,2,0,3,2,-2,6.0,10.0
437,1960-1961,23,NOAD Tilburg,DWS Amsterdam,1,3,2,0,3,4,-2,1.0,10.0
438,1960-1961,23,PSV,Sportclub Enschede,3,1,1,3,0,4,2,6.0,0.0
439,1960-1961,23,Rapid JC Heerlen,Sparta Rotterdam,1,1,3,1,1,2,0,8.0,9.0
440,1960-1961,23,VVV-Venlo,ADO Den Haag,5,0,1,3,0,5,5,12.0,9.0
441,1960-1961,24,ADO Den Haag,Feijenoord,0,2,2,0,3,2,-2,6.0,13.0
442,1960-1961,24,VV Alkmaar '54,PSV,1,2,2,0,3,3,-1,2.0,9.0
443,1960-1961,24,DOS Utrecht,NOAD Tilburg,1,1,3,1,1,2,0,11.0,1.0
444,1960-1961,24,DWS Amsterdam,MVV Maastricht,4,0,1,3,0,4,4,12.0,7.0
445,1960-1961,24,Fortuna '54,USV Elinkwijk,0,1,2,0,3,1,-1,1.0,6.0
446,1960-1961,24,Groninger VAV,Rapid JC Heerlen,4,0,1,3,0,4,4,6.0,5.0
447,1960-1961,24,Sportclub Enschede,AFC Ajax,2,5,2,0,3,7,-3,0.0,15.0
448,1960-1961,24,Sparta Rotterdam,VVV-Venlo,2,0,1,3,0,2,2,11.0,12.0
449,1960-1961,24,Willem II,NAC Breda,1,0,1,3,0,1,1,9.0,3.0
450,1960-1961,25,DOS Utrecht,Fortuna '54,1,1,3,1,1,2,0,11.0,2.0
451,1960-1961,25,DWS Amsterdam,Sportclub Enschede,0,0,3,1,1,0,0,10.0,1.0
452,1960-1961,25,Groninger VAV,VV Alkmaar '54,1,0,1,3,0,1,1,9.0,1.0
453,1960-1961,25,MVV Maastricht,USV Elinkwijk,2,3,2,0,3,5,-1,6.0,6.0
454,1960-1961,25,NAC Breda,Feijenoord,0,2,2,0,3,2,-2,3.0,13.0
455,1960-1961,25,Rapid JC Heerlen,AFC Ajax,1,5,2,0,3,6,-4,2.0,15.0
456,1960-1961,25,Sparta Rotterdam,ADO Den Haag,5,2,1,3,0,7,3,13.0,3.0
457,1960-1961,25,VVV-Venlo,PSV,1,1,3,1,1,2,0,10.0,10.0
458,1960-1961,25,Willem II,NOAD Tilburg,0,2,2,0,3,2,-2,9.0,4.0
459,1960-1961,26,ADO Den Haag,Sparta Rotterdam,5,2,1,3,0,7,3,6.0,10.0
460,1960-1961,26,AFC Ajax,Rapid JC Heerlen,1,0,1,3,0,1,1,15.0,1.0
461,1960-1961,26,VV Alkmaar '54,Groninger VAV,1,1,3,1,1,2,0,1.0,10.0
462,1960-1961,26,USV Elinkwijk,MVV Maastricht,0,0,3,1,1,0,0,7.0,4.0
463,1960-1961,26,Feijenoord,NAC Breda,2,0,1,3,0,2,2,15.0,3.0
464,1960-1961,26,Fortuna '54,DOS Utrecht,1,1,3,1,1,2,0,2.0,9.0
465,1960-1961,26,PSV,VVV-Venlo,1,1,3,1,1,2,0,11.0,8.0
466,1960-1961,26,Sportclub Enschede,DWS Amsterdam,2,2,3,1,1,4,0,2.0,8.0
467,1960-1961,26,NOAD Tilburg,Willem II,0,2,2,0,3,2,-2,4.0,9.0
468,1960-1961,27,AFC Ajax,VV Alkmaar '54,3,1,1,3,0,4,2,15.0,1.0
469,1960-1961,27,USV Elinkwijk,Sportclub Enschede,2,1,1,3,0,3,1,10.0,2.0
470,1960-1961,27,Feijenoord,Sparta Rotterdam,0,1,2,0,3,1,-1,12.0,10.0
471,1960-1961,27,MVV Maastricht,DOS Utrecht,1,2,2,0,3,3,-1,4.0,9.0
472,1960-1961,27,NAC Breda,NOAD Tilburg,2,0,1,3,0,2,2,3.0,4.0
473,1960-1961,27,PSV,ADO Den Haag,4,1,1,3,0,5,3,11.0,3.0
474,1960-1961,27,Rapid JC Heerlen,DWS Amsterdam,1,2,2,0,3,3,-1,1.0,11.0
475,1960-1961,27,VVV-Venlo,Groninger VAV,0,1,2,0,3,1,-1,5.0,10.0
476,1960-1961,27,Willem II,Fortuna '54,3,2,1,3,0,5,1,12.0,2.0
477,1960-1961,28,ADO Den Haag,AFC Ajax,1,3,2,0,3,4,-2,3.0,15.0
478,1960-1961,28,VV Alkmaar '54,USV Elinkwijk,2,1,1,3,0,3,1,4.0,10.0
479,1960-1961,28,DOS Utrecht,Rapid JC Heerlen,4,0,1,3,0,4,4,9.0,0.0
480,1960-1961,28,DWS Amsterdam,VVV-Venlo,1,3,2,0,3,4,-2,8.0,5.0
481,1960-1961,28,Fortuna '54,NAC Breda,4,1,1,3,0,5,3,5.0,3.0
482,1960-1961,28,Groninger VAV,Feijenoord,1,0,1,3,0,1,1,13.0,9.0
483,1960-1961,28,NOAD Tilburg,MVV Maastricht,3,2,1,3,0,5,1,7.0,1.0
484,1960-1961,28,Sportclub Enschede,Willem II,3,2,1,3,0,5,1,5.0,9.0
485,1960-1961,28,Sparta Rotterdam,PSV,4,2,1,3,0,6,2,12.0,8.0
486,1960-1961,29,AFC Ajax,Sparta Rotterdam,1,1,3,1,1,2,0,13.0,10.0
487,1960-1961,29,USV Elinkwijk,ADO Den Haag,4,3,1,3,0,7,1,10.0,3.0
488,1960-1961,29,Feijenoord,DWS Amsterdam,2,0,1,3,0,2,2,9.0,5.0
489,1960-1961,29,Fortuna '54,Sportclub Enschede,2,2,3,1,1,4,0,6.0,6.0
490,1960-1961,29,NAC Breda,MVV Maastricht,1,1,3,1,1,2,0,4.0,2.0
491,1960-1961,29,PSV,Groninger VAV,1,1,3,1,1,2,0,6.0,11.0
492,1960-1961,29,Rapid JC Heerlen,NOAD Tilburg,0,0,3,1,1,0,0,1.0,7.0
493,1960-1961,29,VVV-Venlo,DOS Utrecht,0,3,2,0,3,3,-3,5.0,11.0
494,1960-1961,29,Willem II,VV Alkmaar '54,3,0,1,3,0,3,3,9.0,4.0
495,1960-1961,30,ADO Den Haag,Willem II,1,0,1,3,0,1,1,6.0,9.0
496,1960-1961,30,VV Alkmaar '54,Fortuna '54,1,1,3,1,1,2,0,5.0,6.0
497,1960-1961,30,DOS Utrecht,Feijenoord,0,2,2,0,3,2,-2,10.0,9.0
498,1960-1961,30,DWS Amsterdam,PSV,2,2,3,1,1,4,0,5.0,6.0
499,1960-1961,30,Groninger VAV,AFC Ajax,1,1,3,1,1,2,0,9.0,11.0
500,1960-1961,30,MVV Maastricht,Rapid JC Heerlen,2,1,1,3,0,3,1,5.0,1.0
501,1960-1961,30,NOAD Tilburg,VVV-Venlo,1,5,2,0,3,6,-4,4.0,7.0
502,1960-1961,30,Sportclub Enschede,NAC Breda,6,2,1,3,0,8,4,8.0,4.0
503,1960-1961,30,Sparta Rotterdam,USV Elinkwijk,1,3,2,0,3,4,-2,7.0,10.0
504,1960-1961,31,AFC Ajax,DWS Amsterdam,2,2,3,1,1,4,0,9.0,5.0
505,1960-1961,31,USV Elinkwijk,Groninger VAV,1,0,1,3,0,1,1,12.0,8.0
506,1960-1961,31,Feijenoord,NOAD Tilburg,4,1,1,3,0,5,3,9.0,4.0
507,1960-1961,31,Fortuna '54,ADO Den Haag,1,1,3,1,1,2,0,6.0,4.0
508,1960-1961,31,NAC Breda,Rapid JC Heerlen,0,1,2,0,3,1,-1,4.0,4.0
509,1960-1961,31,PSV,DOS Utrecht,1,2,2,0,3,3,-1,5.0,12.0
510,1960-1961,31,Sportclub Enschede,VV Alkmaar '54,2,2,3,1,1,4,0,8.0,5.0
511,1960-1961,31,VVV-Venlo,MVV Maastricht,6,2,1,3,0,8,4,9.0,4.0
512,1960-1961,31,Willem II,Sparta Rotterdam,2,1,1,3,0,3,1,9.0,7.0
513,1960-1961,32,Rapid JC Heerlen,VVV-Venlo,0,1,2,0,3,1,-1,4.0,12.0
514,1960-1961,32,ADO Den Haag,Sportclub Enschede,3,2,1,3,0,5,1,7.0,8.0
515,1960-1961,32,VV Alkmaar '54,NAC Breda,3,0,1,3,0,3,3,8.0,1.0
516,1960-1961,32,DOS Utrecht,AFC Ajax,2,0,1,3,0,2,2,12.0,6.0
517,1960-1961,32,DWS Amsterdam,USV Elinkwijk,4,1,1,3,0,5,3,5.0,9.0
518,1960-1961,32,Groninger VAV,Willem II,1,1,3,1,1,2,0,6.0,7.0
519,1960-1961,32,MVV Maastricht,Feijenoord,0,2,2,0,3,2,-2,4.0,12.0
520,1960-1961,32,NOAD Tilburg,PSV,2,1,1,3,0,3,1,7.0,2.0
521,1960-1961,32,Sparta Rotterdam,Fortuna '54,5,1,1,3,0,6,4,7.0,6.0
522,1960-1961,33,AFC Ajax,NOAD Tilburg,3,0,1,3,0,3,3,6.0,4.0
523,1960-1961,33,VV Alkmaar '54,ADO Den Haag,0,2,2,0,3,2,-2,5.0,10.0
524,1960-1961,33,USV Elinkwijk,DOS Utrecht,0,3,2,0,3,3,-3,9.0,12.0
525,1960-1961,33,Feijenoord,Rapid JC Heerlen,2,1,1,3,0,3,1,15.0,4.0
526,1960-1961,33,Fortuna '54,Groninger VAV,3,0,1,3,0,3,3,6.0,3.0
527,1960-1961,33,NAC Breda,VVV-Venlo,2,0,1,3,0,2,2,4.0,9.0
528,1960-1961,33,PSV,MVV Maastricht,5,0,1,3,0,5,5,5.0,4.0
529,1960-1961,33,Sportclub Enschede,Sparta Rotterdam,2,5,2,0,3,7,-3,5.0,7.0
530,1960-1961,33,Willem II,DWS Amsterdam,1,1,3,1,1,2,0,8.0,6.0
531,1960-1961,34,DOS Utrecht,Willem II,5,0,1,3,0,5,5,12.0,5.0
532,1960-1961,34,DWS Amsterdam,Fortuna '54,0,3,2,0,3,3,-3,6.0,8.0
533,1960-1961,34,Groninger VAV,Sportclub Enschede,1,2,2,0,3,3,-1,2.0,7.0
534,1960-1961,34,MVV Maastricht,AFC Ajax,1,5,2,0,3,6,-4,3.0,8.0
535,1960-1961,34,NAC Breda,ADO Den Haag,4,1,1,3,0,5,3,6.0,10.0
536,1960-1961,34,NOAD Tilburg,USV Elinkwijk,0,1,2,0,3,1,-1,3.0,9.0
537,1960-1961,34,Rapid JC Heerlen,PSV,3,2,1,3,0,5,1,6.0,4.0
538,1960-1961,34,Sparta Rotterdam,VV Alkmaar '54,2,2,3,1,1,4,0,7.0,6.0
539,1960-1961,34,VVV-Venlo,Feijenoord,2,2,3,1,1,4,0,10.0,13.0
540,1961-1962,1,ADO Den Haag,Fortuna '54,2,1,1,3,0,3,1,10.0,7.0
541,1961-1962,1,De Volewijckers,NAC Breda,0,3,2,0,3,3,-3,,9.0
542,1961-1962,1,DOS Utrecht,AFC Ajax,2,2,3,1,1,4,0,13.0,8.0
543,1961-1962,1,DWS Amsterdam,MVV Maastricht,1,0,1,3,0,1,1,8.0,0.0
544,1961-1962,1,Groninger VAV,Blauw Wit,2,2,3,1,1,4,0,2.0,10.0
545,1961-1962,1,Rapid JC Heerlen,Feijenoord,1,6,2,0,3,7,-5,6.0,13.0
546,1961-1962,1,Sportclub Enschede,FC Volendam,2,3,2,0,3,5,-1,4.0,7.0
547,1961-1962,1,Sparta Rotterdam,Willem II,4,2,1,3,0,6,2,10.0,5.0
548,1961-1962,1,VVV-Venlo,PSV,1,3,2,0,3,4,-2,7.0,6.0
549,1961-1962,2,AFC Ajax,Sportclub Enschede,6,1,1,3,0,7,5,10.0,3.0
550,1961-1962,2,Blauw Wit,VVV-Venlo,2,1,1,3,0,3,1,10.0,4.0
551,1961-1962,2,Feijenoord,Sparta Rotterdam,3,0,1,3,0,3,3,13.0,10.0
552,1961-1962,2,Fortuna '54,De Volewijckers,5,2,1,3,0,7,3,9.0,
553,1961-1962,2,MVV Maastricht,Groninger VAV,0,0,3,1,1,0,0,1.0,3.0
554,1961-1962,2,NAC Breda,Rapid JC Heerlen,1,1,3,1,1,2,0,10.0,4.0
555,1961-1962,2,PSV,ADO Den Haag,6,1,1,3,0,7,5,9.0,9.0
556,1961-1962,2,FC Volendam,DWS Amsterdam,0,0,3,1,1,0,0,8.0,8.0
557,1961-1962,2,Willem II,DOS Utrecht,2,1,1,3,0,3,1,5.0,10.0
558,1961-1962,3,ADO Den Haag,VVV-Venlo,5,1,1,3,0,6,4,9.0,1.0
559,1961-1962,3,De Volewijckers,PSV,3,6,2,0,3,9,-3,,12.0
560,1961-1962,3,DOS Utrecht,Feijenoord,0,0,3,1,1,0,0,8.0,11.0
561,1961-1962,3,DWS Amsterdam,AFC Ajax,0,0,3,1,1,0,0,6.0,11.0
562,1961-1962,3,Groninger VAV,FC Volendam,1,3,2,0,3,4,-2,2.0,8.0
563,1961-1962,3,MVV Maastricht,Blauw Wit,5,3,1,3,0,8,2,4.0,10.0
564,1961-1962,3,Rapid JC Heerlen,Fortuna '54,0,3,2,0,3,3,-3,4.0,12.0
565,1961-1962,3,Sportclub Enschede,Willem II,2,4,2,0,3,6,-2,3.0,7.0
566,1961-1962,3,Sparta Rotterdam,NAC Breda,3,3,3,1,1,6,0,8.0,11.0
567,1961-1962,4,AFC Ajax,Groninger VAV,4,2,1,3,0,6,2,11.0,2.0
568,1961-1962,4,Blauw Wit,ADO Den Haag,0,0,3,1,1,0,0,8.0,7.0
569,1961-1962,4,Feijenoord,Sportclub Enschede,2,0,1,3,0,2,2,11.0,3.0
570,1961-1962,4,Fortuna '54,Sparta Rotterdam,1,0,1,3,0,1,1,12.0,5.0
571,1961-1962,4,NAC Breda,DOS Utrecht,2,0,1,3,0,2,2,11.0,5.0
572,1961-1962,4,PSV,Rapid JC Heerlen,7,1,1,3,0,8,6,12.0,4.0
573,1961-1962,4,FC Volendam,MVV Maastricht,2,3,2,0,3,5,-1,7.0,7.0
574,1961-1962,4,VVV-Venlo,De Volewijckers,1,1,3,1,1,2,0,2.0,
575,1961-1962,4,Willem II,DWS Amsterdam,3,1,1,3,0,4,2,9.0,5.0
576,1961-1962,5,De Volewijckers,ADO Den Haag,2,7,2,0,3,9,-5,1.0,10.0
577,1961-1962,5,DOS Utrecht,Fortuna '54,2,3,2,0,3,5,-1,2.0,12.0
578,1961-1962,5,DWS Amsterdam,Feijenoord,2,3,2,0,3,5,-1,5.0,13.0
579,1961-1962,5,Groninger VAV,Willem II,2,2,3,1,1,4,0,3.0,10.0
580,1961-1962,5,MVV Maastricht,AFC Ajax,2,4,2,0,3,6,-2,7.0,11.0
581,1961-1962,5,Rapid JC Heerlen,VVV-Venlo,3,0,1,3,0,3,3,4.0,1.0
582,1961-1962,5,Sportclub Enschede,NAC Breda,3,1,1,3,0,4,2,3.0,8.0
583,1961-1962,5,Sparta Rotterdam,PSV,0,5,2,0,3,5,-5,4.0,15.0
584,1961-1962,5,FC Volendam,Blauw Wit,2,4,2,0,3,6,-2,7.0,8.0
585,1961-1962,6,ADO Den Haag,Rapid JC Heerlen,4,1,1,3,0,5,3,10.0,4.0
586,1961-1962,6,AFC Ajax,FC Volendam,9,1,1,3,0,10,8,13.0,4.0
587,1961-1962,6,Blauw Wit,De Volewijckers,5,1,1,3,0,6,4,10.0,1.0
588,1961-1962,6,Feijenoord,Groninger VAV,7,4,1,3,0,11,3,13.0,2.0
589,1961-1962,6,Fortuna '54,Sportclub Enschede,5,0,1,3,0,5,5,15.0,3.0
590,1961-1962,6,NAC Breda,DWS Amsterdam,1,1,3,1,1,2,0,6.0,3.0
591,1961-1962,6,PSV,DOS Utrecht,0,1,2,0,3,1,-1,12.0,4.0
592,1961-1962,6,VVV-Venlo,Sparta Rotterdam,1,1,3,1,1,2,0,2.0,2.0
593,1961-1962,6,Willem II,MVV Maastricht,4,3,1,3,0,7,1,13.0,7.0
594,1961-1962,7,AFC Ajax,Blauw Wit,2,2,3,1,1,4,0,11.0,8.0
595,1961-1962,7,DOS Utrecht,VVV-Venlo,1,1,3,1,1,2,0,5.0,3.0
596,1961-1962,7,DWS Amsterdam,Fortuna '54,2,1,1,3,0,3,1,5.0,12.0
597,1961-1962,7,Groninger VAV,NAC Breda,2,2,3,1,1,4,0,2.0,6.0
598,1961-1962,7,MVV Maastricht,Feijenoord,0,0,3,1,1,0,0,7.0,11.0
599,1961-1962,7,Rapid JC Heerlen,De Volewijckers,4,1,1,3,0,5,3,6.0,1.0
600,1961-1962,7,Sportclub Enschede,PSV,0,1,2,0,3,1,-1,3.0,12.0
601,1961-1962,7,Sparta Rotterdam,ADO Den Haag,2,2,3,1,1,4,0,3.0,11.0
602,1961-1962,7,FC Volendam,Willem II,3,2,1,3,0,5,1,6.0,10.0
603,1961-1962,8,ADO Den Haag,DOS Utrecht,1,2,2,0,3,3,-1,8.0,7.0
604,1961-1962,8,Blauw Wit,Rapid JC Heerlen,3,1,1,3,0,4,2,11.0,6.0
605,1961-1962,8,De Volewijckers,Sparta Rotterdam,3,0,1,3,0,3,3,4.0,2.0
606,1961-1962,8,Feijenoord,FC Volendam,3,0,1,3,0,3,3,13.0,3.0
607,1961-1962,8,Fortuna '54,Groninger VAV,0,3,2,0,3,3,-3,9.0,5.0
608,1961-1962,8,NAC Breda,MVV Maastricht,1,0,1,3,0,1,1,8.0,4.0
609,1961-1962,8,PSV,DWS Amsterdam,2,1,1,3,0,3,1,12.0,4.0
610,1961-1962,8,VVV-Venlo,Sportclub Enschede,2,0,1,3,0,2,2,6.0,3.0
611,1961-1962,8,Willem II,AFC Ajax,0,1,2,0,3,1,-1,7.0,13.0
612,1961-1962,9,AFC Ajax,Feijenoord,1,3,2,0,3,4,-2,10.0,13.0
613,1961-1962,9,DOS Utrecht,De Volewijckers,4,1,1,3,0,5,3,10.0,3.0
614,1961-1962,9,DWS Amsterdam,VVV-Venlo,1,1,3,1,1,2,0,5.0,6.0
615,1961-1962,9,Groninger VAV,PSV,3,2,1,3,0,5,1,8.0,9.0
616,1961-1962,9,MVV Maastricht,Fortuna '54,3,1,1,3,0,4,2,4.0,6.0
617,1961-1962,9,Sportclub Enschede,ADO Den Haag,4,1,1,3,0,5,3,6.0,7.0
618,1961-1962,9,Sparta Rotterdam,Rapid JC Heerlen,3,0,1,3,0,3,3,5.0,6.0
619,1961-1962,9,FC Volendam,NAC Breda,3,1,1,3,0,4,2,6.0,5.0
620,1961-1962,9,Willem II,Blauw Wit,3,0,1,3,0,3,3,7.0,10.0
621,1961-1962,10,ADO Den Haag,DWS Amsterdam,3,0,1,3,0,3,3,7.0,5.0
622,1961-1962,10,Blauw Wit,Sparta Rotterdam,3,0,1,3,0,3,3,10.0,5.0
623,1961-1962,10,De Volewijckers,Sportclub Enschede,3,1,1,3,0,4,2,6.0,3.0
624,1961-1962,10,Feijenoord,Willem II,0,2,2,0,3,2,-2,10.0,9.0
625,1961-1962,10,Fortuna '54,FC Volendam,6,1,1,3,0,7,5,6.0,6.0
626,1961-1962,10,NAC Breda,AFC Ajax,1,3,2,0,3,4,-2,5.0,10.0
627,1961-1962,10,PSV,MVV Maastricht,2,1,1,3,0,3,1,9.0,4.0
628,1961-1962,10,Rapid JC Heerlen,DOS Utrecht,3,3,3,1,1,6,0,4.0,11.0
629,1961-1962,10,VVV-Venlo,Groninger VAV,2,0,1,3,0,2,2,9.0,7.0
630,1961-1962,11,AFC Ajax,Fortuna '54,3,4,2,0,3,7,-1,7.0,6.0
631,1961-1962,11,DOS Utrecht,Sparta Rotterdam,3,2,1,3,0,5,1,11.0,4.0
632,1961-1962,11,DWS Amsterdam,De Volewijckers,2,2,3,1,1,4,0,5.0,7.0
633,1961-1962,11,Feijenoord,Blauw Wit,9,1,1,3,0,10,8,10.0,7.0
634,1961-1962,11,Groninger VAV,ADO Den Haag,3,1,1,3,0,4,2,10.0,4.0
635,1961-1962,11,MVV Maastricht,VVV-Venlo,1,0,1,3,0,1,1,7.0,8.0
636,1961-1962,11,Sportclub Enschede,Rapid JC Heerlen,1,2,2,0,3,3,-1,3.0,7.0
637,1961-1962,11,FC Volendam,PSV,3,1,1,3,0,4,2,9.0,9.0
638,1961-1962,11,Willem II,NAC Breda,0,1,2,0,3,1,-1,6.0,7.0
639,1961-1962,12,ADO Den Haag,MVV Maastricht,0,1,2,0,3,1,-1,3.0,9.0
640,1961-1962,12,Blauw Wit,DOS Utrecht,2,1,1,3,0,3,1,9.0,10.0
641,1961-1962,12,De Volewijckers,Groninger VAV,1,1,3,1,1,2,0,8.0,10.0
642,1961-1962,12,Fortuna '54,Willem II,1,3,2,0,3,4,-2,6.0,9.0
643,1961-1962,12,NAC Breda,Feijenoord,2,3,2,0,3,5,-1,6.0,12.0
644,1961-1962,12,PSV,AFC Ajax,2,2,3,1,1,4,0,7.0,7.0
645,1961-1962,12,Rapid JC Heerlen,DWS Amsterdam,0,1,2,0,3,1,-1,4.0,5.0
646,1961-1962,12,Sparta Rotterdam,Sportclub Enschede,0,2,2,0,3,2,-2,3.0,6.0
647,1961-1962,12,VVV-Venlo,FC Volendam,0,0,3,1,1,0,0,8.0,7.0
648,1961-1962,13,AFC Ajax,VVV-Venlo,3,1,1,3,0,4,2,7.0,5.0
649,1961-1962,13,DWS Amsterdam,Sparta Rotterdam,0,0,3,1,1,0,0,6.0,4.0
650,1961-1962,13,Feijenoord,Fortuna '54,1,1,3,1,1,2,0,10.0,7.0
651,1961-1962,13,Groninger VAV,Rapid JC Heerlen,2,1,1,3,0,3,1,10.0,4.0
652,1961-1962,13,MVV Maastricht,De Volewijckers,2,1,1,3,0,3,1,12.0,5.0
653,1961-1962,13,NAC Breda,Blauw Wit,0,1,2,0,3,1,-1,3.0,9.0
654,1961-1962,13,Sportclub Enschede,DOS Utrecht,3,4,2,0,3,7,-1,6.0,10.0
655,1961-1962,13,FC Volendam,ADO Den Haag,3,2,1,3,0,5,1,10.0,3.0
656,1961-1962,13,Willem II,PSV,1,2,2,0,3,3,-1,9.0,7.0
657,1961-1962,14,ADO Den Haag,AFC Ajax,1,3,2,0,3,4,-2,3.0,10.0
658,1961-1962,14,Blauw Wit,Sportclub Enschede,1,1,3,1,1,2,0,10.0,4.0
659,1961-1962,14,De Volewijckers,FC Volendam,2,1,1,3,0,3,1,8.0,7.0
660,1961-1962,14,DOS Utrecht,DWS Amsterdam,2,2,3,1,1,4,0,8.0,6.0
661,1961-1962,14,Fortuna '54,NAC Breda,0,2,2,0,3,2,-2,7.0,6.0
662,1961-1962,14,PSV,Feijenoord,0,3,2,0,3,3,-3,7.0,10.0
663,1961-1962,14,Rapid JC Heerlen,MVV Maastricht,0,0,3,1,1,0,0,5.0,10.0
664,1961-1962,14,Sparta Rotterdam,Groninger VAV,3,1,1,3,0,4,2,4.0,7.0
665,1961-1962,14,VVV-Venlo,Willem II,2,4,2,0,3,6,-2,4.0,9.0
666,1961-1962,15,AFC Ajax,De Volewijckers,2,1,1,3,0,3,1,10.0,5.0
667,1961-1962,15,DWS Amsterdam,Sportclub Enschede,2,2,3,1,1,4,0,7.0,5.0
668,1961-1962,15,Feijenoord,VVV-Venlo,3,0,1,3,0,3,3,13.0,1.0
669,1961-1962,15,Fortuna '54,Blauw Wit,0,0,3,1,1,0,0,5.0,8.0
670,1961-1962,15,Groninger VAV,DOS Utrecht,3,0,1,3,0,3,3,10.0,7.0
671,1961-1962,15,MVV Maastricht,Sparta Rotterdam,1,1,3,1,1,2,0,11.0,5.0
672,1961-1962,15,NAC Breda,PSV,1,3,2,0,3,4,-2,6.0,7.0
673,1961-1962,15,FC Volendam,Rapid JC Heerlen,3,0,1,3,0,3,3,10.0,4.0
674,1961-1962,15,Willem II,ADO Den Haag,2,2,3,1,1,4,0,7.0,1.0
675,1961-1962,16,ADO Den Haag,Feijenoord,0,2,2,0,3,2,-2,1.0,13.0
676,1961-1962,16,De Volewijckers,Willem II,2,1,1,3,0,3,1,7.0,7.0
677,1961-1962,16,DOS Utrecht,MVV Maastricht,3,3,3,1,1,6,0,5.0,9.0
678,1961-1962,16,DWS Amsterdam,Blauw Wit,0,2,2,0,3,2,-2,6.0,11.0
679,1961-1962,16,PSV,Fortuna '54,0,1,2,0,3,1,-1,7.0,5.0
680,1961-1962,16,Rapid JC Heerlen,AFC Ajax,1,2,2,0,3,3,-1,1.0,13.0
681,1961-1962,16,Sportclub Enschede,Groninger VAV,0,1,2,0,3,1,-1,5.0,10.0
682,1961-1962,16,Sparta Rotterdam,FC Volendam,4,2,1,3,0,6,2,8.0,7.0
683,1961-1962,16,VVV-Venlo,NAC Breda,1,0,1,3,0,1,1,4.0,3.0
684,1961-1962,17,AFC Ajax,DOS Utrecht,3,2,1,3,0,5,1,15.0,5.0
685,1961-1962,17,Blauw Wit,Groninger VAV,2,1,1,3,0,3,1,11.0,9.0
686,1961-1962,17,Feijenoord,Rapid JC Heerlen,3,0,1,3,0,3,3,13.0,1.0
687,1961-1962,17,Fortuna '54,ADO Den Haag,3,0,1,3,0,3,3,8.0,1.0
688,1961-1962,17,MVV Maastricht,DWS Amsterdam,0,0,3,1,1,0,0,7.0,4.0
689,1961-1962,17,NAC Breda,De Volewijckers,1,2,2,0,3,3,-1,3.0,9.0
690,1961-1962,17,PSV,VVV-Venlo,2,1,1,3,0,3,1,9.0,3.0
691,1961-1962,17,FC Volendam,Sportclub Enschede,4,1,1,3,0,5,3,9.0,2.0
692,1961-1962,17,Willem II,Sparta Rotterdam,0,1,2,0,3,1,-1,4.0,11.0
693,1961-1962,18,ADO Den Haag,PSV,1,1,3,1,1,2,0,2.0,7.0
694,1961-1962,18,De Volewijckers,Fortuna '54,2,4,2,0,3,6,-2,9.0,10.0
695,1961-1962,18,DOS Utrecht,Willem II,3,1,1,3,0,4,2,5.0,4.0
696,1961-1962,18,DWS Amsterdam,FC Volendam,1,1,3,1,1,2,0,4.0,7.0
697,1961-1962,18,Groninger VAV,MVV Maastricht,2,2,3,1,1,4,0,7.0,5.0
698,1961-1962,18,Rapid JC Heerlen,NAC Breda,2,5,2,0,3,7,-3,1.0,6.0
699,1961-1962,18,Sportclub Enschede,AFC Ajax,2,0,1,3,0,2,2,5.0,12.0
700,1961-1962,18,Sparta Rotterdam,Feijenoord,1,3,2,0,3,4,-2,10.0,15.0
701,1961-1962,18,VVV-Venlo,Blauw Wit,1,5,2,0,3,6,-4,3.0,11.0
702,1961-1962,19,AFC Ajax,DWS Amsterdam,8,0,1,3,0,8,8,12.0,3.0
703,1961-1962,19,Blauw Wit,MVV Maastricht,3,1,1,3,0,4,2,13.0,4.0
704,1961-1962,19,Feijenoord,DOS Utrecht,3,0,1,3,0,3,3,15.0,4.0
705,1961-1962,19,Fortuna '54,Rapid JC Heerlen,0,1,2,0,3,1,-1,10.0,3.0
706,1961-1962,19,NAC Breda,Sparta Rotterdam,3,2,1,3,0,5,1,6.0,7.0
707,1961-1962,19,PSV,De Volewijckers,4,2,1,3,0,6,2,10.0,6.0
708,1961-1962,19,FC Volendam,Groninger VAV,5,2,1,3,0,7,3,10.0,7.0
709,1961-1962,19,VVV-Venlo,ADO Den Haag,1,1,3,1,1,2,0,4.0,3.0
710,1961-1962,19,Willem II,Sportclub Enschede,2,0,1,3,0,2,2,4.0,4.0
711,1961-1962,20,ADO Den Haag,Blauw Wit,1,4,2,0,3,5,-3,2.0,15.0
712,1961-1962,20,De Volewijckers,VVV-Venlo,1,0,1,3,0,1,1,9.0,4.0
713,1961-1962,20,DOS Utrecht,NAC Breda,2,3,2,0,3,5,-1,4.0,9.0
714,1961-1962,20,DWS Amsterdam,Willem II,0,2,2,0,3,2,-2,2.0,6.0
715,1961-1962,20,Groninger VAV,AFC Ajax,1,0,1,3,0,1,1,7.0,9.0
716,1961-1962,20,MVV Maastricht,FC Volendam,3,0,1,3,0,3,3,6.0,7.0
717,1961-1962,20,Rapid JC Heerlen,PSV,1,0,1,3,0,1,1,6.0,7.0
718,1961-1962,20,Sparta Rotterdam,Fortuna '54,3,1,1,3,0,4,2,9.0,9.0
719,1961-1962,20,Sportclub Enschede,Feijenoord,3,3,3,1,1,6,0,4.0,13.0
720,1961-1962,21,AFC Ajax,Sparta Rotterdam,3,0,1,3,0,3,3,9.0,6.0
721,1961-1962,21,Blauw Wit,PSV,1,2,2,0,3,3,-1,12.0,10.0
722,1961-1962,21,Feijenoord,De Volewijckers,6,0,1,3,0,6,6,13.0,6.0
723,1961-1962,21,Fortuna '54,VVV-Venlo,4,1,1,3,0,5,3,9.0,1.0
724,1961-1962,21,Groninger VAV,DWS Amsterdam,3,2,1,3,0,5,1,7.0,2.0
725,1961-1962,21,MVV Maastricht,Sportclub Enschede,1,2,2,0,3,3,-1,5.0,7.0
726,1961-1962,21,NAC Breda,ADO Den Haag,1,1,3,1,1,2,0,10.0,3.0
727,1961-1962,21,FC Volendam,DOS Utrecht,4,0,1,3,0,4,4,10.0,3.0
728,1961-1962,21,Willem II,Rapid JC Heerlen,0,0,3,1,1,0,0,7.0,7.0
729,1961-1962,22,ADO Den Haag,De Volewijckers,2,1,1,3,0,3,1,6.0,3.0
730,1961-1962,22,AFC Ajax,MVV Maastricht,0,2,2,0,3,2,-2,6.0,7.0
731,1961-1962,22,Blauw Wit,FC Volendam,4,2,1,3,0,6,2,12.0,7.0
732,1961-1962,22,Feijenoord,DWS Amsterdam,5,2,1,3,0,7,3,13.0,1.0
733,1961-1962,22,Fortuna '54,DOS Utrecht,2,2,3,1,1,4,0,7.0,4.0
734,1961-1962,22,NAC Breda,Sportclub Enschede,3,0,1,3,0,3,3,13.0,7.0
735,1961-1962,22,PSV,Sparta Rotterdam,4,0,1,3,0,4,4,10.0,3.0
736,1961-1962,22,VVV-Venlo,Rapid JC Heerlen,2,0,1,3,0,2,2,4.0,7.0
737,1961-1962,22,Willem II,Groninger VAV,1,1,3,1,1,2,0,8.0,8.0
738,1961-1962,23,De Volewijckers,Blauw Wit,3,3,3,1,1,6,0,4.0,10.0
739,1961-1962,23,DOS Utrecht,PSV,1,1,3,1,1,2,0,2.0,10.0
740,1961-1962,23,DWS Amsterdam,NAC Breda,0,3,2,0,3,3,-3,0.0,13.0
741,1961-1962,23,Groninger VAV,Feijenoord,1,1,3,1,1,2,0,8.0,11.0
742,1961-1962,23,MVV Maastricht,Willem II,1,0,1,3,0,1,1,9.0,8.0
743,1961-1962,23,Rapid JC Heerlen,ADO Den Haag,3,3,3,1,1,6,0,8.0,6.0
744,1961-1962,23,Sportclub Enschede,Fortuna '54,1,1,3,1,1,2,0,5.0,5.0
745,1961-1962,23,Sparta Rotterdam,VVV-Venlo,2,0,1,3,0,2,2,6.0,4.0
746,1961-1962,23,FC Volendam,AFC Ajax,4,0,1,3,0,4,4,9.0,6.0
747,1961-1962,24,ADO Den Haag,Sparta Rotterdam,1,0,1,3,0,1,1,8.0,6.0
748,1961-1962,24,Blauw Wit,AFC Ajax,2,2,3,1,1,4,0,8.0,4.0
749,1961-1962,24,Feijenoord,MVV Maastricht,3,2,1,3,0,5,1,11.0,9.0
750,1961-1962,24,Fortuna '54,DWS Amsterdam,2,2,3,1,1,4,0,6.0,1.0
751,1961-1962,24,NAC Breda,Groninger VAV,0,0,3,1,1,0,0,11.0,9.0
752,1961-1962,24,PSV,Sportclub Enschede,1,1,3,1,1,2,0,8.0,6.0
753,1961-1962,24,VVV-Venlo,DOS Utrecht,3,2,1,3,0,5,1,6.0,2.0
754,1961-1962,24,Willem II,FC Volendam,3,1,1,3,0,4,2,8.0,6.0
755,1961-1962,24,De Volewijckers,Rapid JC Heerlen,3,2,1,3,0,5,1,7.0,5.0
756,1961-1962,25,AFC Ajax,Willem II,3,2,1,3,0,5,1,7.0,5.0
757,1961-1962,25,DOS Utrecht,ADO Den Haag,2,2,3,1,1,4,0,3.0,9.0
758,1961-1962,25,DWS Amsterdam,PSV,0,0,3,1,1,0,0,2.0,9.0
759,1961-1962,25,Groninger VAV,Fortuna '54,0,0,3,1,1,0,0,7.0,7.0
760,1961-1962,25,MVV Maastricht,NAC Breda,2,2,3,1,1,4,0,7.0,9.0
761,1961-1962,25,Rapid JC Heerlen,Blauw Wit,2,3,2,0,3,5,-1,2.0,8.0
762,1961-1962,25,Sportclub Enschede,VVV-Venlo,2,0,1,3,0,2,2,8.0,6.0
763,1961-1962,25,Sparta Rotterdam,De Volewijckers,2,2,3,1,1,4,0,4.0,5.0
764,1961-1962,25,FC Volendam,Feijenoord,1,1,3,1,1,2,0,7.0,11.0
765,1961-1962,26,ADO Den Haag,Sportclub Enschede,2,2,3,1,1,4,0,9.0,6.0
766,1961-1962,26,Blauw Wit,Willem II,2,0,1,3,0,2,2,11.0,4.0
767,1961-1962,26,De Volewijckers,DOS Utrecht,3,0,1,3,0,3,3,8.0,3.0
768,1961-1962,26,Feijenoord,AFC Ajax,1,2,2,0,3,3,-1,8.0,7.0
769,1961-1962,26,Fortuna '54,MVV Maastricht,2,2,3,1,1,4,0,5.0,8.0
770,1961-1962,26,NAC Breda,FC Volendam,4,1,1,3,0,5,3,11.0,4.0
771,1961-1962,26,PSV,Groninger VAV,4,0,1,3,0,4,4,9.0,4.0
772,1961-1962,26,Rapid JC Heerlen,Sparta Rotterdam,0,2,2,0,3,2,-2,1.0,7.0
773,1961-1962,26,VVV-Venlo,DWS Amsterdam,3,1,1,3,0,4,2,9.0,2.0
774,1961-1962,27,AFC Ajax,NAC Breda,2,0,1,3,0,2,2,10.0,8.0
775,1961-1962,27,DOS Utrecht,Rapid JC Heerlen,5,0,1,3,0,5,5,5.0,1.0
776,1961-1962,27,DWS Amsterdam,ADO Den Haag,4,2,1,3,0,6,2,5.0,6.0
777,1961-1962,27,Groninger VAV,VVV-Venlo,1,1,3,1,1,2,0,4.0,7.0
778,1961-1962,27,MVV Maastricht,PSV,1,1,3,1,1,2,0,6.0,7.0
779,1961-1962,27,Sportclub Enschede,De Volewijckers,5,3,1,3,0,8,2,9.0,8.0
780,1961-1962,27,Sparta Rotterdam,Blauw Wit,0,0,3,1,1,0,0,8.0,9.0
781,1961-1962,27,FC Volendam,Fortuna '54,2,1,1,3,0,3,1,7.0,4.0
782,1961-1962,27,Willem II,Feijenoord,0,0,3,1,1,0,0,4.0,6.0
783,1961-1962,28,ADO Den Haag,Groninger VAV,2,2,3,1,1,4,0,6.0,4.0
784,1961-1962,28,Blauw Wit,Feijenoord,1,1,3,1,1,2,0,9.0,6.0
785,1961-1962,28,De Volewijckers,DWS Amsterdam,3,5,2,0,3,8,-2,7.0,8.0
786,1961-1962,28,Fortuna '54,AFC Ajax,2,2,3,1,1,4,0,4.0,11.0
787,1961-1962,28,NAC Breda,Willem II,2,0,1,3,0,2,2,8.0,4.0
788,1961-1962,28,PSV,FC Volendam,5,1,1,3,0,6,4,9.0,4.0
789,1961-1962,28,Rapid JC Heerlen,Sportclub Enschede,0,1,2,0,3,1,-1,0.0,11.0
790,1961-1962,28,Sparta Rotterdam,DOS Utrecht,0,0,3,1,1,0,0,6.0,5.0
791,1961-1962,28,VVV-Venlo,MVV Maastricht,2,3,2,0,3,5,-1,7.0,6.0
792,1961-1962,29,AFC Ajax,PSV,4,5,2,0,3,9,-1,10.0,11.0
793,1961-1962,29,DOS Utrecht,Blauw Wit,2,0,1,3,0,2,2,8.0,8.0
794,1961-1962,29,DWS Amsterdam,Rapid JC Heerlen,0,0,3,1,1,0,0,8.0,1.0
795,1961-1962,29,Feijenoord,NAC Breda,4,1,1,3,0,5,3,6.0,7.0
796,1961-1962,29,Groninger VAV,De Volewijckers,2,2,3,1,1,4,0,4.0,5.0
797,1961-1962,29,MVV Maastricht,ADO Den Haag,3,1,1,3,0,4,2,9.0,3.0
798,1961-1962,29,Sportclub Enschede,Sparta Rotterdam,0,0,3,1,1,0,0,11.0,7.0
799,1961-1962,29,FC Volendam,VVV-Venlo,5,0,1,3,0,5,5,7.0,4.0
800,1961-1962,29,Willem II,Fortuna '54,2,0,1,3,0,2,2,4.0,3.0
801,1961-1962,30,ADO Den Haag,FC Volendam,2,1,1,3,0,3,1,5.0,6.0
802,1961-1962,30,Blauw Wit,NAC Breda,0,2,2,0,3,2,-2,5.0,9.0
803,1961-1962,30,De Volewijckers,MVV Maastricht,2,0,1,3,0,2,2,7.0,8.0
804,1961-1962,30,DOS Utrecht,Sportclub Enschede,2,3,2,0,3,5,-1,7.0,11.0
805,1961-1962,30,Fortuna '54,Feijenoord,1,4,2,0,3,5,-3,2.0,8.0
806,1961-1962,30,PSV,Willem II,3,2,1,3,0,5,1,13.0,4.0
807,1961-1962,30,Rapid JC Heerlen,Groninger VAV,1,0,1,3,0,1,1,4.0,3.0
808,1961-1962,30,Sparta Rotterdam,DWS Amsterdam,2,0,1,3,0,2,2,9.0,7.0
809,1961-1962,30,VVV-Venlo,AFC Ajax,1,0,1,3,0,1,1,7.0,7.0
810,1961-1962,31,AFC Ajax,ADO Den Haag,1,2,2,0,3,3,-1,4.0,7.0
811,1961-1962,31,DWS Amsterdam,DOS Utrecht,0,0,3,1,1,0,0,8.0,8.0
812,1961-1962,31,Feijenoord,PSV,1,1,3,1,1,2,0,9.0,11.0
813,1961-1962,31,Groninger VAV,Sparta Rotterdam,0,3,2,0,3,3,-3,3.0,9.0
814,1961-1962,31,MVV Maastricht,Rapid JC Heerlen,0,0,3,1,1,0,0,8.0,5.0
815,1961-1962,31,NAC Breda,Fortuna '54,0,0,3,1,1,0,0,7.0,2.0
816,1961-1962,31,Sportclub Enschede,Blauw Wit,2,1,1,3,0,3,1,13.0,2.0
817,1961-1962,31,FC Volendam,De Volewijckers,1,2,2,0,3,3,-1,6.0,7.0
818,1961-1962,31,Willem II,VVV-Venlo,1,2,2,0,3,3,-1,4.0,7.0
819,1961-1962,32,ADO Den Haag,Willem II,0,3,2,0,3,3,-3,7.0,6.0
820,1961-1962,32,Blauw Wit,Fortuna '54,7,0,1,3,0,7,7,4.0,2.0
821,1961-1962,32,De Volewijckers,AFC Ajax,3,1,1,3,0,4,2,10.0,1.0
822,1961-1962,32,DOS Utrecht,Groninger VAV,2,1,1,3,0,3,1,8.0,2.0
823,1961-1962,32,PSV,NAC Breda,4,1,1,3,0,5,3,13.0,7.0
824,1961-1962,32,Rapid JC Heerlen,FC Volendam,1,3,2,0,3,4,-2,5.0,6.0
825,1961-1962,32,Sportclub Enschede,DWS Amsterdam,6,1,1,3,0,7,5,13.0,5.0
826,1961-1962,32,Sparta Rotterdam,MVV Maastricht,1,0,1,3,0,1,1,11.0,7.0
827,1961-1962,32,VVV-Venlo,Feijenoord,1,0,1,3,0,1,1,9.0,8.0
828,1961-1962,33,AFC Ajax,Rapid JC Heerlen,2,2,3,1,1,4,0,1.0,6.0
829,1961-1962,33,Blauw Wit,DWS Amsterdam,1,2,2,0,3,3,-1,3.0,5.0
830,1961-1962,33,Feijenoord,ADO Den Haag,1,1,3,1,1,2,0,8.0,7.0
831,1961-1962,33,Fortuna '54,PSV,1,3,2,0,3,4,-2,1.0,13.0
832,1961-1962,33,Groninger VAV,Sportclub Enschede,1,1,3,1,1,2,0,2.0,11.0
833,1961-1962,33,MVV Maastricht,DOS Utrecht,1,1,3,1,1,2,0,5.0,8.0
834,1961-1962,33,NAC Breda,VVV-Venlo,4,1,1,3,0,5,3,7.0,9.0
835,1961-1962,33,FC Volendam,Sparta Rotterdam,1,0,1,3,0,1,1,9.0,10.0
836,1961-1962,33,Willem II,De Volewijckers,4,5,2,0,3,9,-1,6.0,13.0
837,1961-1962,34,ADO Den Haag,NAC Breda,2,3,2,0,3,5,-1,7.0,10.0
838,1961-1962,34,De Volewijckers,Feijenoord,3,0,1,3,0,3,3,15.0,5.0
839,1961-1962,34,DOS Utrecht,FC Volendam,6,2,1,3,0,8,4,8.0,6.0
840,1961-1962,34,DWS Amsterdam,Groninger VAV,2,0,1,3,0,2,2,7.0,1.0
841,1961-1962,34,PSV,Blauw Wit,2,1,1,3,0,3,1,13.0,3.0
842,1961-1962,34,Rapid JC Heerlen,Willem II,1,5,2,0,3,6,-4,5.0,6.0
843,1961-1962,34,Sportclub Enschede,MVV Maastricht,1,6,2,0,3,7,-5,10.0,5.0
844,1961-1962,34,Sparta Rotterdam,AFC Ajax,4,0,1,3,0,4,4,12.0,1.0
845,1961-1962,34,VVV-Venlo,Fortuna '54,3,0,1,3,0,3,3,12.0,1.0
846,1962-1963,1,ADO Den Haag,PSV,1,3,2,0,3,4,-2,4.0,13.0
847,1962-1963,1,AFC Ajax,Heracles Almelo,1,0,1,3,0,1,1,4.0,
848,1962-1963,1,Groninger VAV,DOS Utrecht,3,1,1,3,0,4,2,4.0,8.0
849,1962-1963,1,MVV Maastricht,De Volewijckers,3,1,1,3,0,4,2,8.0,12.0
850,1962-1963,1,NAC Breda,Willem II,2,2,3,1,1,4,0,8.0,7.0
851,1962-1963,1,Sportclub Enschede,Feijenoord,1,2,2,0,3,3,-1,7.0,5.0
852,1962-1963,1,Sparta Rotterdam,Blauw Wit,4,1,1,3,0,5,3,12.0,3.0
853,1962-1963,1,FC Volendam,Fortuna '54,1,1,3,1,1,2,0,7.0,2.0
854,1962-1963,2,Blauw Wit,Sportclub Enschede,1,7,2,0,3,8,-6,3.0,7.0
855,1962-1963,2,De Volewijckers,Sparta Rotterdam,2,2,3,1,1,4,0,10.0,10.0
856,1962-1963,2,DOS Utrecht,MVV Maastricht,1,0,1,3,0,1,1,10.0,7.0
857,1962-1963,2,Feijenoord,AFC Ajax,1,1,3,1,1,2,0,5.0,5.0
858,1962-1963,2,Fortuna '54,ADO Den Haag,1,0,1,3,0,1,1,4.0,1.0
859,1962-1963,2,Heracles Almelo,FC Volendam,1,1,3,1,1,2,0,,8.0
860,1962-1963,2,PSV,NAC Breda,1,2,2,0,3,3,-1,12.0,10.0
861,1962-1963,2,Willem II,Groninger VAV,3,0,1,3,0,3,3,10.0,4.0
862,1962-1963,3,ADO Den Haag,Heracles Almelo,1,0,1,3,0,1,1,4.0,
863,1962-1963,3,Blauw Wit,Feijenoord,1,0,1,3,0,1,1,3.0,5.0
864,1962-1963,3,Groninger VAV,PSV,1,1,3,1,1,2,0,5.0,10.0
865,1962-1963,3,MVV Maastricht,Willem II,4,1,1,3,0,5,3,10.0,7.0
866,1962-1963,3,NAC Breda,Fortuna '54,0,2,2,0,3,2,-2,10.0,7.0
867,1962-1963,3,Sportclub Enschede,De Volewijckers,4,0,1,3,0,4,4,7.0,7.0
868,1962-1963,3,Sparta Rotterdam,DOS Utrecht,5,1,1,3,0,6,4,10.0,7.0
869,1962-1963,3,FC Volendam,AFC Ajax,4,5,2,0,3,9,-1,5.0,8.0
870,1962-1963,4,AFC Ajax,ADO Den Haag,1,0,1,3,0,1,1,10.0,3.0
871,1962-1963,4,De Volewijckers,Blauw Wit,2,1,1,3,0,3,1,7.0,3.0
872,1962-1963,4,DOS Utrecht,Sportclub Enschede,2,1,1,3,0,3,1,9.0,6.0
873,1962-1963,4,Feijenoord,FC Volendam,2,5,2,0,3,7,-3,4.0,5.0
874,1962-1963,4,Fortuna '54,Groninger VAV,2,1,1,3,0,3,1,10.0,4.0
875,1962-1963,4,Heracles Almelo,NAC Breda,3,2,1,3,0,5,1,,7.0
876,1962-1963,4,PSV,MVV Maastricht,2,0,1,3,0,2,2,10.0,9.0
877,1962-1963,4,Willem II,Sparta Rotterdam,1,1,3,1,1,2,0,8.0,11.0
878,1962-1963,5,ADO Den Haag,FC Volendam,0,0,3,1,1,0,0,4.0,6.0
879,1962-1963,5,Blauw Wit,DOS Utrecht,1,1,3,1,1,2,0,4.0,7.0
880,1962-1963,5,De Volewijckers,Feijenoord,1,4,2,0,3,5,-3,4.0,7.0
881,1962-1963,5,Groninger VAV,Heracles Almelo,2,1,1,3,0,3,1,7.0,4.0
882,1962-1963,5,MVV Maastricht,Fortuna '54,3,0,1,3,0,3,3,9.0,10.0
883,1962-1963,5,NAC Breda,AFC Ajax,2,0,1,3,0,2,2,7.0,10.0
884,1962-1963,5,Sportclub Enschede,Willem II,5,2,1,3,0,7,3,9.0,5.0
885,1962-1963,5,Sparta Rotterdam,PSV,0,0,3,1,1,0,0,9.0,8.0
886,1962-1963,6,AFC Ajax,Groninger VAV,0,0,3,1,1,0,0,8.0,5.0
887,1962-1963,6,DOS Utrecht,De Volewijckers,3,1,1,3,0,4,2,10.0,4.0
888,1962-1963,6,Feijenoord,ADO Den Haag,1,1,3,1,1,2,0,5.0,5.0
889,1962-1963,6,Fortuna '54,Sparta Rotterdam,1,2,2,0,3,3,-1,9.0,9.0
890,1962-1963,6,Heracles Almelo,MVV Maastricht,4,1,1,3,0,5,3,7.0,6.0
891,1962-1963,6,PSV,Sportclub Enschede,2,3,2,0,3,5,-1,5.0,12.0
892,1962-1963,6,FC Volendam,NAC Breda,2,0,1,3,0,2,2,8.0,6.0
893,1962-1963,6,Willem II,Blauw Wit,1,2,2,0,3,3,-1,4.0,7.0
894,1962-1963,7,Blauw Wit,PSV,1,3,2,0,3,4,-2,7.0,8.0
895,1962-1963,7,De Volewijckers,Willem II,0,4,2,0,3,4,-4,3.0,4.0
896,1962-1963,7,DOS Utrecht,Feijenoord,1,0,1,3,0,1,1,10.0,4.0
897,1962-1963,7,Groninger VAV,FC Volendam,2,2,3,1,1,4,0,6.0,8.0
898,1962-1963,7,MVV Maastricht,AFC Ajax,2,2,3,1,1,4,0,7.0,8.0
899,1962-1963,7,NAC Breda,ADO Den Haag,0,0,3,1,1,0,0,4.0,6.0
900,1962-1963,7,Sportclub Enschede,Fortuna '54,2,0,1,3,0,2,2,12.0,6.0
901,1962-1963,7,Sparta Rotterdam,Heracles Almelo,2,1,1,3,0,3,1,11.0,6.0
902,1962-1963,8,ADO Den Haag,Groninger VAV,5,2,1,3,0,7,3,6.0,5.0
903,1962-1963,8,AFC Ajax,Sparta Rotterdam,1,2,2,0,3,3,-1,5.0,11.0
904,1962-1963,8,Feijenoord,NAC Breda,1,1,3,1,1,2,0,5.0,5.0
905,1962-1963,8,Fortuna '54,Blauw Wit,2,1,1,3,0,3,1,6.0,4.0
906,1962-1963,8,Heracles Almelo,Sportclub Enschede,3,2,1,3,0,5,1,9.0,9.0
907,1962-1963,8,PSV,De Volewijckers,4,1,1,3,0,5,3,10.0,3.0
908,1962-1963,8,FC Volendam,MVV Maastricht,1,1,3,1,1,2,0,9.0,5.0
909,1962-1963,8,Willem II,DOS Utrecht,1,3,2,0,3,4,-2,4.0,13.0
910,1962-1963,9,Blauw Wit,Heracles Almelo,4,1,1,3,0,5,3,7.0,6.0
911,1962-1963,9,De Volewijckers,Fortuna '54,0,3,2,0,3,3,-3,0.0,6.0
912,1962-1963,9,DOS Utrecht,PSV,2,0,1,3,0,2,2,13.0,7.0
913,1962-1963,9,Groninger VAV,NAC Breda,1,0,1,3,0,1,1,8.0,5.0
914,1962-1963,9,MVV Maastricht,ADO Den Haag,1,2,2,0,3,3,-1,5.0,9.0
915,1962-1963,9,Sportclub Enschede,AFC Ajax,0,6,2,0,3,6,-6,9.0,5.0
916,1962-1963,9,Sparta Rotterdam,FC Volendam,3,2,1,3,0,5,1,13.0,6.0
917,1962-1963,9,Willem II,Feijenoord,1,1,3,1,1,2,0,4.0,6.0
918,1962-1963,10,ADO Den Haag,Sparta Rotterdam,1,0,1,3,0,1,1,11.0,12.0
919,1962-1963,10,AFC Ajax,Blauw Wit,3,0,1,3,0,3,3,8.0,6.0
920,1962-1963,10,Feijenoord,Groninger VAV,2,1,1,3,0,3,1,6.0,5.0
921,1962-1963,10,Fortuna '54,DOS Utrecht,1,2,2,0,3,3,-1,6.0,15.0
922,1962-1963,10,Heracles Almelo,De Volewijckers,7,1,1,3,0,8,6,9.0,0.0
923,1962-1963,10,NAC Breda,MVV Maastricht,4,2,1,3,0,6,2,5.0,2.0
924,1962-1963,10,PSV,Willem II,5,2,1,3,0,7,3,9.0,4.0
925,1962-1963,10,FC Volendam,Sportclub Enschede,1,3,2,0,3,4,-2,5.0,9.0
926,1962-1963,11,Blauw Wit,FC Volendam,5,0,1,3,0,5,5,6.0,2.0
927,1962-1963,11,De Volewijckers,AFC Ajax,0,5,2,0,3,5,-5,0.0,10.0
928,1962-1963,11,DOS Utrecht,Heracles Almelo,2,0,1,3,0,2,2,15.0,6.0
929,1962-1963,11,MVV Maastricht,Groninger VAV,4,1,1,3,0,5,3,5.0,4.0
930,1962-1963,11,PSV,Feijenoord,2,1,1,3,0,3,1,12.0,5.0
931,1962-1963,11,Sportclub Enschede,ADO Den Haag,1,0,1,3,0,1,1,9.0,10.0
932,1962-1963,11,Sparta Rotterdam,NAC Breda,5,5,3,1,1,10,0,10.0,6.0
933,1962-1963,11,Willem II,Fortuna '54,2,3,2,0,3,5,-1,4.0,9.0
934,1962-1963,12,ADO Den Haag,Blauw Wit,3,4,2,0,3,7,-1,9.0,9.0
935,1962-1963,12,AFC Ajax,DOS Utrecht,2,1,1,3,0,3,1,12.0,12.0
936,1962-1963,12,Feijenoord,MVV Maastricht,1,0,1,3,0,1,1,8.0,4.0
937,1962-1963,12,Fortuna '54,PSV,0,2,2,0,3,2,-2,9.0,12.0
938,1962-1963,12,Groninger VAV,Sparta Rotterdam,2,0,1,3,0,2,2,6.0,7.0
939,1962-1963,12,Heracles Almelo,Willem II,3,3,3,1,1,6,0,7.0,2.0
940,1962-1963,12,NAC Breda,Sportclub Enschede,0,1,2,0,3,1,-1,5.0,9.0
941,1962-1963,12,FC Volendam,De Volewijckers,5,0,1,3,0,5,5,4.0,0.0
942,1962-1963,13,Blauw Wit,NAC Breda,1,1,3,1,1,2,0,10.0,5.0
943,1962-1963,13,De Volewijckers,ADO Den Haag,0,2,2,0,3,2,-2,0.0,9.0
944,1962-1963,13,DOS Utrecht,FC Volendam,3,2,1,3,0,5,1,12.0,3.0
945,1962-1963,13,Fortuna '54,Feijenoord,3,2,1,3,0,5,1,9.0,7.0
946,1962-1963,13,PSV,Heracles Almelo,2,2,3,1,1,4,0,10.0,5.0
947,1962-1963,13,Sportclub Enschede,Groninger VAV,2,2,3,1,1,4,0,10.0,7.0
948,1962-1963,13,Sparta Rotterdam,MVV Maastricht,3,2,1,3,0,5,1,7.0,3.0
949,1962-1963,13,Willem II,AFC Ajax,2,3,2,0,3,5,-1,2.0,15.0
950,1962-1963,14,Blauw Wit,MVV Maastricht,1,2,2,0,3,3,-1,7.0,6.0
951,1962-1963,14,De Volewijckers,Groninger VAV,0,5,2,0,3,5,-5,0.0,7.0
952,1962-1963,14,DOS Utrecht,NAC Breda,1,3,2,0,3,4,-2,9.0,8.0
953,1962-1963,14,Feijenoord,Heracles Almelo,6,2,1,3,0,8,4,9.0,5.0
954,1962-1963,14,Fortuna '54,AFC Ajax,1,0,1,3,0,1,1,9.0,12.0
955,1962-1963,14,PSV,FC Volendam,4,2,1,3,0,6,2,13.0,3.0
956,1962-1963,14,Sportclub Enschede,Sparta Rotterdam,3,1,1,3,0,4,2,13.0,4.0
957,1962-1963,14,Willem II,ADO Den Haag,2,2,3,1,1,4,0,2.0,7.0
958,1962-1963,15,ADO Den Haag,DOS Utrecht,0,2,2,0,3,2,-2,4.0,9.0
959,1962-1963,15,AFC Ajax,PSV,1,1,3,1,1,2,0,10.0,11.0
960,1962-1963,15,Groninger VAV,Blauw Wit,1,2,2,0,3,3,-1,7.0,10.0
961,1962-1963,15,Heracles Almelo,Fortuna '54,0,4,2,0,3,4,-4,2.0,12.0
962,1962-1963,15,MVV Maastricht,Sportclub Enschede,1,1,3,1,1,2,0,7.0,11.0
963,1962-1963,15,NAC Breda,De Volewijckers,2,1,1,3,0,3,1,8.0,0.0
964,1962-1963,15,Sparta Rotterdam,Feijenoord,3,0,1,3,0,3,3,7.0,6.0
965,1962-1963,15,FC Volendam,Willem II,1,1,3,1,1,2,0,4.0,3.0
966,1962-1963,16,Blauw Wit,Sparta Rotterdam,0,5,2,0,3,5,-5,7.0,9.0
967,1962-1963,16,De Volewijckers,MVV Maastricht,2,3,2,0,3,5,-1,0.0,7.0
968,1962-1963,16,DOS Utrecht,Groninger VAV,3,0,1,3,0,3,3,9.0,7.0
969,1962-1963,16,Feijenoord,Sportclub Enschede,1,1,3,1,1,2,0,7.0,9.0
970,1962-1963,16,Fortuna '54,FC Volendam,2,2,3,1,1,4,0,10.0,5.0
971,1962-1963,16,Heracles Almelo,AFC Ajax,0,2,2,0,3,2,-2,2.0,10.0
972,1962-1963,16,PSV,ADO Den Haag,2,0,1,3,0,2,2,11.0,4.0
973,1962-1963,16,Willem II,NAC Breda,2,3,2,0,3,5,-1,3.0,10.0
974,1962-1963,17,ADO Den Haag,Fortuna '54,3,0,1,3,0,3,3,7.0,10.0
975,1962-1963,17,AFC Ajax,Feijenoord,1,3,2,0,3,4,-2,7.0,7.0
976,1962-1963,17,Groninger VAV,Willem II,2,0,1,3,0,2,2,7.0,2.0
977,1962-1963,17,MVV Maastricht,DOS Utrecht,2,2,3,1,1,4,0,8.0,10.0
978,1962-1963,17,NAC Breda,PSV,3,3,3,1,1,6,0,11.0,9.0
979,1962-1963,17,Sportclub Enschede,Blauw Wit,0,1,2,0,3,1,-1,6.0,7.0
980,1962-1963,17,Sparta Rotterdam,De Volewijckers,4,0,1,3,0,4,4,12.0,0.0
981,1962-1963,17,FC Volendam,Heracles Almelo,2,2,3,1,1,4,0,3.0,2.0
982,1962-1963,18,AFC Ajax,FC Volendam,1,3,2,0,3,4,-2,4.0,6.0
983,1962-1963,18,De Volewijckers,Sportclub Enschede,1,4,2,0,3,5,-3,0.0,8.0
984,1962-1963,18,DOS Utrecht,Sparta Rotterdam,2,0,1,3,0,2,2,10.0,9.0
985,1962-1963,18,Feijenoord,Blauw Wit,2,0,1,3,0,2,2,10.0,6.0
986,1962-1963,18,Fortuna '54,NAC Breda,3,1,1,3,0,4,2,10.0,10.0
987,1962-1963,18,Heracles Almelo,ADO Den Haag,1,2,2,0,3,3,-1,1.0,7.0
988,1962-1963,18,PSV,Groninger VAV,3,1,1,3,0,4,2,11.0,6.0
989,1962-1963,18,Willem II,MVV Maastricht,4,2,1,3,0,6,2,5.0,8.0
990,1962-1963,19,ADO Den Haag,AFC Ajax,2,2,3,1,1,4,0,7.0,5.0
991,1962-1963,19,Blauw Wit,De Volewijckers,1,1,3,1,1,2,0,7.0,1.0
992,1962-1963,19,Groninger VAV,Fortuna '54,4,2,1,3,0,6,2,6.0,7.0
993,1962-1963,19,MVV Maastricht,PSV,1,1,3,1,1,2,0,6.0,9.0
994,1962-1963,19,NAC Breda,Heracles Almelo,1,1,3,1,1,2,0,8.0,2.0
995,1962-1963,19,Sportclub Enschede,DOS Utrecht,2,0,1,3,0,2,2,8.0,10.0
996,1962-1963,19,Sparta Rotterdam,Willem II,2,1,1,3,0,3,1,12.0,4.0
997,1962-1963,19,FC Volendam,Feijenoord,0,3,2,0,3,3,-3,6.0,10.0
998,1962-1963,20,AFC Ajax,NAC Breda,1,3,2,0,3,4,-2,4.0,8.0
999,1962-1963,20,DOS Utrecht,Blauw Wit,1,0,1,3,0,1,1,10.0,4.0
1000,1962-1963,20,Feijenoord,De Volewijckers,4,0,1,3,0,4,4,13.0,1.0
1001,1962-1963,20,Fortuna '54,MVV Maastricht,1,0,1,3,0,1,1,7.0,5.0
1002,1962-1963,20,Heracles Almelo,Groninger VAV,3,1,1,3,0,4,2,5.0,6.0
1003,1962-1963,20,PSV,Sparta Rotterdam,0,1,2,0,3,1,-1,8.0,12.0
1004,1962-1963,20,FC Volendam,ADO Den Haag,1,0,1,3,0,1,1,8.0,7.0
1005,1962-1963,20,Willem II,Sportclub Enschede,2,3,2,0,3,5,-1,3.0,10.0
1006,1962-1963,21,ADO Den Haag,Feijenoord,1,1,3,1,1,2,0,8.0,13.0
1007,1962-1963,21,Blauw Wit,Willem II,2,3,2,0,3,5,-1,4.0,6.0
1008,1962-1963,21,De Volewijckers,DOS Utrecht,2,2,3,1,1,4,0,2.0,8.0
1009,1962-1963,21,Groninger VAV,AFC Ajax,1,2,2,0,3,3,-1,6.0,4.0
1010,1962-1963,21,MVV Maastricht,Heracles Almelo,1,1,3,1,1,2,0,3.0,6.0
1011,1962-1963,21,NAC Breda,FC Volendam,1,1,3,1,1,2,0,6.0,8.0
1012,1962-1963,21,Sportclub Enschede,PSV,1,2,2,0,3,3,-1,9.0,8.0
1013,1962-1963,21,Sparta Rotterdam,Fortuna '54,2,0,1,3,0,2,2,12.0,6.0
1014,1962-1963,22,ADO Den Haag,NAC Breda,2,3,2,0,3,5,-1,5.0,8.0
1015,1962-1963,22,AFC Ajax,MVV Maastricht,3,1,1,3,0,4,2,7.0,2.0
1016,1962-1963,22,Feijenoord,DOS Utrecht,3,0,1,3,0,3,3,13.0,7.0
1017,1962-1963,22,Fortuna '54,Sportclub Enschede,2,2,3,1,1,4,0,7.0,10.0
1018,1962-1963,22,Heracles Almelo,Sparta Rotterdam,1,2,2,0,3,3,-1,5.0,12.0
1019,1962-1963,22,PSV,Blauw Wit,2,5,2,0,3,7,-3,7.0,4.0
1020,1962-1963,22,FC Volendam,Groninger VAV,0,2,2,0,3,2,-2,7.0,6.0
1021,1962-1963,22,Willem II,De Volewijckers,3,1,1,3,0,4,2,9.0,2.0
1022,1962-1963,23,Blauw Wit,Fortuna '54,5,0,1,3,0,5,5,7.0,4.0
1023,1962-1963,23,De Volewijckers,PSV,0,2,2,0,3,2,-2,2.0,7.0
1024,1962-1963,23,DOS Utrecht,Willem II,0,0,3,1,1,0,0,5.0,7.0
1025,1962-1963,23,Groninger VAV,ADO Den Haag,3,1,1,3,0,4,2,9.0,2.0
1026,1962-1963,23,MVV Maastricht,FC Volendam,2,1,1,3,0,3,1,5.0,4.0
1027,1962-1963,23,NAC Breda,Feijenoord,1,2,2,0,3,3,-1,8.0,13.0
1028,1962-1963,23,Sportclub Enschede,Heracles Almelo,0,0,3,1,1,0,0,8.0,6.0
1029,1962-1963,23,Sparta Rotterdam,AFC Ajax,2,1,1,3,0,3,1,15.0,7.0
1030,1962-1963,24,ADO Den Haag,MVV Maastricht,5,0,1,3,0,5,5,4.0,4.0
1031,1962-1963,24,AFC Ajax,Sportclub Enschede,2,0,1,3,0,2,2,9.0,5.0
1032,1962-1963,24,Feijenoord,Willem II,3,2,1,3,0,5,1,13.0,7.0
1033,1962-1963,24,Fortuna '54,De Volewijckers,2,2,3,1,1,4,0,5.0,2.0
1034,1962-1963,24,Heracles Almelo,Blauw Wit,4,3,1,3,0,7,1,8.0,6.0
1035,1962-1963,24,NAC Breda,Groninger VAV,0,2,2,0,3,2,-2,7.0,9.0
1036,1962-1963,24,PSV,DOS Utrecht,6,0,1,3,0,6,6,9.0,5.0
1037,1962-1963,24,FC Volendam,Sparta Rotterdam,2,1,1,3,0,3,1,7.0,12.0
1038,1962-1963,25,Blauw Wit,AFC Ajax,0,3,2,0,3,3,-3,6.0,12.0
1039,1962-1963,25,De Volewijckers,Heracles Almelo,3,4,2,0,3,7,-1,2.0,8.0
1040,1962-1963,25,DOS Utrecht,Fortuna '54,0,2,2,0,3,2,-2,2.0,5.0
1041,1962-1963,25,Groninger VAV,Feijenoord,1,1,3,1,1,2,0,10.0,11.0
1042,1962-1963,25,MVV Maastricht,NAC Breda,1,3,2,0,3,4,-2,4.0,7.0
1043,1962-1963,25,Sportclub Enschede,FC Volendam,1,1,3,1,1,2,0,3.0,5.0
1044,1962-1963,25,Sparta Rotterdam,ADO Den Haag,1,1,3,1,1,2,0,10.0,5.0
1045,1962-1963,25,Willem II,PSV,0,2,2,0,3,2,-2,7.0,12.0
1046,1962-1963,26,ADO Den Haag,Sportclub Enschede,2,2,3,1,1,4,0,5.0,4.0
1047,1962-1963,26,AFC Ajax,De Volewijckers,6,2,1,3,0,8,4,12.0,1.0
1048,1962-1963,26,Feijenoord,PSV,2,2,3,1,1,4,0,11.0,10.0
1049,1962-1963,26,Fortuna '54,Willem II,1,4,2,0,3,5,-3,5.0,7.0
1050,1962-1963,26,Groninger VAV,MVV Maastricht,0,1,2,0,3,1,-1,10.0,6.0
1051,1962-1963,26,Heracles Almelo,DOS Utrecht,2,1,1,3,0,3,1,10.0,1.0
1052,1962-1963,26,NAC Breda,Sparta Rotterdam,3,1,1,3,0,4,2,9.0,7.0
1053,1962-1963,26,FC Volendam,Blauw Wit,0,1,2,0,3,1,-1,4.0,9.0
1054,1962-1963,27,Blauw Wit,ADO Den Haag,1,0,1,3,0,1,1,9.0,5.0
1055,1962-1963,27,De Volewijckers,FC Volendam,2,3,2,0,3,5,-1,1.0,7.0
1056,1962-1963,27,DOS Utrecht,AFC Ajax,0,3,2,0,3,3,-3,1.0,12.0
1057,1962-1963,27,MVV Maastricht,Feijenoord,1,1,3,1,1,2,0,7.0,9.0
1058,1962-1963,27,PSV,Fortuna '54,1,0,1,3,0,1,1,13.0,4.0
1059,1962-1963,27,Sportclub Enschede,NAC Breda,1,1,3,1,1,2,0,4.0,7.0
1060,1962-1963,27,Sparta Rotterdam,Groninger VAV,0,1,2,0,3,1,-1,4.0,10.0
1061,1962-1963,27,Willem II,Heracles Almelo,1,0,1,3,0,1,1,7.0,10.0
1062,1962-1963,28,ADO Den Haag,De Volewijckers,3,0,1,3,0,3,3,8.0,1.0
1063,1962-1963,28,AFC Ajax,Willem II,7,0,1,3,0,7,7,15.0,6.0
1064,1962-1963,28,Feijenoord,Fortuna '54,2,1,1,3,0,3,1,9.0,4.0
1065,1962-1963,28,Groninger VAV,Sportclub Enschede,3,3,3,1,1,6,0,8.0,4.0
1066,1962-1963,28,Heracles Almelo,PSV,2,2,3,1,1,4,0,10.0,11.0
1067,1962-1963,28,MVV Maastricht,Sparta Rotterdam,1,0,1,3,0,1,1,7.0,1.0
1068,1962-1963,28,NAC Breda,Blauw Wit,1,1,3,1,1,2,0,8.0,7.0
1069,1962-1963,28,FC Volendam,DOS Utrecht,0,0,3,1,1,0,0,8.0,1.0
1070,1962-1963,29,Blauw Wit,Groninger VAV,2,1,1,3,0,3,1,10.0,5.0
1071,1962-1963,29,De Volewijckers,NAC Breda,4,1,1,3,0,5,3,3.0,8.0
1072,1962-1963,29,DOS Utrecht,ADO Den Haag,0,0,3,1,1,0,0,2.0,6.0
1073,1962-1963,29,Feijenoord,Sparta Rotterdam,0,2,2,0,3,2,-2,6.0,4.0
1074,1962-1963,29,Fortuna '54,Heracles Almelo,1,2,2,0,3,3,-1,3.0,10.0
1075,1962-1963,29,PSV,AFC Ajax,5,2,1,3,0,7,3,11.0,12.0
1076,1962-1963,29,Sportclub Enschede,MVV Maastricht,0,1,2,0,3,1,-1,4.0,10.0
1077,1962-1963,29,Willem II,FC Volendam,2,4,2,0,3,6,-2,6.0,8.0
1078,1962-1963,30,ADO Den Haag,Willem II,1,1,3,1,1,2,0,6.0,7.0
1079,1962-1963,30,AFC Ajax,Fortuna '54,6,3,1,3,0,9,3,12.0,0.0
1080,1962-1963,30,Groninger VAV,De Volewijckers,6,1,1,3,0,7,5,7.0,3.0
1081,1962-1963,30,Heracles Almelo,Feijenoord,3,6,2,0,3,9,-3,7.0,8.0
1082,1962-1963,30,MVV Maastricht,Blauw Wit,2,0,1,3,0,2,2,13.0,10.0
1083,1962-1963,30,NAC Breda,DOS Utrecht,2,0,1,3,0,2,2,8.0,2.0
1084,1962-1963,30,Sparta Rotterdam,Sportclub Enschede,4,2,1,3,0,6,2,6.0,3.0
1085,1962-1963,30,FC Volendam,PSV,1,2,2,0,3,3,-1,7.0,11.0
1086,1963-1964,1,ADO Den Haag,FC Volendam,3,1,1,3,0,4,2,8.0,7.0
1087,1963-1964,1,DWS Amsterdam,Heracles Almelo,2,1,1,3,0,3,1,10.0,4.0
1088,1963-1964,1,Fortuna '54,AFC Ajax,2,1,1,3,0,3,1,3.0,9.0
1089,1963-1964,1,Go Ahead Eagles,MVV Maastricht,1,3,2,0,3,4,-2,,13.0
1090,1963-1964,1,Groninger VAV,Feijenoord,3,0,1,3,0,3,3,10.0,7.0
1091,1963-1964,1,NAC Breda,PSV,0,1,2,0,3,1,-1,5.0,13.0
1092,1963-1964,1,Sportclub Enschede,Blauw Wit,1,0,1,3,0,1,1,5.0,7.0
1093,1963-1964,1,Sparta Rotterdam,DOS Utrecht,1,3,2,0,3,4,-2,6.0,5.0
1094,1963-1964,2,AFC Ajax,ADO Den Haag,3,0,1,3,0,3,3,9.0,8.0
1095,1963-1964,2,Blauw Wit,Sparta Rotterdam,3,2,1,3,0,5,1,7.0,6.0
1096,1963-1964,2,DOS Utrecht,Groninger VAV,2,1,1,3,0,3,1,8.0,7.0
1097,1963-1964,2,Feijenoord,DWS Amsterdam,0,1,2,0,3,1,-1,6.0,12.0
1098,1963-1964,2,Heracles Almelo,Fortuna '54,1,3,2,0,3,4,-2,4.0,6.0
1099,1963-1964,2,MVV Maastricht,Sportclub Enschede,3,0,1,3,0,3,3,15.0,4.0
1100,1963-1964,2,PSV,Go Ahead Eagles,5,0,1,3,0,5,5,13.0,
1101,1963-1964,2,FC Volendam,NAC Breda,2,3,2,0,3,5,-1,4.0,7.0
1102,1963-1964,3,ADO Den Haag,PSV,1,1,3,1,1,2,0,6.0,13.0
1103,1963-1964,3,DWS Amsterdam,AFC Ajax,0,3,2,0,3,3,-3,12.0,9.0
1104,1963-1964,3,Feijenoord,DOS Utrecht,4,2,1,3,0,6,2,6.0,7.0
1105,1963-1964,3,Fortuna '54,FC Volendam,2,0,1,3,0,2,2,9.0,3.0
1106,1963-1964,3,Go Ahead Eagles,Blauw Wit,3,4,2,0,3,7,-1,,9.0
1107,1963-1964,3,Groninger VAV,Heracles Almelo,2,0,1,3,0,2,2,9.0,3.0
1108,1963-1964,3,NAC Breda,MVV Maastricht,2,3,2,0,3,5,-1,6.0,15.0
1109,1963-1964,3,Sportclub Enschede,Sparta Rotterdam,2,0,1,3,0,2,2,6.0,6.0
1110,1963-1964,4,AFC Ajax,Groninger VAV,4,2,1,3,0,6,2,12.0,9.0
1111,1963-1964,4,Blauw Wit,NAC Breda,0,2,2,0,3,2,-2,6.0,9.0
1112,1963-1964,4,DOS Utrecht,Sportclub Enschede,1,1,3,1,1,2,0,7.0,7.0
1113,1963-1964,4,Heracles Almelo,Feijenoord,3,0,1,3,0,3,3,3.0,6.0
1114,1963-1964,4,MVV Maastricht,ADO Den Haag,1,2,2,0,3,3,-1,12.0,8.0
1115,1963-1964,4,PSV,Fortuna '54,3,2,1,3,0,5,1,13.0,9.0
1116,1963-1964,4,Sparta Rotterdam,Go Ahead Eagles,0,3,2,0,3,3,-3,3.0,
1117,1963-1964,4,FC Volendam,DWS Amsterdam,1,3,2,0,3,4,-2,0.0,12.0
1118,1963-1964,5,ADO Den Haag,Blauw Wit,3,0,1,3,0,3,3,10.0,6.0
1119,1963-1964,5,DWS Amsterdam,PSV,1,2,2,0,3,3,-1,9.0,13.0
1120,1963-1964,5,Feijenoord,AFC Ajax,1,1,3,1,1,2,0,4.0,10.0
1121,1963-1964,5,Fortuna '54,MVV Maastricht,1,1,3,1,1,2,0,10.0,10.0
1122,1963-1964,5,Go Ahead Eagles,Sportclub Enschede,3,2,1,3,0,5,1,6.0,7.0
1123,1963-1964,5,Groninger VAV,FC Volendam,2,1,1,3,0,3,1,9.0,0.0
1124,1963-1964,5,Heracles Almelo,DOS Utrecht,0,2,2,0,3,2,-2,3.0,10.0
1125,1963-1964,5,NAC Breda,Sparta Rotterdam,2,1,1,3,0,3,1,9.0,0.0
1126,1963-1964,6,AFC Ajax,Heracles Almelo,7,0,1,3,0,7,7,13.0,3.0
1127,1963-1964,6,DOS Utrecht,Go Ahead Eagles,2,4,2,0,3,6,-2,7.0,9.0
1128,1963-1964,6,MVV Maastricht,DWS Amsterdam,0,1,2,0,3,1,-1,7.0,9.0
1129,1963-1964,6,PSV,Groninger VAV,4,1,1,3,0,5,3,13.0,6.0
1130,1963-1964,6,Sportclub Enschede,NAC Breda,1,3,2,0,3,4,-2,4.0,12.0
1131,1963-1964,6,Sparta Rotterdam,ADO Den Haag,0,2,2,0,3,2,-2,0.0,10.0
1132,1963-1964,6,FC Volendam,Feijenoord,0,8,2,0,3,8,-8,0.0,7.0
1133,1963-1964,6,Blauw Wit,Fortuna '54,2,2,3,1,1,4,0,7.0,8.0
1134,1963-1964,7,ADO Den Haag,Sportclub Enschede,1,1,3,1,1,2,0,11.0,5.0
1135,1963-1964,7,AFC Ajax,DOS Utrecht,6,1,1,3,0,7,5,13.0,4.0
1136,1963-1964,7,DWS Amsterdam,Blauw Wit,3,2,1,3,0,5,1,9.0,4.0
1137,1963-1964,7,Feijenoord,PSV,4,2,1,3,0,6,2,10.0,10.0
1138,1963-1964,7,Fortuna '54,Sparta Rotterdam,0,0,3,1,1,0,0,6.0,1.0
1139,1963-1964,7,Groninger VAV,MVV Maastricht,1,0,1,3,0,1,1,9.0,4.0
1140,1963-1964,7,Heracles Almelo,FC Volendam,3,1,1,3,0,4,2,6.0,0.0
1141,1963-1964,7,NAC Breda,Go Ahead Eagles,4,0,1,3,0,4,4,12.0,9.0
1142,1963-1964,8,Blauw Wit,Groninger VAV,1,1,3,1,1,2,0,2.0,7.0
1143,1963-1964,8,DOS Utrecht,NAC Breda,2,0,1,3,0,2,2,7.0,12.0
1144,1963-1964,8,Go Ahead Eagles,ADO Den Haag,3,4,2,0,3,7,-1,9.0,13.0
1145,1963-1964,8,MVV Maastricht,Feijenoord,1,0,1,3,0,1,1,4.0,7.0
1146,1963-1964,8,PSV,Heracles Almelo,3,2,1,3,0,5,1,12.0,6.0
1147,1963-1964,8,Sportclub Enschede,Fortuna '54,2,2,3,1,1,4,0,3.0,4.0
1148,1963-1964,8,Sparta Rotterdam,DWS Amsterdam,4,2,1,3,0,6,2,4.0,9.0
1149,1963-1964,8,FC Volendam,AFC Ajax,2,3,2,0,3,5,-1,0.0,13.0
1150,1963-1964,9,ADO Den Haag,NAC Breda,3,4,2,0,3,7,-1,10.0,12.0
1151,1963-1964,9,AFC Ajax,PSV,2,0,1,3,0,2,2,13.0,9.0
1152,1963-1964,9,Feijenoord,Blauw Wit,3,0,1,3,0,3,3,10.0,2.0
1153,1963-1964,9,Fortuna '54,Go Ahead Eagles,1,1,3,1,1,2,0,5.0,7.0
1154,1963-1964,9,Groninger VAV,Sparta Rotterdam,3,0,1,3,0,3,3,10.0,4.0
1155,1963-1964,9,Heracles Almelo,MVV Maastricht,5,1,1,3,0,6,4,6.0,4.0
1156,1963-1964,9,FC Volendam,DOS Utrecht,2,2,3,1,1,4,0,1.0,7.0
1157,1963-1964,9,DWS Amsterdam,Sportclub Enschede,0,1,2,0,3,1,-1,6.0,5.0
1158,1963-1964,10,Blauw Wit,Heracles Almelo,3,4,2,0,3,7,-1,2.0,9.0
1159,1963-1964,10,DOS Utrecht,ADO Den Haag,4,0,1,3,0,4,4,7.0,7.0
1160,1963-1964,10,Go Ahead Eagles,DWS Amsterdam,1,1,3,1,1,2,0,5.0,7.0
1161,1963-1964,10,MVV Maastricht,AFC Ajax,2,2,3,1,1,4,0,4.0,13.0
1162,1963-1964,10,NAC Breda,Fortuna '54,4,2,1,3,0,6,2,12.0,4.0
1163,1963-1964,10,PSV,FC Volendam,2,0,1,3,0,2,2,9.0,1.0
1164,1963-1964,10,Sportclub Enschede,Groninger VAV,4,2,1,3,0,6,2,8.0,7.0
1165,1963-1964,10,Sparta Rotterdam,Feijenoord,0,0,3,1,1,0,0,5.0,10.0
1166,1963-1964,11,AFC Ajax,Blauw Wit,1,1,3,1,1,2,0,11.0,2.0
1167,1963-1964,11,DWS Amsterdam,NAC Breda,2,3,2,0,3,5,-1,4.0,12.0
1168,1963-1964,11,Feijenoord,Sportclub Enschede,3,1,1,3,0,4,2,10.0,8.0
1169,1963-1964,11,Fortuna '54,ADO Den Haag,2,0,1,3,0,2,2,6.0,4.0
1170,1963-1964,11,Groninger VAV,Go Ahead Eagles,2,1,1,3,0,3,1,10.0,2.0
1171,1963-1964,11,Heracles Almelo,Sparta Rotterdam,1,0,1,3,0,1,1,12.0,5.0
1172,1963-1964,11,PSV,DOS Utrecht,1,1,3,1,1,2,0,7.0,8.0
1173,1963-1964,11,FC Volendam,MVV Maastricht,1,1,3,1,1,2,0,2.0,5.0
1174,1963-1964,12,ADO Den Haag,DWS Amsterdam,2,3,2,0,3,5,-1,3.0,4.0
1175,1963-1964,12,Blauw Wit,FC Volendam,3,0,1,3,0,3,3,5.0,2.0
1176,1963-1964,12,DOS Utrecht,Fortuna '54,2,1,1,3,0,3,1,11.0,5.0
1177,1963-1964,12,Go Ahead Eagles,Feijenoord,0,2,2,0,3,2,-2,2.0,10.0
1178,1963-1964,12,MVV Maastricht,PSV,1,1,3,1,1,2,0,6.0,8.0
1179,1963-1964,12,NAC Breda,Groninger VAV,0,0,3,1,1,0,0,10.0,8.0
1180,1963-1964,12,Sportclub Enschede,Heracles Almelo,3,1,1,3,0,4,2,10.0,9.0
1181,1963-1964,12,Sparta Rotterdam,AFC Ajax,2,5,2,0,3,7,-3,4.0,11.0
1182,1963-1964,13,AFC Ajax,Sportclub Enschede,1,1,3,1,1,2,0,9.0,10.0
1183,1963-1964,13,DWS Amsterdam,Fortuna '54,6,0,1,3,0,6,6,7.0,4.0
1184,1963-1964,13,Feijenoord,NAC Breda,10,0,1,3,0,10,10,13.0,10.0
1185,1963-1964,13,Groninger VAV,ADO Den Haag,1,2,2,0,3,3,-1,7.0,3.0
1186,1963-1964,13,Heracles Almelo,Go Ahead Eagles,1,1,3,1,1,2,0,10.0,3.0
1187,1963-1964,13,MVV Maastricht,DOS Utrecht,2,1,1,3,0,3,1,6.0,8.0
1188,1963-1964,13,PSV,Blauw Wit,5,3,1,3,0,8,2,8.0,4.0
1189,1963-1964,13,FC Volendam,Sparta Rotterdam,5,2,1,3,0,7,3,5.0,1.0
1190,1963-1964,14,ADO Den Haag,Feijenoord,1,0,1,3,0,1,1,6.0,10.0
1191,1963-1964,14,Blauw Wit,MVV Maastricht,1,2,2,0,3,3,-1,4.0,9.0
1192,1963-1964,14,DOS Utrecht,DWS Amsterdam,0,2,2,0,3,2,-2,7.0,10.0
1193,1963-1964,14,Fortuna '54,Groninger VAV,1,1,3,1,1,2,0,4.0,5.0
1194,1963-1964,14,Go Ahead Eagles,AFC Ajax,1,0,1,3,0,1,1,5.0,6.0
1195,1963-1964,14,NAC Breda,Heracles Almelo,5,0,1,3,0,5,5,10.0,7.0
1196,1963-1964,14,Sportclub Enschede,FC Volendam,5,2,1,3,0,7,3,10.0,4.0
1197,1963-1964,14,Sparta Rotterdam,PSV,0,2,2,0,3,2,-2,1.0,11.0
1198,1963-1964,15,AFC Ajax,NAC Breda,2,2,3,1,1,4,0,6.0,8.0
1199,1963-1964,15,Blauw Wit,DOS Utrecht,3,1,1,3,0,4,2,7.0,4.0
1200,1963-1964,15,Feijenoord,Fortuna '54,1,0,1,3,0,1,1,12.0,4.0
1201,1963-1964,15,Heracles Almelo,ADO Den Haag,1,1,3,1,1,2,0,5.0,7.0
1202,1963-1964,15,MVV Maastricht,Sparta Rotterdam,2,2,3,1,1,4,0,9.0,1.0
1203,1963-1964,15,PSV,Sportclub Enschede,2,3,2,0,3,5,-1,8.0,10.0
1204,1963-1964,15,FC Volendam,Go Ahead Eagles,2,2,3,1,1,4,0,5.0,5.0
1205,1963-1964,15,Groninger VAV,DWS Amsterdam,1,2,2,0,3,3,-1,5.0,12.0
1206,1963-1964,16,ADO Den Haag,AFC Ajax,1,0,1,3,0,1,1,10.0,5.0
1207,1963-1964,16,DWS Amsterdam,Feijenoord,2,0,1,3,0,2,2,15.0,9.0
1208,1963-1964,16,Fortuna '54,Heracles Almelo,4,1,1,3,0,5,3,4.0,2.0
1209,1963-1964,16,Go Ahead Eagles,PSV,0,5,2,0,3,5,-5,5.0,10.0
1210,1963-1964,16,NAC Breda,FC Volendam,4,3,1,3,0,7,1,8.0,4.0
1211,1963-1964,16,Sportclub Enschede,MVV Maastricht,4,1,1,3,0,5,3,13.0,8.0
1212,1963-1964,16,Sparta Rotterdam,Blauw Wit,2,2,3,1,1,4,0,2.0,7.0
1213,1963-1964,16,Groninger VAV,DOS Utrecht,3,0,1,3,0,3,3,5.0,3.0
1214,1963-1964,17,AFC Ajax,Fortuna '54,4,1,1,3,0,5,3,5.0,4.0
1215,1963-1964,17,Blauw Wit,Sportclub Enschede,2,4,2,0,3,6,-2,4.0,13.0
1216,1963-1964,17,DOS Utrecht,Sparta Rotterdam,2,0,1,3,0,2,2,3.0,2.0
1217,1963-1964,17,Feijenoord,Groninger VAV,1,0,1,3,0,1,1,9.0,4.0
1218,1963-1964,17,Heracles Almelo,DWS Amsterdam,0,1,2,0,3,1,-1,2.0,15.0
1219,1963-1964,17,MVV Maastricht,Go Ahead Eagles,2,2,3,1,1,4,0,8.0,6.0
1220,1963-1964,17,PSV,NAC Breda,2,2,3,1,1,4,0,10.0,8.0
1221,1963-1964,17,FC Volendam,ADO Den Haag,2,2,3,1,1,4,0,5.0,11.0
1222,1963-1964,18,Blauw Wit,Go Ahead Eagles,1,1,3,1,1,2,0,5.0,6.0
1223,1963-1964,18,Heracles Almelo,Groninger VAV,2,2,3,1,1,4,0,2.0,5.0
1224,1963-1964,18,MVV Maastricht,NAC Breda,1,0,1,3,0,1,1,8.0,8.0
1225,1963-1964,18,PSV,ADO Den Haag,2,1,1,3,0,3,1,10.0,8.0
1226,1963-1964,18,FC Volendam,Fortuna '54,1,4,2,0,3,5,-3,2.0,7.0
1227,1963-1964,18,AFC Ajax,DWS Amsterdam,1,1,3,1,1,2,0,5.0,13.0
1228,1963-1964,18,DOS Utrecht,Feijenoord,1,2,2,0,3,3,-1,3.0,9.0
1229,1963-1964,18,Sparta Rotterdam,Sportclub Enschede,2,2,3,1,1,4,0,3.0,13.0
1230,1963-1964,19,ADO Den Haag,MVV Maastricht,2,1,1,3,0,3,1,8.0,5.0
1231,1963-1964,19,DWS Amsterdam,FC Volendam,0,0,3,1,1,0,0,11.0,3.0
1232,1963-1964,19,Feijenoord,Heracles Almelo,1,1,3,1,1,2,0,10.0,3.0
1233,1963-1964,19,Fortuna '54,PSV,3,1,1,3,0,4,2,9.0,7.0
1234,1963-1964,19,Go Ahead Eagles,Sparta Rotterdam,2,0,1,3,0,2,2,6.0,3.0
1235,1963-1964,19,Groninger VAV,AFC Ajax,3,1,1,3,0,4,2,7.0,5.0
1236,1963-1964,19,NAC Breda,Blauw Wit,0,0,3,1,1,0,0,6.0,6.0
1237,1963-1964,19,Sportclub Enschede,DOS Utrecht,1,1,3,1,1,2,0,11.0,4.0
1238,1963-1964,20,ADO Den Haag,Sparta Rotterdam,1,4,2,0,3,5,-3,7.0,5.0
1239,1963-1964,20,Fortuna '54,Blauw Wit,2,2,3,1,1,4,0,10.0,4.0
1240,1963-1964,20,DWS Amsterdam,MVV Maastricht,1,0,1,3,0,1,1,11.0,4.0
1241,1963-1964,20,Feijenoord,FC Volendam,4,1,1,3,0,5,3,10.0,2.0
1242,1963-1964,20,Go Ahead Eagles,DOS Utrecht,0,2,2,0,3,2,-2,5.0,7.0
1243,1963-1964,20,Groninger VAV,PSV,3,1,1,3,0,4,2,10.0,7.0
1244,1963-1964,20,Heracles Almelo,AFC Ajax,1,0,1,3,0,1,1,5.0,4.0
1245,1963-1964,20,NAC Breda,Sportclub Enschede,2,4,2,0,3,6,-2,5.0,11.0
1246,1963-1964,21,AFC Ajax,Feijenoord,1,1,3,1,1,2,0,5.0,11.0
1247,1963-1964,21,Blauw Wit,ADO Den Haag,1,2,2,0,3,3,-1,3.0,7.0
1248,1963-1964,21,DOS Utrecht,Heracles Almelo,5,2,1,3,0,7,3,10.0,5.0
1249,1963-1964,21,MVV Maastricht,Fortuna '54,0,0,3,1,1,0,0,5.0,8.0
1250,1963-1964,21,PSV,DWS Amsterdam,0,2,2,0,3,2,-2,4.0,11.0
1251,1963-1964,21,Sportclub Enschede,Go Ahead Eagles,1,1,3,1,1,2,0,9.0,6.0
1252,1963-1964,21,Sparta Rotterdam,NAC Breda,3,0,1,3,0,3,3,7.0,2.0
1253,1963-1964,21,FC Volendam,Groninger VAV,0,0,3,1,1,0,0,3.0,8.0
1254,1963-1964,22,Blauw Wit,DWS Amsterdam,0,2,2,0,3,2,-2,3.0,11.0
1255,1963-1964,22,DOS Utrecht,AFC Ajax,3,1,1,3,0,4,2,10.0,2.0
1256,1963-1964,22,Go Ahead Eagles,NAC Breda,2,0,1,3,0,2,2,8.0,1.0
1257,1963-1964,22,MVV Maastricht,Groninger VAV,2,1,1,3,0,3,1,7.0,8.0
1258,1963-1964,22,PSV,Feijenoord,1,0,1,3,0,1,1,6.0,8.0
1259,1963-1964,22,Sportclub Enschede,ADO Den Haag,1,0,1,3,0,1,1,9.0,6.0
1260,1963-1964,22,Sparta Rotterdam,Fortuna '54,1,1,3,1,1,2,0,8.0,9.0
1261,1963-1964,22,FC Volendam,Heracles Almelo,3,1,1,3,0,4,2,5.0,5.0
1262,1963-1964,23,Groninger VAV,Blauw Wit,2,0,1,3,0,2,2,10.0,2.0
1263,1963-1964,23,ADO Den Haag,Go Ahead Eagles,0,1,2,0,3,1,-1,6.0,10.0
1264,1963-1964,23,AFC Ajax,FC Volendam,2,3,2,0,3,5,-1,1.0,8.0
1265,1963-1964,23,DWS Amsterdam,Sparta Rotterdam,1,1,3,1,1,2,0,11.0,8.0
1266,1963-1964,23,Feijenoord,MVV Maastricht,9,1,1,3,0,10,8,8.0,4.0
1267,1963-1964,23,Fortuna '54,Sportclub Enschede,1,3,2,0,3,4,-2,6.0,11.0
1268,1963-1964,23,Heracles Almelo,PSV,1,3,2,0,3,4,-2,4.0,6.0
1269,1963-1964,23,NAC Breda,DOS Utrecht,0,0,3,1,1,0,0,2.0,11.0
1270,1963-1964,24,Blauw Wit,Feijenoord,1,7,2,0,3,8,-6,1.0,10.0
1271,1963-1964,24,DOS Utrecht,FC Volendam,2,0,1,3,0,2,2,13.0,7.0
1272,1963-1964,24,Go Ahead Eagles,Fortuna '54,1,2,2,0,3,3,-1,7.0,6.0
1273,1963-1964,24,MVV Maastricht,Heracles Almelo,1,1,3,1,1,2,0,5.0,4.0
1274,1963-1964,24,NAC Breda,ADO Den Haag,2,2,3,1,1,4,0,2.0,4.0
1275,1963-1964,24,PSV,AFC Ajax,2,0,1,3,0,2,2,9.0,1.0
1276,1963-1964,24,Sportclub Enschede,DWS Amsterdam,0,1,2,0,3,1,-1,10.0,13.0
1277,1963-1964,24,Sparta Rotterdam,Groninger VAV,1,1,3,1,1,2,0,9.0,8.0
1278,1963-1964,25,ADO Den Haag,DOS Utrecht,4,2,1,3,0,6,2,7.0,10.0
1279,1963-1964,25,AFC Ajax,MVV Maastricht,3,1,1,3,0,4,2,4.0,5.0
1280,1963-1964,25,DWS Amsterdam,Go Ahead Eagles,0,0,3,1,1,0,0,11.0,8.0
1281,1963-1964,25,Feijenoord,Sparta Rotterdam,0,1,2,0,3,1,-1,7.0,9.0
1282,1963-1964,25,Fortuna '54,NAC Breda,1,2,2,0,3,3,-1,5.0,5.0
1283,1963-1964,25,Groninger VAV,Sportclub Enschede,1,5,2,0,3,6,-4,5.0,10.0
1284,1963-1964,25,Heracles Almelo,Blauw Wit,4,1,1,3,0,5,3,4.0,0.0
1285,1963-1964,25,FC Volendam,PSV,2,1,1,3,0,3,1,10.0,9.0
1286,1963-1964,26,ADO Den Haag,Fortuna '54,1,2,2,0,3,3,-1,4.0,7.0
1287,1963-1964,26,Blauw Wit,AFC Ajax,0,1,2,0,3,1,-1,0.0,6.0
1288,1963-1964,26,DOS Utrecht,PSV,2,3,2,0,3,5,-1,7.0,12.0
1289,1963-1964,26,Go Ahead Eagles,Groninger VAV,2,2,3,1,1,4,0,8.0,5.0
1290,1963-1964,26,MVV Maastricht,FC Volendam,3,1,1,3,0,4,2,7.0,9.0
1291,1963-1964,26,NAC Breda,DWS Amsterdam,2,1,1,3,0,3,1,8.0,8.0
1292,1963-1964,26,Sportclub Enschede,Feijenoord,2,2,3,1,1,4,0,10.0,7.0
1293,1963-1964,26,Sparta Rotterdam,Heracles Almelo,2,1,1,3,0,3,1,9.0,4.0
1294,1963-1964,27,AFC Ajax,Sparta Rotterdam,0,0,3,1,1,0,0,7.0,9.0
1295,1963-1964,27,DWS Amsterdam,ADO Den Haag,9,0,1,3,0,9,9,8.0,4.0
1296,1963-1964,27,Feijenoord,Go Ahead Eagles,6,1,1,3,0,7,5,10.0,5.0
1297,1963-1964,27,Fortuna '54,DOS Utrecht,4,0,1,3,0,4,4,9.0,4.0
1298,1963-1964,27,Groninger VAV,NAC Breda,1,0,1,3,0,1,1,8.0,8.0
1299,1963-1964,27,Heracles Almelo,Sportclub Enschede,2,2,3,1,1,4,0,5.0,8.0
1300,1963-1964,27,PSV,MVV Maastricht,3,1,1,3,0,4,2,12.0,4.0
1301,1963-1964,27,FC Volendam,Blauw Wit,2,2,3,1,1,4,0,7.0,1.0
1302,1963-1964,28,ADO Den Haag,Groninger VAV,3,1,1,3,0,4,2,7.0,5.0
1303,1963-1964,28,Blauw Wit,PSV,2,4,2,0,3,6,-2,1.0,12.0
1304,1963-1964,28,DOS Utrecht,MVV Maastricht,1,1,3,1,1,2,0,4.0,5.0
1305,1963-1964,28,Fortuna '54,DWS Amsterdam,1,2,2,0,3,3,-1,9.0,10.0
1306,1963-1964,28,Go Ahead Eagles,Heracles Almelo,1,2,2,0,3,3,-1,2.0,8.0
1307,1963-1964,28,NAC Breda,Feijenoord,3,1,1,3,0,4,2,10.0,7.0
1308,1963-1964,28,Sportclub Enschede,AFC Ajax,2,1,1,3,0,3,1,8.0,7.0
1309,1963-1964,28,Sparta Rotterdam,FC Volendam,1,1,3,1,1,2,0,9.0,5.0
1310,1963-1964,29,AFC Ajax,Go Ahead Eagles,4,2,1,3,0,6,2,10.0,2.0
1311,1963-1964,29,DWS Amsterdam,DOS Utrecht,3,1,1,3,0,4,2,10.0,1.0
1312,1963-1964,29,Feijenoord,ADO Den Haag,5,1,1,3,0,6,4,7.0,6.0
1313,1963-1964,29,Groninger VAV,Fortuna '54,2,2,3,1,1,4,0,5.0,7.0
1314,1963-1964,29,Heracles Almelo,NAC Breda,0,3,2,0,3,3,-3,7.0,12.0
1315,1963-1964,29,MVV Maastricht,Blauw Wit,1,2,2,0,3,3,-1,4.0,4.0
1316,1963-1964,29,PSV,Sparta Rotterdam,2,0,1,3,0,2,2,12.0,8.0
1317,1963-1964,29,FC Volendam,Sportclub Enschede,2,2,3,1,1,4,0,6.0,9.0
1318,1963-1964,30,ADO Den Haag,Heracles Almelo,2,2,3,1,1,4,0,4.0,5.0
1319,1963-1964,30,DOS Utrecht,Blauw Wit,4,2,1,3,0,6,2,4.0,4.0
1320,1963-1964,30,DWS Amsterdam,Groninger VAV,3,1,1,3,0,4,2,12.0,5.0
1321,1963-1964,30,Fortuna '54,Feijenoord,1,2,2,0,3,3,-1,7.0,10.0
1322,1963-1964,30,Go Ahead Eagles,FC Volendam,2,2,3,1,1,4,0,2.0,4.0
1323,1963-1964,30,NAC Breda,AFC Ajax,2,3,2,0,3,5,-1,9.0,10.0
1324,1963-1964,30,Sportclub Enschede,PSV,2,2,3,1,1,4,0,7.0,13.0
1325,1963-1964,30,Sparta Rotterdam,MVV Maastricht,2,1,1,3,0,3,1,8.0,4.0
1326,1964-1965,1,AFC Ajax,Go Ahead Eagles,4,1,1,3,0,5,3,10.0,1.0
1327,1964-1965,1,Feijenoord,DOS Utrecht,4,2,1,3,0,6,2,12.0,4.0
1328,1964-1965,1,Groninger VAV,Sportclub Enschede,1,0,1,3,0,1,1,7.0,6.0
1329,1964-1965,1,Heracles Almelo,MVV Maastricht,3,2,1,3,0,5,1,8.0,1.0
1330,1964-1965,1,NAC Breda,Sparta Rotterdam,1,2,2,0,3,3,-1,6.0,8.0
1331,1964-1965,1,PSV,Fortuna '54,1,2,2,0,3,3,-1,10.0,7.0
1332,1964-1965,1,Sittardia,DWS Amsterdam,1,1,3,1,1,2,0,1.0,13.0
1333,1964-1965,1,Telstar,ADO Den Haag,2,1,1,3,0,3,1,,4.0
1334,1964-1965,2,ADO Den Haag,AFC Ajax,2,1,1,3,0,3,1,7.0,9.0
1335,1964-1965,2,DOS Utrecht,NAC Breda,1,1,3,1,1,2,0,5.0,7.0
1336,1964-1965,2,DWS Amsterdam,Telstar,2,1,1,3,0,3,1,13.0,
1337,1964-1965,2,Fortuna '54,Feijenoord,1,0,1,3,0,1,1,7.0,9.0
1338,1964-1965,2,Go Ahead Eagles,Groninger VAV,0,0,3,1,1,0,0,2.0,5.0
1339,1964-1965,2,MVV Maastricht,Sittardia,2,3,2,0,3,5,-1,1.0,4.0
1340,1964-1965,2,Sportclub Enschede,PSV,1,3,2,0,3,4,-2,5.0,10.0
1341,1964-1965,2,Sparta Rotterdam,Heracles Almelo,0,2,2,0,3,2,-2,7.0,10.0
1342,1964-1965,3,AFC Ajax,DWS Amsterdam,0,3,2,0,3,3,-3,9.0,13.0
1343,1964-1965,3,Feijenoord,Sportclub Enschede,4,0,1,3,0,4,4,12.0,2.0
1344,1964-1965,3,Fortuna '54,DOS Utrecht,2,4,2,0,3,6,-2,7.0,7.0
1345,1964-1965,3,Groninger VAV,ADO Den Haag,0,0,3,1,1,0,0,6.0,5.0
1346,1964-1965,3,Heracles Almelo,NAC Breda,4,2,1,3,0,6,2,10.0,4.0
1347,1964-1965,3,PSV,Go Ahead Eagles,3,4,2,0,3,7,-1,7.0,5.0
1348,1964-1965,3,Sittardia,Sparta Rotterdam,1,2,2,0,3,3,-1,4.0,9.0
1349,1964-1965,3,Telstar,MVV Maastricht,1,1,3,1,1,2,0,,1.0
1350,1964-1965,4,ADO Den Haag,PSV,0,1,2,0,3,1,-1,5.0,7.0
1351,1964-1965,4,DOS Utrecht,Heracles Almelo,1,4,2,0,3,5,-3,7.0,13.0
1352,1964-1965,4,DWS Amsterdam,Groninger VAV,3,1,1,3,0,4,2,13.0,5.0
1353,1964-1965,4,Go Ahead Eagles,Feijenoord,0,1,2,0,3,1,-1,5.0,12.0
1354,1964-1965,4,MVV Maastricht,AFC Ajax,2,2,3,1,1,4,0,2.0,7.0
1355,1964-1965,4,NAC Breda,Sittardia,2,2,3,1,1,4,0,2.0,5.0
1356,1964-1965,4,Sportclub Enschede,Fortuna '54,0,0,3,1,1,0,0,2.0,7.0
1357,1964-1965,4,Sparta Rotterdam,Telstar,1,1,3,1,1,2,0,10.0,
1358,1964-1965,5,AFC Ajax,Sparta Rotterdam,1,3,2,0,3,4,-2,4.0,10.0
1359,1964-1965,5,Feijenoord,ADO Den Haag,2,1,1,3,0,3,1,12.0,4.0
1360,1964-1965,5,Fortuna '54,Go Ahead Eagles,2,1,1,3,0,3,1,10.0,4.0
1361,1964-1965,5,Groninger VAV,MVV Maastricht,5,2,1,3,0,7,3,8.0,2.0
1362,1964-1965,5,PSV,DWS Amsterdam,0,0,3,1,1,0,0,7.0,11.0
1363,1964-1965,5,Sportclub Enschede,DOS Utrecht,2,2,3,1,1,4,0,2.0,5.0
1364,1964-1965,5,Sittardia,Heracles Almelo,1,4,2,0,3,5,-3,5.0,15.0
1365,1964-1965,5,Telstar,NAC Breda,1,1,3,1,1,2,0,6.0,3.0
1366,1964-1965,6,ADO Den Haag,Fortuna '54,1,2,2,0,3,3,-1,4.0,10.0
1367,1964-1965,6,DOS Utrecht,Sittardia,2,1,1,3,0,3,1,8.0,4.0
1368,1964-1965,6,DWS Amsterdam,Feijenoord,2,1,1,3,0,3,1,13.0,9.0
1369,1964-1965,6,Go Ahead Eagles,Sportclub Enschede,0,0,3,1,1,0,0,5.0,3.0
1370,1964-1965,6,Heracles Almelo,Telstar,1,1,3,1,1,2,0,13.0,4.0
1371,1964-1965,6,MVV Maastricht,PSV,0,3,2,0,3,3,-3,2.0,10.0
1372,1964-1965,6,NAC Breda,AFC Ajax,1,2,2,0,3,3,-1,3.0,4.0
1373,1964-1965,6,Sparta Rotterdam,Groninger VAV,0,1,2,0,3,1,-1,7.0,8.0
1374,1964-1965,7,AFC Ajax,Heracles Almelo,1,4,2,0,3,5,-3,4.0,13.0
1375,1964-1965,7,Feijenoord,MVV Maastricht,3,0,1,3,0,3,3,12.0,2.0
1376,1964-1965,7,Fortuna '54,DWS Amsterdam,1,2,2,0,3,3,-1,7.0,13.0
1377,1964-1965,7,Go Ahead Eagles,DOS Utrecht,3,3,3,1,1,6,0,5.0,8.0
1378,1964-1965,7,Groninger VAV,NAC Breda,3,0,1,3,0,3,3,10.0,2.0
1379,1964-1965,7,PSV,Sparta Rotterdam,3,2,1,3,0,5,1,10.0,7.0
1380,1964-1965,7,Sportclub Enschede,ADO Den Haag,1,0,1,3,0,1,1,6.0,1.0
1381,1964-1965,7,Telstar,Sittardia,0,0,3,1,1,0,0,5.0,2.0
1382,1964-1965,8,ADO Den Haag,Go Ahead Eagles,0,3,2,0,3,3,-3,0.0,5.0
1383,1964-1965,8,DOS Utrecht,Telstar,3,1,1,3,0,4,2,8.0,4.0
1384,1964-1965,8,DWS Amsterdam,Sportclub Enschede,3,1,1,3,0,4,2,13.0,6.0
1385,1964-1965,8,Heracles Almelo,Groninger VAV,0,0,3,1,1,0,0,11.0,10.0
1386,1964-1965,8,MVV Maastricht,Fortuna '54,1,0,1,3,0,1,1,4.0,7.0
1387,1964-1965,8,NAC Breda,PSV,1,0,1,3,0,1,1,5.0,10.0
1388,1964-1965,8,Sittardia,AFC Ajax,2,1,1,3,0,3,1,5.0,4.0
1389,1964-1965,8,Sparta Rotterdam,Feijenoord,0,3,2,0,3,3,-3,4.0,12.0
1390,1964-1965,9,ADO Den Haag,DOS Utrecht,2,1,1,3,0,3,1,3.0,8.0
1391,1964-1965,9,AFC Ajax,Telstar,0,2,2,0,3,2,-2,3.0,6.0
1392,1964-1965,9,Feijenoord,NAC Breda,5,1,1,3,0,6,4,12.0,4.0
1393,1964-1965,9,Fortuna '54,Sparta Rotterdam,3,1,1,3,0,4,2,9.0,3.0
1394,1964-1965,9,Go Ahead Eagles,DWS Amsterdam,1,2,2,0,3,3,-1,5.0,13.0
1395,1964-1965,9,Groninger VAV,Sittardia,2,0,1,3,0,2,2,13.0,4.0
1396,1964-1965,9,PSV,Heracles Almelo,0,1,2,0,3,1,-1,7.0,11.0
1397,1964-1965,9,Sportclub Enschede,MVV Maastricht,1,1,3,1,1,2,0,6.0,4.0
1398,1964-1965,10,DOS Utrecht,AFC Ajax,2,2,3,1,1,4,0,8.0,4.0
1399,1964-1965,10,DWS Amsterdam,ADO Den Haag,1,1,3,1,1,2,0,13.0,4.0
1400,1964-1965,10,Heracles Almelo,Feijenoord,1,5,2,0,3,6,-4,8.0,12.0
1401,1964-1965,10,MVV Maastricht,Go Ahead Eagles,1,0,1,3,0,1,1,7.0,5.0
1402,1964-1965,10,NAC Breda,Fortuna '54,0,1,2,0,3,1,-1,3.0,9.0
1403,1964-1965,10,Sittardia,PSV,2,5,2,0,3,7,-3,4.0,9.0
1404,1964-1965,10,Sparta Rotterdam,Sportclub Enschede,3,0,1,3,0,3,3,3.0,5.0
1405,1964-1965,10,Telstar,Groninger VAV,2,3,2,0,3,5,-1,5.0,13.0
1406,1964-1965,11,ADO Den Haag,MVV Maastricht,0,1,2,0,3,1,-1,4.0,10.0
1407,1964-1965,11,DWS Amsterdam,DOS Utrecht,0,0,3,1,1,0,0,11.0,6.0
1408,1964-1965,11,Feijenoord,Sittardia,2,1,1,3,0,3,1,15.0,4.0
1409,1964-1965,11,Fortuna '54,Heracles Almelo,2,0,1,3,0,2,2,9.0,7.0
1410,1964-1965,11,Go Ahead Eagles,Sparta Rotterdam,1,1,3,1,1,2,0,5.0,4.0
1411,1964-1965,11,Groninger VAV,AFC Ajax,3,1,1,3,0,4,2,13.0,1.0
1412,1964-1965,11,PSV,Telstar,3,2,1,3,0,5,1,9.0,4.0
1413,1964-1965,11,Sportclub Enschede,NAC Breda,6,1,1,3,0,7,5,7.0,3.0
1414,1964-1965,12,AFC Ajax,PSV,5,0,1,3,0,5,5,4.0,6.0
1415,1964-1965,12,DOS Utrecht,Groninger VAV,2,3,2,0,3,5,-1,5.0,13.0
1416,1964-1965,12,Heracles Almelo,Sportclub Enschede,1,2,2,0,3,3,-1,4.0,7.0
1417,1964-1965,12,MVV Maastricht,DWS Amsterdam,2,0,1,3,0,2,2,13.0,8.0
1418,1964-1965,12,NAC Breda,Go Ahead Eagles,2,0,1,3,0,2,2,6.0,4.0
1419,1964-1965,12,Sittardia,Fortuna '54,2,2,3,1,1,4,0,4.0,10.0
1420,1964-1965,12,Sparta Rotterdam,ADO Den Haag,1,0,1,3,0,1,1,7.0,4.0
1421,1964-1965,12,Telstar,Feijenoord,0,2,2,0,3,2,-2,3.0,15.0
1422,1964-1965,13,ADO Den Haag,NAC Breda,2,2,3,1,1,4,0,5.0,4.0
1423,1964-1965,13,DWS Amsterdam,Sparta Rotterdam,7,1,1,3,0,8,6,8.0,7.0
1424,1964-1965,13,Feijenoord,AFC Ajax,9,4,1,3,0,13,5,15.0,4.0
1425,1964-1965,13,Fortuna '54,Telstar,0,1,2,0,3,1,-1,10.0,6.0
1426,1964-1965,13,Go Ahead Eagles,Heracles Almelo,2,2,3,1,1,4,0,2.0,4.0
1427,1964-1965,13,PSV,Groninger VAV,2,2,3,1,1,4,0,7.0,13.0
1428,1964-1965,13,Sportclub Enschede,Sittardia,3,0,1,3,0,3,3,10.0,1.0
1429,1964-1965,13,MVV Maastricht,DOS Utrecht,2,2,3,1,1,4,0,11.0,3.0
1430,1964-1965,14,AFC Ajax,Fortuna '54,2,1,1,3,0,3,1,7.0,7.0
1431,1964-1965,14,Groninger VAV,Feijenoord,1,3,2,0,3,4,-2,10.0,15.0
1432,1964-1965,14,Heracles Almelo,ADO Den Haag,1,1,3,1,1,2,0,2.0,3.0
1433,1964-1965,14,NAC Breda,DWS Amsterdam,1,2,2,0,3,3,-1,4.0,8.0
1434,1964-1965,14,PSV,DOS Utrecht,1,1,3,1,1,2,0,8.0,4.0
1435,1964-1965,14,Sittardia,Go Ahead Eagles,0,1,2,0,3,1,-1,1.0,5.0
1436,1964-1965,14,Sparta Rotterdam,MVV Maastricht,5,1,1,3,0,6,4,10.0,10.0
1437,1964-1965,14,Telstar,Sportclub Enschede,1,1,3,1,1,2,0,4.0,10.0
1438,1964-1965,15,ADO Den Haag,Sittardia,1,0,1,3,0,1,1,5.0,1.0
1439,1964-1965,15,DOS Utrecht,Sparta Rotterdam,0,4,2,0,3,4,-4,3.0,10.0
1440,1964-1965,15,DWS Amsterdam,Heracles Almelo,5,0,1,3,0,5,5,10.0,2.0
1441,1964-1965,15,Feijenoord,PSV,1,0,1,3,0,1,1,15.0,5.0
1442,1964-1965,15,Fortuna '54,Groninger VAV,1,0,1,3,0,1,1,7.0,7.0
1443,1964-1965,15,Go Ahead Eagles,Telstar,0,1,2,0,3,1,-1,5.0,7.0
1444,1964-1965,15,MVV Maastricht,NAC Breda,3,1,1,3,0,4,2,10.0,4.0
1445,1964-1965,15,Sportclub Enschede,AFC Ajax,0,4,2,0,3,4,-4,10.0,9.0
1446,1964-1965,16,DOS Utrecht,Feijenoord,3,1,1,3,0,4,2,5.0,12.0
1447,1964-1965,16,Fortuna '54,PSV,2,5,2,0,3,7,-3,4.0,5.0
1448,1964-1965,16,Go Ahead Eagles,AFC Ajax,1,0,1,3,0,1,1,7.0,9.0
1449,1964-1965,16,MVV Maastricht,Heracles Almelo,1,0,1,3,0,1,1,10.0,2.0
1450,1964-1965,16,Sportclub Enschede,Groninger VAV,2,1,1,3,0,3,1,10.0,4.0
1451,1964-1965,16,Sparta Rotterdam,NAC Breda,1,0,1,3,0,1,1,12.0,4.0
1452,1964-1965,16,DWS Amsterdam,Sittardia,2,0,1,3,0,2,2,12.0,1.0
1453,1964-1965,16,ADO Den Haag,Telstar,1,1,3,1,1,2,0,6.0,8.0
1454,1964-1965,17,AFC Ajax,ADO Den Haag,5,1,1,3,0,6,4,9.0,6.0
1455,1964-1965,17,Feijenoord,Fortuna '54,5,0,1,3,0,5,5,12.0,3.0
1456,1964-1965,17,Groninger VAV,Go Ahead Eagles,2,2,3,1,1,4,0,2.0,8.0
1457,1964-1965,17,Heracles Almelo,Sparta Rotterdam,1,1,3,1,1,2,0,3.0,10.0
1458,1964-1965,17,PSV,Sportclub Enschede,0,0,3,1,1,0,0,6.0,8.0
1459,1964-1965,17,Telstar,DWS Amsterdam,0,0,3,1,1,0,0,9.0,13.0
1460,1964-1965,17,NAC Breda,DOS Utrecht,3,0,1,3,0,3,3,4.0,5.0
1461,1964-1965,17,Sittardia,MVV Maastricht,2,1,1,3,0,3,1,3.0,7.0
1462,1964-1965,18,ADO Den Haag,Groninger VAV,4,1,1,3,0,5,3,8.0,1.0
1463,1964-1965,18,DWS Amsterdam,AFC Ajax,1,1,3,1,1,2,0,11.0,10.0
1464,1964-1965,18,Go Ahead Eagles,PSV,0,1,2,0,3,1,-1,7.0,8.0
1465,1964-1965,18,MVV Maastricht,Telstar,0,2,2,0,3,2,-2,6.0,9.0
1466,1964-1965,18,Sparta Rotterdam,Sittardia,1,0,1,3,0,1,1,13.0,3.0
1467,1964-1965,18,Sportclub Enschede,Feijenoord,2,0,1,3,0,2,2,8.0,9.0
1468,1964-1965,18,DOS Utrecht,Fortuna '54,0,3,2,0,3,3,-3,4.0,6.0
1469,1964-1965,18,NAC Breda,Heracles Almelo,0,0,3,1,1,0,0,4.0,3.0
1470,1964-1965,19,AFC Ajax,MVV Maastricht,9,3,1,3,0,12,6,10.0,6.0
1471,1964-1965,19,Feijenoord,Go Ahead Eagles,1,1,3,1,1,2,0,7.0,5.0
1472,1964-1965,19,Fortuna '54,Sportclub Enschede,2,2,3,1,1,4,0,7.0,8.0
1473,1964-1965,19,Groninger VAV,DWS Amsterdam,1,5,2,0,3,6,-4,1.0,11.0
1474,1964-1965,19,Heracles Almelo,DOS Utrecht,1,0,1,3,0,1,1,5.0,3.0
1475,1964-1965,19,PSV,ADO Den Haag,3,3,3,1,1,6,0,8.0,8.0
1476,1964-1965,19,Sittardia,NAC Breda,1,1,3,1,1,2,0,4.0,5.0
1477,1964-1965,19,Telstar,Sparta Rotterdam,1,0,1,3,0,1,1,11.0,10.0
1478,1964-1965,20,ADO Den Haag,Feijenoord,3,0,1,3,0,3,3,8.0,4.0
1479,1964-1965,20,DOS Utrecht,Sportclub Enschede,0,2,2,0,3,2,-2,3.0,11.0
1480,1964-1965,20,DWS Amsterdam,PSV,1,1,3,1,1,2,0,9.0,9.0
1481,1964-1965,20,Go Ahead Eagles,Fortuna '54,1,3,2,0,3,4,-2,5.0,7.0
1482,1964-1965,20,Heracles Almelo,Sittardia,0,3,2,0,3,3,-3,5.0,7.0
1483,1964-1965,20,MVV Maastricht,Groninger VAV,3,0,1,3,0,3,3,6.0,1.0
1484,1964-1965,20,NAC Breda,Telstar,2,0,1,3,0,2,2,8.0,8.0
1485,1964-1965,20,Sparta Rotterdam,AFC Ajax,0,0,3,1,1,0,0,8.0,8.0
1486,1964-1965,21,AFC Ajax,NAC Breda,3,0,1,3,0,3,3,11.0,8.0
1487,1964-1965,21,Feijenoord,DWS Amsterdam,3,1,1,3,0,4,2,7.0,6.0
1488,1964-1965,21,Fortuna '54,ADO Den Haag,2,3,2,0,3,5,-1,7.0,10.0
1489,1964-1965,21,Groninger VAV,Sparta Rotterdam,1,2,2,0,3,3,-1,1.0,8.0
1490,1964-1965,21,PSV,MVV Maastricht,0,3,2,0,3,3,-3,6.0,6.0
1491,1964-1965,21,Sportclub Enschede,Go Ahead Eagles,0,0,3,1,1,0,0,9.0,3.0
1492,1964-1965,21,Sittardia,DOS Utrecht,1,1,3,1,1,2,0,8.0,1.0
1493,1964-1965,21,Telstar,Heracles Almelo,0,1,2,0,3,1,-1,7.0,8.0
1494,1964-1965,22,ADO Den Haag,Sportclub Enschede,0,0,3,1,1,0,0,11.0,9.0
1495,1964-1965,22,DOS Utrecht,Go Ahead Eagles,3,1,1,3,0,4,2,4.0,2.0
1496,1964-1965,22,DWS Amsterdam,Fortuna '54,0,2,2,0,3,2,-2,5.0,10.0
1497,1964-1965,22,Heracles Almelo,AFC Ajax,1,0,1,3,0,1,1,10.0,8.0
1498,1964-1965,22,MVV Maastricht,Feijenoord,1,2,2,0,3,3,-1,6.0,7.0
1499,1964-1965,22,NAC Breda,Groninger VAV,1,0,1,3,0,1,1,8.0,0.0
1500,1964-1965,22,Sittardia,Telstar,0,1,2,0,3,1,-1,5.0,9.0
1501,1964-1965,22,Sparta Rotterdam,PSV,2,2,3,1,1,4,0,8.0,6.0
1502,1964-1965,23,AFC Ajax,Sittardia,1,0,1,3,0,1,1,10.0,5.0
1503,1964-1965,23,Feijenoord,Sparta Rotterdam,3,1,1,3,0,4,2,10.0,5.0
1504,1964-1965,23,Fortuna '54,MVV Maastricht,0,0,3,1,1,0,0,8.0,7.0
1505,1964-1965,23,Go Ahead Eagles,ADO Den Haag,0,1,2,0,3,1,-1,2.0,11.0
1506,1964-1965,23,Groninger VAV,Heracles Almelo,0,0,3,1,1,0,0,1.0,10.0
1507,1964-1965,23,PSV,NAC Breda,1,0,1,3,0,1,1,6.0,7.0
1508,1964-1965,23,Sportclub Enschede,DWS Amsterdam,0,0,3,1,1,0,0,7.0,5.0
1509,1964-1965,23,Telstar,DOS Utrecht,1,4,2,0,3,5,-3,6.0,7.0
1510,1964-1965,24,DOS Utrecht,ADO Den Haag,0,3,2,0,3,3,-3,7.0,13.0
1511,1964-1965,24,DWS Amsterdam,Go Ahead Eagles,1,1,3,1,1,2,0,3.0,2.0
1512,1964-1965,24,Heracles Almelo,PSV,1,4,2,0,3,5,-3,7.0,8.0
1513,1964-1965,24,MVV Maastricht,Sportclub Enschede,2,0,1,3,0,2,2,10.0,6.0
1514,1964-1965,24,NAC Breda,Feijenoord,1,0,1,3,0,1,1,9.0,9.0
1515,1964-1965,24,Sittardia,Groninger VAV,4,2,1,3,0,6,2,7.0,1.0
1516,1964-1965,24,Sparta Rotterdam,Fortuna '54,1,0,1,3,0,1,1,8.0,7.0
1517,1964-1965,24,Telstar,AFC Ajax,0,0,3,1,1,0,0,4.0,8.0
1518,1964-1965,25,ADO Den Haag,DWS Amsterdam,1,0,1,3,0,1,1,13.0,2.0
1519,1964-1965,25,AFC Ajax,DOS Utrecht,0,0,3,1,1,0,0,8.0,8.0
1520,1964-1965,25,Feijenoord,Heracles Almelo,5,0,1,3,0,5,5,12.0,7.0
1521,1964-1965,25,Fortuna '54,NAC Breda,1,6,2,0,3,7,-5,4.0,9.0
1522,1964-1965,25,Go Ahead Eagles,MVV Maastricht,1,0,1,3,0,1,1,5.0,7.0
1523,1964-1965,25,Groninger VAV,Telstar,1,1,3,1,1,2,0,2.0,5.0
1524,1964-1965,25,PSV,Sittardia,1,3,2,0,3,4,-2,7.0,7.0
1525,1964-1965,25,Sportclub Enschede,Sparta Rotterdam,1,1,3,1,1,2,0,4.0,8.0
1526,1964-1965,26,AFC Ajax,Groninger VAV,1,1,3,1,1,2,0,6.0,3.0
1527,1964-1965,26,DOS Utrecht,DWS Amsterdam,1,2,2,0,3,3,-1,7.0,5.0
1528,1964-1965,26,Heracles Almelo,Fortuna '54,2,4,2,0,3,6,-2,4.0,7.0
1529,1964-1965,26,MVV Maastricht,ADO Den Haag,1,0,1,3,0,1,1,7.0,10.0
1530,1964-1965,26,NAC Breda,Sportclub Enschede,1,1,3,1,1,2,0,10.0,4.0
1531,1964-1965,26,Sittardia,Feijenoord,0,2,2,0,3,2,-2,6.0,12.0
1532,1964-1965,26,Sparta Rotterdam,Go Ahead Eagles,0,0,3,1,1,0,0,6.0,5.0
1533,1964-1965,26,Telstar,PSV,0,1,2,0,3,1,-1,5.0,10.0
1534,1964-1965,27,ADO Den Haag,Sparta Rotterdam,1,0,1,3,0,1,1,12.0,5.0
1535,1964-1965,27,DWS Amsterdam,MVV Maastricht,4,1,1,3,0,5,3,8.0,7.0
1536,1964-1965,27,Feijenoord,Telstar,4,1,1,3,0,5,3,12.0,2.0
1537,1964-1965,27,Fortuna '54,Sittardia,0,3,2,0,3,3,-3,4.0,9.0
1538,1964-1965,27,Go Ahead Eagles,NAC Breda,2,0,1,3,0,2,2,8.0,7.0
1539,1964-1965,27,Groninger VAV,DOS Utrecht,0,1,2,0,3,1,-1,3.0,7.0
1540,1964-1965,27,PSV,AFC Ajax,3,0,1,3,0,3,3,12.0,6.0
1541,1964-1965,27,Sportclub Enschede,Heracles Almelo,1,0,1,3,0,1,1,6.0,1.0
1542,1964-1965,28,AFC Ajax,Feijenoord,1,1,3,1,1,2,0,4.0,10.0
1543,1964-1965,28,DOS Utrecht,MVV Maastricht,1,1,3,1,1,2,0,5.0,7.0
1544,1964-1965,28,Groninger VAV,PSV,0,1,2,0,3,1,-1,2.0,12.0
1545,1964-1965,28,Heracles Almelo,Go Ahead Eagles,0,6,2,0,3,6,-6,0.0,11.0
1546,1964-1965,28,NAC Breda,ADO Den Haag,0,1,2,0,3,1,-1,7.0,12.0
1547,1964-1965,28,Sittardia,Sportclub Enschede,2,1,1,3,0,3,1,12.0,5.0
1548,1964-1965,28,Sparta Rotterdam,DWS Amsterdam,2,2,3,1,1,4,0,6.0,8.0
1549,1964-1965,28,Telstar,Fortuna '54,2,0,1,3,0,2,2,5.0,3.0
1550,1964-1965,29,ADO Den Haag,Heracles Almelo,2,0,1,3,0,2,2,12.0,0.0
1551,1964-1965,29,DOS Utrecht,PSV,2,0,1,3,0,2,2,8.0,9.0
1552,1964-1965,29,DWS Amsterdam,NAC Breda,3,1,1,3,0,4,2,10.0,4.0
1553,1964-1965,29,Feijenoord,Groninger VAV,1,1,3,1,1,2,0,11.0,3.0
1554,1964-1965,29,Fortuna '54,AFC Ajax,2,0,1,3,0,2,2,6.0,3.0
1555,1964-1965,29,Go Ahead Eagles,Sittardia,1,1,3,1,1,2,0,11.0,10.0
1556,1964-1965,29,MVV Maastricht,Sparta Rotterdam,2,0,1,3,0,2,2,7.0,3.0
1557,1964-1965,29,Sportclub Enschede,Telstar,1,3,2,0,3,4,-2,5.0,7.0
1558,1964-1965,30,AFC Ajax,Sportclub Enschede,1,2,2,0,3,3,-1,2.0,7.0
1559,1964-1965,30,Groninger VAV,Fortuna '54,3,3,3,1,1,6,0,3.0,7.0
1560,1964-1965,30,Heracles Almelo,DWS Amsterdam,1,0,1,3,0,1,1,3.0,10.0
1561,1964-1965,30,NAC Breda,MVV Maastricht,1,1,3,1,1,2,0,2.0,8.0
1562,1964-1965,30,PSV,Feijenoord,0,4,2,0,3,4,-4,9.0,11.0
1563,1964-1965,30,Sittardia,ADO Den Haag,0,1,2,0,3,1,-1,7.0,12.0
1564,1964-1965,30,Sparta Rotterdam,DOS Utrecht,1,1,3,1,1,2,0,3.0,8.0
1565,1964-1965,30,Telstar,Go Ahead Eagles,1,2,2,0,3,3,-1,6.0,11.0
1566,1965-1966,1,ADO Den Haag,Sparta Rotterdam,2,2,3,1,1,4,0,13.0,3.0
1567,1965-1966,1,AFC Ajax,DOS Utrecht,2,1,1,3,0,3,1,4.0,8.0
1568,1965-1966,1,USV Elinkwijk,MVV Maastricht,2,2,3,1,1,4,0,7.0,6.0
1569,1965-1966,1,FC Twente,Telstar,1,1,3,1,1,2,0,,7.0
1570,1965-1966,1,Feijenoord,PSV,3,2,1,3,0,5,1,11.0,6.0
1571,1965-1966,1,Fortuna '54,DWS Amsterdam,1,3,2,0,3,4,-2,4.0,10.0
1572,1965-1966,1,GVAV Groningen,Heracles Almelo,1,1,3,1,1,2,0,,4.0
1573,1965-1966,1,Willem II,Go Ahead Eagles,1,0,1,3,0,1,1,7.0,10.0
1574,1965-1966,2,DOS Utrecht,Fortuna '54,2,2,3,1,1,4,0,6.0,5.0
1575,1965-1966,2,DWS Amsterdam,ADO Den Haag,2,1,1,3,0,3,1,10.0,10.0
1576,1965-1966,2,Go Ahead Eagles,FC Twente,2,0,1,3,0,2,2,10.0,
1577,1965-1966,2,Heracles Almelo,Willem II,0,3,2,0,3,3,-3,4.0,7.0
1578,1965-1966,2,MVV Maastricht,AFC Ajax,0,1,2,0,3,1,-1,6.0,7.0
1579,1965-1966,2,PSV,USV Elinkwijk,1,1,3,1,1,2,0,4.0,5.0
1580,1965-1966,2,Sparta Rotterdam,GVAV Groningen,1,2,2,0,3,3,-1,3.0,
1581,1965-1966,2,Telstar,Feijenoord,0,2,2,0,3,2,-2,7.0,11.0
1582,1965-1966,3,Feijenoord,Go Ahead Eagles,0,0,3,1,1,0,0,11.0,8.0
1583,1965-1966,3,ADO Den Haag,Fortuna '54,1,1,3,1,1,2,0,8.0,6.0
1584,1965-1966,3,AFC Ajax,PSV,2,0,1,3,0,2,2,9.0,1.0
1585,1965-1966,3,USV Elinkwijk,Telstar,3,3,3,1,1,6,0,6.0,5.0
1586,1965-1966,3,FC Twente,Heracles Almelo,4,1,1,3,0,5,3,,4.0
1587,1965-1966,3,GVAV Groningen,DWS Amsterdam,0,0,3,1,1,0,0,,10.0
1588,1965-1966,3,MVV Maastricht,DOS Utrecht,2,2,3,1,1,4,0,6.0,6.0
1589,1965-1966,3,Willem II,Sparta Rotterdam,1,3,2,0,3,4,-2,7.0,5.0
1590,1965-1966,4,DOS Utrecht,ADO Den Haag,0,7,2,0,3,7,-7,3.0,8.0
1591,1965-1966,4,DWS Amsterdam,Willem II,0,0,3,1,1,0,0,8.0,8.0
1592,1965-1966,4,Fortuna '54,GVAV Groningen,0,0,3,1,1,0,0,4.0,
1593,1965-1966,4,Go Ahead Eagles,USV Elinkwijk,3,0,1,3,0,3,3,10.0,6.0
1594,1965-1966,4,Heracles Almelo,Feijenoord,1,3,2,0,3,4,-2,4.0,13.0
1595,1965-1966,4,PSV,MVV Maastricht,2,1,1,3,0,3,1,4.0,3.0
1596,1965-1966,4,Sparta Rotterdam,FC Twente,3,4,2,0,3,7,-1,5.0,
1597,1965-1966,4,Telstar,AFC Ajax,1,2,2,0,3,3,-1,2.0,12.0
1598,1965-1966,5,AFC Ajax,Go Ahead Eagles,4,0,1,3,0,4,4,15.0,7.0
1599,1965-1966,5,USV Elinkwijk,Heracles Almelo,1,0,1,3,0,1,1,6.0,1.0
1600,1965-1966,5,FC Twente,DWS Amsterdam,0,3,2,0,3,3,-3,7.0,11.0
1601,1965-1966,5,Feijenoord,Sparta Rotterdam,2,0,1,3,0,2,2,13.0,4.0
1602,1965-1966,5,GVAV Groningen,ADO Den Haag,1,1,3,1,1,2,0,7.0,6.0
1603,1965-1966,5,MVV Maastricht,Telstar,0,1,2,0,3,1,-1,2.0,5.0
1604,1965-1966,5,PSV,DOS Utrecht,2,0,1,3,0,2,2,7.0,2.0
1605,1965-1966,5,Willem II,Fortuna '54,0,2,2,0,3,2,-2,7.0,6.0
1606,1965-1966,6,ADO Den Haag,Willem II,4,0,1,3,0,4,4,8.0,4.0
1607,1965-1966,6,DOS Utrecht,GVAV Groningen,3,2,1,3,0,5,1,5.0,6.0
1608,1965-1966,6,DWS Amsterdam,Feijenoord,2,0,1,3,0,2,2,11.0,10.0
1609,1965-1966,6,Fortuna '54,FC Twente,1,3,2,0,3,4,-2,6.0,9.0
1610,1965-1966,6,Go Ahead Eagles,MVV Maastricht,1,1,3,1,1,2,0,8.0,2.0
1611,1965-1966,6,Heracles Almelo,AFC Ajax,1,1,3,1,1,2,0,1.0,13.0
1612,1965-1966,6,Sparta Rotterdam,USV Elinkwijk,2,1,1,3,0,3,1,6.0,5.0
1613,1965-1966,6,Telstar,PSV,3,1,1,3,0,4,2,7.0,7.0
1614,1965-1966,7,AFC Ajax,Sparta Rotterdam,0,1,2,0,3,1,-1,10.0,9.0
1615,1965-1966,7,USV Elinkwijk,DWS Amsterdam,1,0,1,3,0,1,1,7.0,8.0
1616,1965-1966,7,FC Twente,ADO Den Haag,0,0,3,1,1,0,0,10.0,9.0
1617,1965-1966,7,Feijenoord,Fortuna '54,1,0,1,3,0,1,1,10.0,5.0
1618,1965-1966,7,MVV Maastricht,Heracles Almelo,2,2,3,1,1,4,0,3.0,2.0
1619,1965-1966,7,PSV,Go Ahead Eagles,2,2,3,1,1,4,0,7.0,6.0
1620,1965-1966,7,Telstar,DOS Utrecht,1,0,1,3,0,1,1,10.0,4.0
1621,1965-1966,7,Willem II,GVAV Groningen,4,0,1,3,0,4,4,4.0,3.0
1622,1965-1966,8,ADO Den Haag,Feijenoord,2,1,1,3,0,3,1,11.0,9.0
1623,1965-1966,8,DOS Utrecht,Willem II,0,2,2,0,3,2,-2,3.0,7.0
1624,1965-1966,8,DWS Amsterdam,AFC Ajax,0,2,2,0,3,2,-2,7.0,10.0
1625,1965-1966,8,Fortuna '54,USV Elinkwijk,3,0,1,3,0,3,3,7.0,6.0
1626,1965-1966,8,Go Ahead Eagles,Telstar,2,1,1,3,0,3,1,8.0,9.0
1627,1965-1966,8,GVAV Groningen,FC Twente,0,2,2,0,3,2,-2,2.0,10.0
1628,1965-1966,8,Heracles Almelo,PSV,0,3,2,0,3,3,-3,2.0,10.0
1629,1965-1966,8,Sparta Rotterdam,MVV Maastricht,7,2,1,3,0,9,5,9.0,2.0
1630,1965-1966,9,AFC Ajax,Fortuna '54,5,1,1,3,0,6,4,10.0,6.0
1631,1965-1966,9,USV Elinkwijk,ADO Den Haag,1,1,3,1,1,2,0,7.0,9.0
1632,1965-1966,9,FC Twente,Willem II,6,1,1,3,0,7,5,10.0,6.0
1633,1965-1966,9,Feijenoord,GVAV Groningen,1,2,2,0,3,3,-1,6.0,4.0
1634,1965-1966,9,Go Ahead Eagles,DOS Utrecht,1,1,3,1,1,2,0,6.0,4.0
1635,1965-1966,9,MVV Maastricht,DWS Amsterdam,0,1,2,0,3,1,-1,2.0,9.0
1636,1965-1966,9,PSV,Sparta Rotterdam,2,1,1,3,0,3,1,10.0,9.0
1637,1965-1966,9,Telstar,Heracles Almelo,0,2,2,0,3,2,-2,9.0,5.0
1638,1965-1966,10,ADO Den Haag,AFC Ajax,2,3,2,0,3,5,-1,8.0,10.0
1639,1965-1966,10,DOS Utrecht,FC Twente,3,0,1,3,0,3,3,7.0,10.0
1640,1965-1966,10,DWS Amsterdam,PSV,2,2,3,1,1,4,0,7.0,8.0
1641,1965-1966,10,Fortuna '54,MVV Maastricht,3,3,3,1,1,6,0,4.0,3.0
1642,1965-1966,10,Sparta Rotterdam,Telstar,1,0,1,3,0,1,1,12.0,6.0
1643,1965-1966,10,Willem II,Feijenoord,3,4,2,0,3,7,-1,6.0,6.0
1644,1965-1966,10,GVAV Groningen,USV Elinkwijk,4,0,1,3,0,4,4,6.0,4.0
1645,1965-1966,10,Heracles Almelo,Go Ahead Eagles,0,0,3,1,1,0,0,6.0,7.0
1646,1965-1966,11,AFC Ajax,GVAV Groningen,5,1,1,3,0,6,4,12.0,6.0
1647,1965-1966,11,Go Ahead Eagles,Sparta Rotterdam,2,2,3,1,1,4,0,7.0,10.0
1648,1965-1966,11,Heracles Almelo,DOS Utrecht,2,2,3,1,1,4,0,6.0,5.0
1649,1965-1966,11,PSV,Fortuna '54,2,2,3,1,1,4,0,9.0,5.0
1650,1965-1966,11,Telstar,DWS Amsterdam,2,2,3,1,1,4,0,4.0,5.0
1651,1965-1966,11,USV Elinkwijk,Willem II,0,1,2,0,3,1,-1,4.0,9.0
1652,1965-1966,11,Feijenoord,FC Twente,4,0,1,3,0,4,4,9.0,7.0
1653,1965-1966,11,MVV Maastricht,ADO Den Haag,0,3,2,0,3,3,-3,2.0,8.0
1654,1965-1966,12,ADO Den Haag,PSV,1,3,2,0,3,4,-2,7.0,11.0
1655,1965-1966,12,DOS Utrecht,Feijenoord,0,3,2,0,3,3,-3,5.0,9.0
1656,1965-1966,12,DWS Amsterdam,Go Ahead Eagles,1,2,2,0,3,3,-1,5.0,9.0
1657,1965-1966,12,FC Twente,USV Elinkwijk,3,1,1,3,0,4,2,9.0,1.0
1658,1965-1966,12,Fortuna '54,Telstar,2,1,1,3,0,3,1,8.0,1.0
1659,1965-1966,12,GVAV Groningen,MVV Maastricht,2,0,1,3,0,2,2,9.0,1.0
1660,1965-1966,12,Sparta Rotterdam,Heracles Almelo,6,0,1,3,0,6,6,10.0,5.0
1661,1965-1966,12,Willem II,AFC Ajax,1,4,2,0,3,5,-3,6.0,15.0
1662,1965-1966,13,AFC Ajax,FC Twente,3,1,1,3,0,4,2,15.0,6.0
1663,1965-1966,13,USV Elinkwijk,Feijenoord,1,3,2,0,3,4,-2,1.0,12.0
1664,1965-1966,13,Go Ahead Eagles,Fortuna '54,0,0,3,1,1,0,0,7.0,6.0
1665,1965-1966,13,Heracles Almelo,DWS Amsterdam,0,1,2,0,3,1,-1,5.0,8.0
1666,1965-1966,13,MVV Maastricht,Willem II,3,1,1,3,0,4,2,4.0,3.0
1667,1965-1966,13,PSV,GVAV Groningen,0,2,2,0,3,2,-2,8.0,12.0
1668,1965-1966,13,Sparta Rotterdam,DOS Utrecht,3,1,1,3,0,4,2,10.0,5.0
1669,1965-1966,13,Telstar,ADO Den Haag,2,2,3,1,1,4,0,2.0,5.0
1670,1965-1966,14,ADO Den Haag,Go Ahead Eagles,4,0,1,3,0,4,4,7.0,6.0
1671,1965-1966,14,DWS Amsterdam,Sparta Rotterdam,1,1,3,1,1,2,0,6.0,11.0
1672,1965-1966,14,USV Elinkwijk,DOS Utrecht,6,2,1,3,0,8,4,3.0,4.0
1673,1965-1966,14,FC Twente,MVV Maastricht,0,0,3,1,1,0,0,4.0,5.0
1674,1965-1966,14,Feijenoord,AFC Ajax,1,1,3,1,1,2,0,13.0,13.0
1675,1965-1966,14,Fortuna '54,Heracles Almelo,1,0,1,3,0,1,1,9.0,2.0
1676,1965-1966,14,GVAV Groningen,Telstar,4,2,1,3,0,6,2,12.0,2.0
1677,1965-1966,14,Willem II,PSV,0,0,3,1,1,0,0,4.0,6.0
1678,1965-1966,15,AFC Ajax,USV Elinkwijk,7,0,1,3,0,7,7,13.0,3.0
1679,1965-1966,15,DOS Utrecht,DWS Amsterdam,2,3,2,0,3,5,-1,1.0,8.0
1680,1965-1966,15,Go Ahead Eagles,GVAV Groningen,2,0,1,3,0,2,2,8.0,9.0
1681,1965-1966,15,MVV Maastricht,Feijenoord,0,2,2,0,3,2,-2,4.0,13.0
1682,1965-1966,15,PSV,FC Twente,2,2,3,1,1,4,0,6.0,5.0
1683,1965-1966,15,Sparta Rotterdam,Fortuna '54,2,1,1,3,0,3,1,11.0,8.0
1684,1965-1966,15,Telstar,Willem II,1,3,2,0,3,4,-2,2.0,7.0
1685,1965-1966,15,ADO Den Haag,Heracles Almelo,2,2,3,1,1,4,0,8.0,2.0
1686,1965-1966,16,DOS Utrecht,AFC Ajax,1,2,2,0,3,3,-1,0.0,13.0
1687,1965-1966,16,DWS Amsterdam,Fortuna '54,4,1,1,3,0,5,3,10.0,7.0
1688,1965-1966,16,Go Ahead Eagles,Willem II,5,2,1,3,0,7,3,10.0,4.0
1689,1965-1966,16,Heracles Almelo,GVAV Groningen,2,1,1,3,0,3,1,4.0,9.0
1690,1965-1966,16,MVV Maastricht,USV Elinkwijk,1,0,1,3,0,1,1,7.0,3.0
1691,1965-1966,16,PSV,Feijenoord,1,3,2,0,3,4,-2,5.0,13.0
1692,1965-1966,16,Sparta Rotterdam,ADO Den Haag,0,4,2,0,3,4,-4,10.0,8.0
1693,1965-1966,16,Telstar,FC Twente,1,0,1,3,0,1,1,4.0,5.0
1694,1965-1966,17,ADO Den Haag,DWS Amsterdam,2,0,1,3,0,2,2,11.0,10.0
1695,1965-1966,17,AFC Ajax,MVV Maastricht,1,1,3,1,1,2,0,11.0,8.0
1696,1965-1966,17,USV Elinkwijk,PSV,1,3,2,0,3,4,-2,3.0,5.0
1697,1965-1966,17,FC Twente,Go Ahead Eagles,3,1,1,3,0,4,2,5.0,7.0
1698,1965-1966,17,Feijenoord,Telstar,2,1,1,3,0,3,1,13.0,4.0
1699,1965-1966,17,Fortuna '54,DOS Utrecht,0,1,2,0,3,1,-1,4.0,3.0
1700,1965-1966,17,GVAV Groningen,Sparta Rotterdam,1,0,1,3,0,1,1,9.0,7.0
1701,1965-1966,17,Willem II,Heracles Almelo,1,0,1,3,0,1,1,7.0,4.0
1702,1965-1966,18,DOS Utrecht,MVV Maastricht,2,2,3,1,1,4,0,4.0,6.0
1703,1965-1966,18,DWS Amsterdam,GVAV Groningen,3,1,1,3,0,4,2,10.0,6.0
1704,1965-1966,18,Fortuna '54,ADO Den Haag,2,1,1,3,0,3,1,6.0,10.0
1705,1965-1966,18,Go Ahead Eagles,Feijenoord,1,2,2,0,3,3,-1,6.0,13.0
1706,1965-1966,18,Heracles Almelo,FC Twente,2,0,1,3,0,2,2,7.0,5.0
1707,1965-1966,18,PSV,AFC Ajax,0,2,2,0,3,2,-2,5.0,11.0
1708,1965-1966,18,Sparta Rotterdam,Willem II,0,1,2,0,3,1,-1,4.0,10.0
1709,1965-1966,18,Telstar,USV Elinkwijk,3,1,1,3,0,4,2,6.0,3.0
1710,1965-1966,19,ADO Den Haag,DOS Utrecht,4,0,1,3,0,4,4,10.0,4.0
1711,1965-1966,19,AFC Ajax,Telstar,6,2,1,3,0,8,4,13.0,6.0
1712,1965-1966,19,USV Elinkwijk,Go Ahead Eagles,0,0,3,1,1,0,0,1.0,7.0
1713,1965-1966,19,FC Twente,Sparta Rotterdam,0,4,2,0,3,4,-4,4.0,6.0
1714,1965-1966,19,Feijenoord,Heracles Almelo,5,2,1,3,0,7,3,15.0,7.0
1715,1965-1966,19,GVAV Groningen,Fortuna '54,2,0,1,3,0,2,2,6.0,3.0
1716,1965-1966,19,MVV Maastricht,PSV,1,1,3,1,1,2,0,6.0,5.0
1717,1965-1966,19,Willem II,DWS Amsterdam,0,1,2,0,3,1,-1,9.0,12.0
1718,1965-1966,20,ADO Den Haag,GVAV Groningen,0,0,3,1,1,0,0,10.0,7.0
1719,1965-1966,20,DOS Utrecht,PSV,3,1,1,3,0,4,2,7.0,4.0
1720,1965-1966,20,DWS Amsterdam,FC Twente,1,1,3,1,1,2,0,10.0,4.0
1721,1965-1966,20,Fortuna '54,Willem II,1,0,1,3,0,1,1,6.0,6.0
1722,1965-1966,20,Go Ahead Eagles,AFC Ajax,1,2,2,0,3,3,-1,4.0,13.0
1723,1965-1966,20,Heracles Almelo,USV Elinkwijk,2,2,3,1,1,4,0,7.0,2.0
1724,1965-1966,20,Sparta Rotterdam,Feijenoord,0,2,2,0,3,2,-2,3.0,15.0
1725,1965-1966,20,Telstar,MVV Maastricht,3,1,1,3,0,4,2,9.0,6.0
1726,1965-1966,21,AFC Ajax,Heracles Almelo,1,0,1,3,0,1,1,13.0,4.0
1727,1965-1966,21,USV Elinkwijk,Sparta Rotterdam,1,2,2,0,3,3,-1,2.0,6.0
1728,1965-1966,21,FC Twente,Fortuna '54,1,0,1,3,0,1,1,7.0,6.0
1729,1965-1966,21,Feijenoord,DWS Amsterdam,1,0,1,3,0,1,1,15.0,7.0
1730,1965-1966,21,GVAV Groningen,DOS Utrecht,5,3,1,3,0,8,2,10.0,7.0
1731,1965-1966,21,MVV Maastricht,Go Ahead Eagles,1,0,1,3,0,1,1,6.0,1.0
1732,1965-1966,21,PSV,Telstar,3,1,1,3,0,4,2,7.0,6.0
1733,1965-1966,21,Willem II,ADO Den Haag,0,1,2,0,3,1,-1,6.0,10.0
1734,1965-1966,22,ADO Den Haag,FC Twente,4,1,1,3,0,5,3,10.0,4.0
1735,1965-1966,22,DOS Utrecht,Telstar,2,0,1,3,0,2,2,7.0,6.0
1736,1965-1966,22,DWS Amsterdam,USV Elinkwijk,2,0,1,3,0,2,2,10.0,2.0
1737,1965-1966,22,Fortuna '54,Feijenoord,1,1,3,1,1,2,0,7.0,13.0
1738,1965-1966,22,Go Ahead Eagles,PSV,3,1,1,3,0,4,2,4.0,4.0
1739,1965-1966,22,GVAV Groningen,Willem II,4,1,1,3,0,5,3,10.0,3.0
1740,1965-1966,22,Heracles Almelo,MVV Maastricht,1,0,1,3,0,1,1,7.0,5.0
1741,1965-1966,22,Sparta Rotterdam,AFC Ajax,1,3,2,0,3,4,-2,6.0,15.0
1742,1965-1966,23,AFC Ajax,DWS Amsterdam,2,1,1,3,0,3,1,15.0,7.0
1743,1965-1966,23,USV Elinkwijk,Fortuna '54,3,2,1,3,0,5,1,5.0,4.0
1744,1965-1966,23,FC Twente,GVAV Groningen,1,1,3,1,1,2,0,5.0,11.0
1745,1965-1966,23,Feijenoord,ADO Den Haag,3,1,1,3,0,4,2,13.0,10.0
1746,1965-1966,23,MVV Maastricht,Sparta Rotterdam,2,4,2,0,3,6,-2,4.0,9.0
1747,1965-1966,23,PSV,Heracles Almelo,5,1,1,3,0,6,4,7.0,4.0
1748,1965-1966,23,Telstar,Go Ahead Eagles,0,1,2,0,3,1,-1,3.0,7.0
1749,1965-1966,23,Willem II,DOS Utrecht,2,2,3,1,1,4,0,1.0,7.0
1750,1965-1966,24,ADO Den Haag,USV Elinkwijk,5,1,1,3,0,6,4,10.0,4.0
1751,1965-1966,24,DOS Utrecht,Go Ahead Eagles,1,5,2,0,3,6,-4,7.0,9.0
1752,1965-1966,24,DWS Amsterdam,MVV Maastricht,4,1,1,3,0,5,3,7.0,3.0
1753,1965-1966,24,Fortuna '54,AFC Ajax,2,1,1,3,0,3,1,7.0,12.0
1754,1965-1966,24,GVAV Groningen,Feijenoord,2,1,1,3,0,3,1,11.0,10.0
1755,1965-1966,24,Heracles Almelo,Telstar,1,1,3,1,1,2,0,5.0,4.0
1756,1965-1966,24,Sparta Rotterdam,PSV,1,1,3,1,1,2,0,7.0,7.0
1757,1965-1966,24,Willem II,FC Twente,4,0,1,3,0,4,4,4.0,5.0
1758,1965-1966,25,AFC Ajax,ADO Den Haag,5,1,1,3,0,6,4,12.0,9.0
1759,1965-1966,25,USV Elinkwijk,GVAV Groningen,1,1,3,1,1,2,0,4.0,11.0
1760,1965-1966,25,FC Twente,DOS Utrecht,5,1,1,3,0,6,4,7.0,4.0
1761,1965-1966,25,Feijenoord,Willem II,6,1,1,3,0,7,5,10.0,4.0
1762,1965-1966,25,Go Ahead Eagles,Heracles Almelo,2,0,1,3,0,2,2,12.0,4.0
1763,1965-1966,25,MVV Maastricht,Fortuna '54,5,0,1,3,0,5,5,6.0,4.0
1764,1965-1966,25,PSV,DWS Amsterdam,1,3,2,0,3,4,-2,7.0,9.0
1765,1965-1966,25,Telstar,Sparta Rotterdam,0,0,3,1,1,0,0,2.0,8.0
1766,1965-1966,26,ADO Den Haag,MVV Maastricht,4,0,1,3,0,4,4,9.0,3.0
1767,1965-1966,26,DOS Utrecht,Heracles Almelo,3,2,1,3,0,5,1,7.0,4.0
1768,1965-1966,26,DWS Amsterdam,Telstar,2,0,1,3,0,2,2,12.0,2.0
1769,1965-1966,26,FC Twente,Feijenoord,1,3,2,0,3,4,-2,4.0,10.0
1770,1965-1966,26,Fortuna '54,PSV,2,1,1,3,0,3,1,7.0,4.0
1771,1965-1966,26,GVAV Groningen,AFC Ajax,0,2,2,0,3,2,-2,8.0,12.0
1772,1965-1966,26,Sparta Rotterdam,Go Ahead Eagles,0,3,2,0,3,3,-3,5.0,15.0
1773,1965-1966,26,Willem II,USV Elinkwijk,2,3,2,0,3,5,-1,4.0,7.0
1774,1965-1966,27,AFC Ajax,Willem II,3,1,1,3,0,4,2,12.0,4.0
1775,1965-1966,27,USV Elinkwijk,FC Twente,2,1,1,3,0,3,1,10.0,4.0
1776,1965-1966,27,Feijenoord,DOS Utrecht,4,1,1,3,0,5,3,12.0,4.0
1777,1965-1966,27,Go Ahead Eagles,DWS Amsterdam,2,1,1,3,0,3,1,15.0,9.0
1778,1965-1966,27,Heracles Almelo,Sparta Rotterdam,3,1,1,3,0,4,2,4.0,5.0
1779,1965-1966,27,MVV Maastricht,GVAV Groningen,1,0,1,3,0,1,1,6.0,5.0
1780,1965-1966,27,PSV,ADO Den Haag,3,5,2,0,3,8,-2,4.0,9.0
1781,1965-1966,27,Telstar,Fortuna '54,3,0,1,3,0,3,3,5.0,6.0
1782,1965-1966,28,ADO Den Haag,Telstar,4,2,1,3,0,6,2,12.0,5.0
1783,1965-1966,28,DOS Utrecht,Sparta Rotterdam,5,1,1,3,0,6,4,6.0,2.0
1784,1965-1966,28,DWS Amsterdam,Heracles Almelo,4,1,1,3,0,5,3,12.0,4.0
1785,1965-1966,28,FC Twente,AFC Ajax,0,2,2,0,3,2,-2,3.0,12.0
1786,1965-1966,28,Feijenoord,USV Elinkwijk,0,1,2,0,3,1,-1,9.0,10.0
1787,1965-1966,28,Fortuna '54,Go Ahead Eagles,0,4,2,0,3,4,-4,6.0,15.0
1788,1965-1966,28,GVAV Groningen,PSV,2,0,1,3,0,2,2,7.0,1.0
1789,1965-1966,28,Willem II,MVV Maastricht,2,0,1,3,0,2,2,6.0,6.0
1790,1965-1966,29,AFC Ajax,Feijenoord,2,0,1,3,0,2,2,15.0,9.0
1791,1965-1966,29,DOS Utrecht,USV Elinkwijk,2,0,1,3,0,2,2,9.0,10.0
1792,1965-1966,29,Go Ahead Eagles,ADO Den Haag,0,1,2,0,3,1,-1,12.0,12.0
1793,1965-1966,29,Heracles Almelo,Fortuna '54,1,1,3,1,1,2,0,4.0,4.0
1794,1965-1966,29,MVV Maastricht,FC Twente,3,2,1,3,0,5,1,9.0,3.0
1795,1965-1966,29,PSV,Willem II,5,2,1,3,0,7,3,3.0,3.0
1796,1965-1966,29,Sparta Rotterdam,DWS Amsterdam,1,0,1,3,0,1,1,4.0,9.0
1797,1965-1966,29,Telstar,GVAV Groningen,2,0,1,3,0,2,2,7.0,4.0
1798,1965-1966,30,DWS Amsterdam,DOS Utrecht,1,2,2,0,3,3,-1,6.0,12.0
1799,1965-1966,30,USV Elinkwijk,AFC Ajax,3,3,3,1,1,6,0,10.0,13.0
1800,1965-1966,30,FC Twente,PSV,1,7,2,0,3,8,-6,0.0,6.0
1801,1965-1966,30,Feijenoord,MVV Maastricht,2,1,1,3,0,3,1,9.0,6.0
1802,1965-1966,30,Fortuna '54,Sparta Rotterdam,4,3,1,3,0,7,1,7.0,3.0
1803,1965-1966,30,GVAV Groningen,Go Ahead Eagles,2,4,2,0,3,6,-2,3.0,12.0
1804,1965-1966,30,Heracles Almelo,ADO Den Haag,2,2,3,1,1,4,0,5.0,13.0
1805,1965-1966,30,Willem II,Telstar,2,1,1,3,0,3,1,6.0,6.0
1806,1966-1967,1,FC Xerxes,GVAV Groningen,2,3,2,0,3,5,-1,,6.0
1807,1966-1967,1,ADO Den Haag,Fortuna '54,2,0,1,3,0,2,2,13.0,4.0
1808,1966-1967,1,DWS Amsterdam,DOS Utrecht,3,1,1,3,0,4,2,6.0,9.0
1809,1966-1967,1,USV Elinkwijk,AFC Ajax,0,7,2,0,3,7,-7,7.0,13.0
1810,1966-1967,1,FC Twente,Go Ahead Eagles,1,3,2,0,3,4,-2,0.0,12.0
1811,1966-1967,1,MVV Maastricht,Willem II,2,2,3,1,1,4,0,7.0,7.0
1812,1966-1967,1,NAC Breda,Feijenoord,0,0,3,1,1,0,0,2.0,7.0
1813,1966-1967,1,Sittardia,Telstar,4,1,1,3,0,5,3,10.0,6.0
1814,1966-1967,1,Sparta Rotterdam,PSV,0,0,3,1,1,0,0,4.0,7.0
1815,1966-1967,2,AFC Ajax,NAC Breda,4,1,1,3,0,5,3,13.0,2.0
1816,1966-1967,2,DOS Utrecht,MVV Maastricht,0,2,2,0,3,2,-2,9.0,7.0
1817,1966-1967,2,Feijenoord,FC Twente,5,1,1,3,0,6,4,7.0,0.0
1818,1966-1967,2,Fortuna '54,FC Xerxes,4,1,1,3,0,5,3,7.0,
1819,1966-1967,2,Go Ahead Eagles,DWS Amsterdam,1,0,1,3,0,1,1,12.0,6.0
1820,1966-1967,2,GVAV Groningen,USV Elinkwijk,4,1,1,3,0,5,3,9.0,4.0
1821,1966-1967,2,PSV,Sittardia,1,2,2,0,3,3,-1,7.0,10.0
1822,1966-1967,2,Telstar,ADO Den Haag,2,4,2,0,3,6,-2,3.0,13.0
1823,1966-1967,2,Willem II,Sparta Rotterdam,0,3,2,0,3,3,-3,7.0,7.0
1824,1966-1967,3,FC Xerxes,ADO Den Haag,0,1,2,0,3,1,-1,,13.0
1825,1966-1967,3,DWS Amsterdam,Feijenoord,0,1,2,0,3,1,-1,3.0,10.0
1826,1966-1967,3,USV Elinkwijk,Fortuna '54,2,2,3,1,1,4,0,2.0,8.0
1827,1966-1967,3,FC Twente,AFC Ajax,1,1,3,1,1,2,0,1.0,11.0
1828,1966-1967,3,MVV Maastricht,Go Ahead Eagles,0,2,2,0,3,2,-2,7.0,12.0
1829,1966-1967,3,NAC Breda,GVAV Groningen,2,0,1,3,0,2,2,5.0,6.0
1830,1966-1967,3,PSV,Telstar,4,1,1,3,0,5,3,10.0,3.0
1831,1966-1967,3,Sittardia,Willem II,1,1,3,1,1,2,0,8.0,5.0
1832,1966-1967,3,Sparta Rotterdam,DOS Utrecht,2,0,1,3,0,2,2,10.0,6.0
1833,1966-1967,4,AFC Ajax,DWS Amsterdam,5,0,1,3,0,5,5,11.0,3.0
1834,1966-1967,4,ADO Den Haag,USV Elinkwijk,6,1,1,3,0,7,5,13.0,2.0
1835,1966-1967,4,DOS Utrecht,Sittardia,1,1,3,1,1,2,0,4.0,8.0
1836,1966-1967,4,Feijenoord,MVV Maastricht,5,0,1,3,0,5,5,13.0,4.0
1837,1966-1967,4,Fortuna '54,NAC Breda,1,3,2,0,3,4,-2,7.0,8.0
1838,1966-1967,4,Go Ahead Eagles,Sparta Rotterdam,2,4,2,0,3,6,-2,12.0,10.0
1839,1966-1967,4,GVAV Groningen,FC Twente,0,0,3,1,1,0,0,7.0,2.0
1840,1966-1967,4,Telstar,FC Xerxes,0,2,2,0,3,2,-2,0.0,
1841,1966-1967,4,Willem II,PSV,3,4,2,0,3,7,-1,5.0,10.0
1842,1966-1967,5,DWS Amsterdam,GVAV Groningen,2,1,1,3,0,3,1,6.0,7.0
1843,1966-1967,5,USV Elinkwijk,FC Xerxes,0,0,3,1,1,0,0,2.0,4.0
1844,1966-1967,5,FC Twente,Fortuna '54,2,2,3,1,1,4,0,3.0,5.0
1845,1966-1967,5,MVV Maastricht,AFC Ajax,2,4,2,0,3,6,-2,4.0,13.0
1846,1966-1967,5,NAC Breda,ADO Den Haag,0,2,2,0,3,2,-2,7.0,15.0
1847,1966-1967,5,PSV,DOS Utrecht,2,3,2,0,3,5,-1,7.0,4.0
1848,1966-1967,5,Sittardia,Go Ahead Eagles,2,1,1,3,0,3,1,11.0,9.0
1849,1966-1967,5,Sparta Rotterdam,Feijenoord,0,0,3,1,1,0,0,11.0,11.0
1850,1966-1967,5,Willem II,Telstar,5,2,1,3,0,7,3,5.0,0.0
1851,1966-1967,6,ADO Den Haag,FC Twente,2,1,1,3,0,3,1,15.0,3.0
1852,1966-1967,6,AFC Ajax,Sparta Rotterdam,5,0,1,3,0,5,5,13.0,10.0
1853,1966-1967,6,DOS Utrecht,Willem II,4,0,1,3,0,4,4,7.0,4.0
1854,1966-1967,6,Feijenoord,Sittardia,1,0,1,3,0,1,1,13.0,8.0
1855,1966-1967,6,Fortuna '54,DWS Amsterdam,4,0,1,3,0,4,4,8.0,3.0
1856,1966-1967,6,Go Ahead Eagles,PSV,1,0,1,3,0,1,1,9.0,6.0
1857,1966-1967,6,GVAV Groningen,MVV Maastricht,5,0,1,3,0,5,5,7.0,3.0
1858,1966-1967,6,Telstar,USV Elinkwijk,3,2,1,3,0,5,1,3.0,2.0
1859,1966-1967,6,FC Xerxes,NAC Breda,2,1,1,3,0,3,1,7.0,6.0
1860,1966-1967,7,DOS Utrecht,Telstar,3,1,1,3,0,4,2,10.0,3.0
1861,1966-1967,7,DWS Amsterdam,ADO Den Haag,4,4,3,1,1,8,0,4.0,13.0
1862,1966-1967,7,FC Twente,FC Xerxes,2,1,1,3,0,3,1,6.0,7.0
1863,1966-1967,7,MVV Maastricht,Fortuna '54,1,1,3,1,1,2,0,1.0,6.0
1864,1966-1967,7,NAC Breda,USV Elinkwijk,4,3,1,3,0,7,1,9.0,2.0
1865,1966-1967,7,PSV,Feijenoord,2,2,3,1,1,4,0,7.0,11.0
1866,1966-1967,7,Sittardia,AFC Ajax,1,1,3,1,1,2,0,6.0,11.0
1867,1966-1967,7,Sparta Rotterdam,GVAV Groningen,2,0,1,3,0,2,2,10.0,4.0
1868,1966-1967,7,Willem II,Go Ahead Eagles,0,3,2,0,3,3,-3,4.0,9.0
1869,1966-1967,8,ADO Den Haag,MVV Maastricht,0,0,3,1,1,0,0,11.0,2.0
1870,1966-1967,8,AFC Ajax,PSV,3,1,1,3,0,4,2,13.0,4.0
1871,1966-1967,8,USV Elinkwijk,FC Twente,2,3,2,0,3,5,-1,1.0,8.0
1872,1966-1967,8,Feijenoord,Willem II,5,1,1,3,0,6,4,11.0,3.0
1873,1966-1967,8,Fortuna '54,Sparta Rotterdam,1,2,2,0,3,3,-1,5.0,10.0
1874,1966-1967,8,Go Ahead Eagles,DOS Utrecht,5,0,1,3,0,5,5,9.0,10.0
1875,1966-1967,8,GVAV Groningen,Sittardia,2,0,1,3,0,2,2,7.0,5.0
1876,1966-1967,8,Telstar,NAC Breda,1,1,3,1,1,2,0,4.0,7.0
1877,1966-1967,8,FC Xerxes,DWS Amsterdam,2,1,1,3,0,3,1,10.0,4.0
1878,1966-1967,9,DOS Utrecht,Feijenoord,0,5,2,0,3,5,-5,9.0,11.0
1879,1966-1967,9,DWS Amsterdam,USV Elinkwijk,6,2,1,3,0,8,4,7.0,1.0
1880,1966-1967,9,FC Twente,NAC Breda,1,0,1,3,0,1,1,10.0,4.0
1881,1966-1967,9,Go Ahead Eagles,Telstar,0,2,2,0,3,2,-2,9.0,7.0
1882,1966-1967,9,MVV Maastricht,FC Xerxes,1,1,3,1,1,2,0,3.0,8.0
1883,1966-1967,9,PSV,GVAV Groningen,1,0,1,3,0,1,1,4.0,6.0
1884,1966-1967,9,Sittardia,Fortuna '54,1,2,2,0,3,3,-1,4.0,8.0
1885,1966-1967,9,Sparta Rotterdam,ADO Den Haag,4,2,1,3,0,6,2,10.0,8.0
1886,1966-1967,9,Willem II,AFC Ajax,0,4,2,0,3,4,-4,3.0,13.0
1887,1966-1967,10,ADO Den Haag,Sittardia,1,2,2,0,3,3,-1,5.0,4.0
1888,1966-1967,10,AFC Ajax,DOS Utrecht,3,1,1,3,0,4,2,13.0,6.0
1889,1966-1967,10,USV Elinkwijk,MVV Maastricht,0,0,3,1,1,0,0,1.0,4.0
1890,1966-1967,10,Feijenoord,Go Ahead Eagles,2,1,1,3,0,3,1,13.0,9.0
1891,1966-1967,10,Fortuna '54,PSV,2,3,2,0,3,5,-1,7.0,7.0
1892,1966-1967,10,GVAV Groningen,Willem II,3,0,1,3,0,3,3,9.0,0.0
1893,1966-1967,10,NAC Breda,DWS Amsterdam,4,4,3,1,1,8,0,5.0,5.0
1894,1966-1967,10,Telstar,FC Twente,4,4,3,1,1,8,0,8.0,10.0
1895,1966-1967,10,FC Xerxes,Sparta Rotterdam,0,0,3,1,1,0,0,8.0,10.0
1896,1966-1967,11,DOS Utrecht,GVAV Groningen,1,1,3,1,1,2,0,4.0,7.0
1897,1966-1967,11,DWS Amsterdam,FC Twente,4,3,1,3,0,7,1,8.0,10.0
1898,1966-1967,11,Feijenoord,Telstar,3,1,1,3,0,4,2,13.0,5.0
1899,1966-1967,11,Go Ahead Eagles,AFC Ajax,2,3,2,0,3,5,-1,6.0,13.0
1900,1966-1967,11,MVV Maastricht,NAC Breda,4,1,1,3,0,5,3,7.0,5.0
1901,1966-1967,11,PSV,ADO Den Haag,1,1,3,1,1,2,0,8.0,3.0
1902,1966-1967,11,Sittardia,FC Xerxes,1,3,2,0,3,4,-2,4.0,8.0
1903,1966-1967,11,Sparta Rotterdam,USV Elinkwijk,2,1,1,3,0,3,1,13.0,1.0
1904,1966-1967,11,Willem II,Fortuna '54,2,1,1,3,0,3,1,3.0,4.0
1905,1966-1967,12,ADO Den Haag,Willem II,6,1,1,3,0,7,5,5.0,3.0
1906,1966-1967,12,AFC Ajax,Feijenoord,5,0,1,3,0,5,5,15.0,12.0
1907,1966-1967,12,USV Elinkwijk,Sittardia,1,0,1,3,0,1,1,4.0,3.0
1908,1966-1967,12,FC Twente,MVV Maastricht,1,2,2,0,3,3,-1,7.0,9.0
1909,1966-1967,12,Fortuna '54,DOS Utrecht,0,3,2,0,3,3,-3,3.0,4.0
1910,1966-1967,12,GVAV Groningen,Go Ahead Eagles,1,3,2,0,3,4,-2,7.0,6.0
1911,1966-1967,12,NAC Breda,Sparta Rotterdam,1,1,3,1,1,2,0,3.0,11.0
1912,1966-1967,12,Telstar,DWS Amsterdam,0,0,3,1,1,0,0,6.0,8.0
1913,1966-1967,12,FC Xerxes,PSV,4,0,1,3,0,4,4,11.0,7.0
1914,1966-1967,13,AFC Ajax,Telstar,4,2,1,3,0,6,2,15.0,5.0
1915,1966-1967,13,DOS Utrecht,ADO Den Haag,2,1,1,3,0,3,1,7.0,4.0
1916,1966-1967,13,Feijenoord,GVAV Groningen,3,0,1,3,0,3,3,12.0,4.0
1917,1966-1967,13,Go Ahead Eagles,Fortuna '54,4,0,1,3,0,4,4,6.0,3.0
1918,1966-1967,13,MVV Maastricht,DWS Amsterdam,0,0,3,1,1,0,0,9.0,9.0
1919,1966-1967,13,PSV,USV Elinkwijk,8,2,1,3,0,10,6,10.0,4.0
1920,1966-1967,13,Sittardia,NAC Breda,2,0,1,3,0,2,2,6.0,2.0
1921,1966-1967,13,Sparta Rotterdam,FC Twente,1,0,1,3,0,1,1,11.0,4.0
1922,1966-1967,13,Willem II,FC Xerxes,1,1,3,1,1,2,0,4.0,9.0
1923,1966-1967,14,ADO Den Haag,Go Ahead Eagles,1,1,3,1,1,2,0,5.0,7.0
1924,1966-1967,14,DWS Amsterdam,Sparta Rotterdam,1,0,1,3,0,1,1,9.0,8.0
1925,1966-1967,14,USV Elinkwijk,Willem II,2,1,1,3,0,3,1,7.0,4.0
1926,1966-1967,14,FC Twente,Sittardia,1,1,3,1,1,2,0,2.0,7.0
1927,1966-1967,14,Fortuna '54,Feijenoord,2,6,2,0,3,8,-4,0.0,12.0
1928,1966-1967,14,GVAV Groningen,AFC Ajax,3,8,2,0,3,11,-5,4.0,15.0
1929,1966-1967,14,NAC Breda,PSV,3,0,1,3,0,3,3,5.0,7.0
1930,1966-1967,14,Telstar,MVV Maastricht,1,1,3,1,1,2,0,3.0,9.0
1931,1966-1967,14,FC Xerxes,DOS Utrecht,6,1,1,3,0,7,5,11.0,7.0
1932,1966-1967,15,DOS Utrecht,USV Elinkwijk,3,0,1,3,0,3,3,10.0,6.0
1933,1966-1967,15,GVAV Groningen,Telstar,2,0,1,3,0,2,2,4.0,2.0
1934,1966-1967,15,Sittardia,DWS Amsterdam,1,1,3,1,1,2,0,5.0,9.0
1935,1966-1967,15,Sparta Rotterdam,MVV Maastricht,2,1,1,3,0,3,1,10.0,8.0
1936,1966-1967,15,Go Ahead Eagles,FC Xerxes,2,0,1,3,0,2,2,10.0,10.0
1937,1966-1967,15,PSV,FC Twente,2,2,3,1,1,4,0,5.0,2.0
1938,1966-1967,15,AFC Ajax,Fortuna '54,1,0,1,3,0,1,1,15.0,0.0
1939,1966-1967,15,Feijenoord,ADO Den Haag,1,1,3,1,1,2,0,10.0,6.0
1940,1966-1967,15,Willem II,NAC Breda,0,0,3,1,1,0,0,5.0,5.0
1941,1966-1967,16,ADO Den Haag,AFC Ajax,2,0,1,3,0,2,2,8.0,12.0
1942,1966-1967,16,FC Twente,Willem II,1,1,3,1,1,2,0,3.0,3.0
1943,1966-1967,16,Fortuna '54,GVAV Groningen,3,2,1,3,0,5,1,3.0,3.0
1944,1966-1967,16,FC Xerxes,Feijenoord,1,1,3,1,1,2,0,8.0,8.0
1945,1966-1967,16,NAC Breda,DOS Utrecht,4,1,1,3,0,5,3,8.0,9.0
1946,1966-1967,16,MVV Maastricht,Sittardia,3,0,1,3,0,3,3,8.0,5.0
1947,1966-1967,16,Sparta Rotterdam,Telstar,4,0,1,3,0,4,4,10.0,2.0
1948,1966-1967,16,DWS Amsterdam,PSV,2,4,2,0,3,6,-2,6.0,7.0
1949,1966-1967,16,USV Elinkwijk,Go Ahead Eagles,1,2,2,0,3,3,-1,6.0,13.0
1950,1966-1967,17,AFC Ajax,FC Xerxes,4,1,1,3,0,5,3,12.0,5.0
1951,1966-1967,17,DOS Utrecht,FC Twente,2,1,1,3,0,3,1,9.0,3.0
1952,1966-1967,17,Feijenoord,USV Elinkwijk,4,0,1,3,0,4,4,11.0,3.0
1953,1966-1967,17,Go Ahead Eagles,NAC Breda,0,0,3,1,1,0,0,11.0,8.0
1954,1966-1967,17,GVAV Groningen,ADO Den Haag,0,0,3,1,1,0,0,4.0,6.0
1955,1966-1967,17,PSV,MVV Maastricht,2,2,3,1,1,4,0,8.0,6.0
1956,1966-1967,17,Sittardia,Sparta Rotterdam,0,1,2,0,3,1,-1,5.0,12.0
1957,1966-1967,17,Telstar,Fortuna '54,2,0,1,3,0,2,2,4.0,3.0
1958,1966-1967,17,Willem II,DWS Amsterdam,1,3,2,0,3,4,-2,3.0,8.0
1959,1966-1967,18,AFC Ajax,USV Elinkwijk,8,0,1,3,0,8,8,12.0,3.0
1960,1966-1967,18,DOS Utrecht,DWS Amsterdam,2,2,3,1,1,4,0,7.0,8.0
1961,1966-1967,18,Feijenoord,NAC Breda,1,1,3,1,1,2,0,9.0,9.0
1962,1966-1967,18,Fortuna '54,ADO Den Haag,1,3,2,0,3,4,-2,3.0,9.0
1963,1966-1967,18,Go Ahead Eagles,FC Twente,1,0,1,3,0,1,1,11.0,3.0
1964,1966-1967,18,GVAV Groningen,FC Xerxes,2,1,1,3,0,3,1,7.0,4.0
1965,1966-1967,18,PSV,Sparta Rotterdam,1,0,1,3,0,1,1,8.0,9.0
1966,1966-1967,18,Telstar,Sittardia,2,0,1,3,0,2,2,7.0,2.0
1967,1966-1967,18,Willem II,MVV Maastricht,1,1,3,1,1,2,0,3.0,6.0
1968,1966-1967,19,ADO Den Haag,Telstar,2,1,1,3,0,3,1,11.0,6.0
1969,1966-1967,19,DWS Amsterdam,Go Ahead Eagles,2,1,1,3,0,3,1,8.0,10.0
1970,1966-1967,19,USV Elinkwijk,GVAV Groningen,0,3,2,0,3,3,-3,0.0,10.0
1971,1966-1967,19,FC Twente,Feijenoord,1,1,3,1,1,2,0,3.0,7.0
1972,1966-1967,19,NAC Breda,AFC Ajax,0,1,2,0,3,1,-1,6.0,12.0
1973,1966-1967,19,Sittardia,PSV,0,0,3,1,1,0,0,2.0,9.0
1974,1966-1967,19,FC Xerxes,Fortuna '54,2,2,3,1,1,4,0,2.0,4.0
1975,1966-1967,19,MVV Maastricht,DOS Utrecht,3,0,1,3,0,3,3,8.0,7.0
1976,1966-1967,19,Sparta Rotterdam,Willem II,2,0,1,3,0,2,2,12.0,3.0
1977,1966-1967,20,ADO Den Haag,FC Xerxes,0,1,2,0,3,1,-1,10.0,5.0
1978,1966-1967,20,AFC Ajax,FC Twente,6,1,1,3,0,7,5,12.0,2.0
1979,1966-1967,20,DOS Utrecht,Sparta Rotterdam,1,3,2,0,3,4,-2,4.0,12.0
1980,1966-1967,20,Feijenoord,DWS Amsterdam,3,2,1,3,0,5,1,9.0,7.0
1981,1966-1967,20,Fortuna '54,USV Elinkwijk,2,0,1,3,0,2,2,7.0,0.0
1982,1966-1967,20,Go Ahead Eagles,MVV Maastricht,3,0,1,3,0,3,3,10.0,8.0
1983,1966-1967,20,GVAV Groningen,NAC Breda,1,0,1,3,0,1,1,10.0,5.0
1984,1966-1967,20,Telstar,PSV,1,1,3,1,1,2,0,7.0,9.0
1985,1966-1967,20,Willem II,Sittardia,0,1,2,0,3,1,-1,2.0,4.0
1986,1966-1967,21,DWS Amsterdam,AFC Ajax,1,1,3,1,1,2,0,8.0,13.0
1987,1966-1967,21,USV Elinkwijk,ADO Den Haag,0,1,2,0,3,1,-1,0.0,10.0
1988,1966-1967,21,FC Twente,GVAV Groningen,1,1,3,1,1,2,0,2.0,11.0
1989,1966-1967,21,MVV Maastricht,Feijenoord,1,0,1,3,0,1,1,8.0,8.0
1990,1966-1967,21,NAC Breda,Fortuna '54,2,2,3,1,1,4,0,3.0,5.0
1991,1966-1967,21,PSV,Willem II,4,1,1,3,0,5,3,9.0,1.0
1992,1966-1967,21,Sittardia,DOS Utrecht,3,0,1,3,0,3,3,7.0,4.0
1993,1966-1967,21,Sparta Rotterdam,Go Ahead Eagles,1,0,1,3,0,1,1,12.0,7.0
1994,1966-1967,21,FC Xerxes,Telstar,3,1,1,3,0,4,2,7.0,7.0
1995,1966-1967,22,ADO Den Haag,NAC Breda,4,3,1,3,0,7,1,12.0,2.0
1996,1966-1967,22,AFC Ajax,MVV Maastricht,8,3,1,3,0,11,5,13.0,7.0
1997,1966-1967,22,DOS Utrecht,PSV,2,3,2,0,3,5,-1,1.0,11.0
1998,1966-1967,22,Feijenoord,Sparta Rotterdam,2,1,1,3,0,3,1,8.0,9.0
1999,1966-1967,22,Fortuna '54,FC Twente,0,2,2,0,3,2,-2,5.0,5.0
2000,1966-1967,22,Go Ahead Eagles,Sittardia,4,0,1,3,0,4,4,9.0,7.0
2001,1966-1967,22,GVAV Groningen,DWS Amsterdam,0,0,3,1,1,0,0,11.0,6.0
2002,1966-1967,22,Telstar,Willem II,3,1,1,3,0,4,2,7.0,1.0
2003,1966-1967,22,FC Xerxes,USV Elinkwijk,2,1,1,3,0,3,1,10.0,0.0
2004,1966-1967,23,DWS Amsterdam,Fortuna '54,0,1,2,0,3,1,-1,5.0,8.0
2005,1966-1967,23,USV Elinkwijk,Telstar,2,0,1,3,0,2,2,3.0,4.0
2006,1966-1967,23,FC Twente,ADO Den Haag,0,2,2,0,3,2,-2,5.0,12.0
2007,1966-1967,23,MVV Maastricht,GVAV Groningen,2,0,1,3,0,2,2,9.0,8.0
2008,1966-1967,23,NAC Breda,FC Xerxes,1,0,1,3,0,1,1,4.0,10.0
2009,1966-1967,23,PSV,Go Ahead Eagles,0,1,2,0,3,1,-1,8.0,9.0
2010,1966-1967,23,Sittardia,Feijenoord,1,0,1,3,0,1,1,10.0,7.0
2011,1966-1967,23,Sparta Rotterdam,AFC Ajax,2,1,1,3,0,3,1,12.0,10.0
2012,1966-1967,23,Willem II,DOS Utrecht,2,2,3,1,1,4,0,1.0,1.0
2013,1966-1967,24,ADO Den Haag,DWS Amsterdam,1,0,1,3,0,1,1,12.0,2.0
2014,1966-1967,24,AFC Ajax,Sittardia,6,0,1,3,0,6,6,10.0,9.0
2015,1966-1967,24,USV Elinkwijk,NAC Breda,2,1,1,3,0,3,1,6.0,4.0
2016,1966-1967,24,Feijenoord,PSV,4,2,1,3,0,6,2,9.0,7.0
2017,1966-1967,24,Fortuna '54,MVV Maastricht,1,1,3,1,1,2,0,8.0,7.0
2018,1966-1967,24,Go Ahead Eagles,Willem II,2,0,1,3,0,2,2,12.0,1.0
2019,1966-1967,24,Telstar,DOS Utrecht,2,2,3,1,1,4,0,5.0,2.0
2020,1966-1967,24,FC Xerxes,FC Twente,0,1,2,0,3,1,-1,9.0,7.0
2021,1966-1967,24,GVAV Groningen,Sparta Rotterdam,0,0,3,1,1,0,0,6.0,10.0
2022,1966-1967,25,DOS Utrecht,Go Ahead Eagles,3,0,1,3,0,3,3,5.0,9.0
2023,1966-1967,25,DWS Amsterdam,FC Xerxes,5,1,1,3,0,6,4,5.0,6.0
2024,1966-1967,25,FC Twente,USV Elinkwijk,2,2,3,1,1,4,0,8.0,7.0
2025,1966-1967,25,MVV Maastricht,ADO Den Haag,2,2,3,1,1,4,0,8.0,13.0
2026,1966-1967,25,NAC Breda,Telstar,0,2,2,0,3,2,-2,4.0,7.0
2027,1966-1967,25,PSV,AFC Ajax,2,1,1,3,0,3,1,9.0,7.0
2028,1966-1967,25,Sittardia,GVAV Groningen,1,0,1,3,0,1,1,9.0,3.0
2029,1966-1967,25,Sparta Rotterdam,Fortuna '54,4,0,1,3,0,4,4,10.0,5.0
2030,1966-1967,25,Willem II,Feijenoord,0,3,2,0,3,3,-3,1.0,9.0
2031,1966-1967,26,ADO Den Haag,Sparta Rotterdam,2,1,1,3,0,3,1,13.0,7.0
2032,1966-1967,26,USV Elinkwijk,DWS Amsterdam,1,0,1,3,0,1,1,10.0,4.0
2033,1966-1967,26,Feijenoord,DOS Utrecht,4,2,1,3,0,6,2,12.0,5.0
2034,1966-1967,26,Fortuna '54,Sittardia,1,0,1,3,0,1,1,7.0,6.0
2035,1966-1967,26,GVAV Groningen,PSV,4,0,1,3,0,4,4,5.0,6.0
2036,1966-1967,26,NAC Breda,FC Twente,2,0,1,3,0,2,2,6.0,7.0
2037,1966-1967,26,Telstar,Go Ahead Eagles,3,3,3,1,1,6,0,8.0,10.0
2038,1966-1967,26,FC Xerxes,MVV Maastricht,2,0,1,3,0,2,2,6.0,5.0
2039,1966-1967,26,AFC Ajax,Willem II,4,0,1,3,0,4,4,9.0,1.0
2040,1966-1967,27,DOS Utrecht,AFC Ajax,0,4,2,0,3,4,-4,5.0,9.0
2041,1966-1967,27,DWS Amsterdam,NAC Breda,1,0,1,3,0,1,1,6.0,6.0
2042,1966-1967,27,FC Twente,Telstar,1,0,1,3,0,1,1,7.0,5.0
2043,1966-1967,27,Go Ahead Eagles,Feijenoord,1,0,1,3,0,1,1,10.0,9.0
2044,1966-1967,27,MVV Maastricht,USV Elinkwijk,1,1,3,1,1,2,0,6.0,11.0
2045,1966-1967,27,PSV,Fortuna '54,2,2,3,1,1,4,0,4.0,8.0
2046,1966-1967,27,Sittardia,ADO Den Haag,1,0,1,3,0,1,1,9.0,10.0
2047,1966-1967,27,Sparta Rotterdam,FC Xerxes,2,0,1,3,0,2,2,10.0,3.0
2048,1966-1967,27,Willem II,GVAV Groningen,0,2,2,0,3,2,-2,1.0,7.0
2049,1966-1967,28,ADO Den Haag,PSV,3,2,1,3,0,5,1,10.0,4.0
2050,1966-1967,28,AFC Ajax,Go Ahead Eagles,4,1,1,3,0,5,3,12.0,7.0
2051,1966-1967,28,USV Elinkwijk,Sparta Rotterdam,1,1,3,1,1,2,0,9.0,8.0
2052,1966-1967,28,FC Twente,DWS Amsterdam,0,2,2,0,3,2,-2,7.0,9.0
2053,1966-1967,28,Fortuna '54,Willem II,1,1,3,1,1,2,0,6.0,1.0
2054,1966-1967,28,GVAV Groningen,DOS Utrecht,4,1,1,3,0,5,3,10.0,4.0
2055,1966-1967,28,NAC Breda,MVV Maastricht,2,0,1,3,0,2,2,6.0,3.0
2056,1966-1967,28,Telstar,Feijenoord,0,2,2,0,3,2,-2,5.0,12.0
2057,1966-1967,28,FC Xerxes,Sittardia,1,1,3,1,1,2,0,4.0,7.0
2058,1966-1967,29,DOS Utrecht,Fortuna '54,1,0,1,3,0,1,1,6.0,5.0
2059,1966-1967,29,DWS Amsterdam,Telstar,1,0,1,3,0,1,1,12.0,4.0
2060,1966-1967,29,Feijenoord,AFC Ajax,1,1,3,1,1,2,0,10.0,10.0
2061,1966-1967,29,Go Ahead Eagles,GVAV Groningen,1,1,3,1,1,2,0,5.0,10.0
2062,1966-1967,29,MVV Maastricht,FC Twente,1,2,2,0,3,3,-1,2.0,7.0
2063,1966-1967,29,PSV,FC Xerxes,0,0,3,1,1,0,0,5.0,5.0
2064,1966-1967,29,Sittardia,USV Elinkwijk,1,1,3,1,1,2,0,8.0,7.0
2065,1966-1967,29,Sparta Rotterdam,NAC Breda,2,0,1,3,0,2,2,10.0,6.0
2066,1966-1967,29,Willem II,ADO Den Haag,0,0,3,1,1,0,0,2.0,8.0
2067,1966-1967,30,ADO Den Haag,DOS Utrecht,6,1,1,3,0,7,5,10.0,3.0
2068,1966-1967,30,DWS Amsterdam,MVV Maastricht,4,0,1,3,0,4,4,12.0,1.0
2069,1966-1967,30,USV Elinkwijk,PSV,0,0,3,1,1,0,0,7.0,3.0
2070,1966-1967,30,FC Twente,Sparta Rotterdam,1,1,3,1,1,2,0,7.0,8.0
2071,1966-1967,30,Fortuna '54,Go Ahead Eagles,1,1,3,1,1,2,0,6.0,6.0
2072,1966-1967,30,GVAV Groningen,Feijenoord,1,4,2,0,3,5,-3,10.0,10.0
2073,1966-1967,30,NAC Breda,Sittardia,0,1,2,0,3,1,-1,6.0,8.0
2074,1966-1967,30,Telstar,AFC Ajax,0,3,2,0,3,3,-3,1.0,13.0
2075,1966-1967,30,FC Xerxes,Willem II,2,1,1,3,0,3,1,8.0,2.0
2076,1966-1967,31,AFC Ajax,GVAV Groningen,0,1,2,0,3,1,-1,10.0,10.0
2077,1966-1967,31,DOS Utrecht,FC Xerxes,1,2,2,0,3,3,-1,3.0,8.0
2078,1966-1967,31,Feijenoord,Fortuna '54,3,0,1,3,0,3,3,10.0,3.0
2079,1966-1967,31,Go Ahead Eagles,ADO Den Haag,1,1,3,1,1,2,0,6.0,8.0
2080,1966-1967,31,MVV Maastricht,Telstar,3,1,1,3,0,4,2,4.0,0.0
2081,1966-1967,31,PSV,NAC Breda,3,3,3,1,1,6,0,4.0,4.0
2082,1966-1967,31,Sittardia,FC Twente,2,0,1,3,0,2,2,11.0,7.0
2083,1966-1967,31,Sparta Rotterdam,DWS Amsterdam,1,0,1,3,0,1,1,11.0,12.0
2084,1966-1967,31,Willem II,USV Elinkwijk,0,2,2,0,3,2,-2,2.0,7.0
2085,1966-1967,32,ADO Den Haag,Feijenoord,1,1,3,1,1,2,0,9.0,11.0
2086,1966-1967,32,DWS Amsterdam,Sittardia,1,2,2,0,3,3,-1,9.0,11.0
2087,1966-1967,32,USV Elinkwijk,DOS Utrecht,0,2,2,0,3,2,-2,6.0,6.0
2088,1966-1967,32,FC Twente,PSV,1,4,2,0,3,5,-3,4.0,6.0
2089,1966-1967,32,Fortuna '54,AFC Ajax,2,3,2,0,3,5,-1,2.0,10.0
2090,1966-1967,32,MVV Maastricht,Sparta Rotterdam,0,1,2,0,3,1,-1,3.0,11.0
2091,1966-1967,32,NAC Breda,Willem II,1,0,1,3,0,1,1,7.0,2.0
2092,1966-1967,32,Telstar,GVAV Groningen,0,0,3,1,1,0,0,1.0,8.0
2093,1966-1967,32,FC Xerxes,Go Ahead Eagles,1,0,1,3,0,1,1,11.0,3.0
2094,1966-1967,33,AFC Ajax,ADO Den Haag,5,3,1,3,0,8,2,10.0,6.0
2095,1966-1967,33,DOS Utrecht,NAC Breda,0,1,2,0,3,1,-1,6.0,7.0
2096,1966-1967,33,Feijenoord,FC Xerxes,3,2,1,3,0,5,1,11.0,10.0
2097,1966-1967,33,Go Ahead Eagles,USV Elinkwijk,0,1,2,0,3,1,-1,3.0,8.0
2098,1966-1967,33,GVAV Groningen,Fortuna '54,1,2,2,0,3,3,-1,5.0,4.0
2099,1966-1967,33,PSV,DWS Amsterdam,2,1,1,3,0,3,1,9.0,6.0
2100,1966-1967,33,Sittardia,MVV Maastricht,1,2,2,0,3,3,-1,10.0,6.0
2101,1966-1967,33,Telstar,Sparta Rotterdam,2,0,1,3,0,2,2,4.0,10.0
2102,1966-1967,33,Willem II,FC Twente,0,2,2,0,3,2,-2,1.0,7.0
2103,1966-1967,34,ADO Den Haag,GVAV Groningen,3,0,1,3,0,3,3,8.0,4.0
2104,1966-1967,34,DWS Amsterdam,Willem II,3,1,1,3,0,4,2,6.0,0.0
2105,1966-1967,34,USV Elinkwijk,Feijenoord,1,5,2,0,3,6,-4,7.0,13.0
2106,1966-1967,34,FC Twente,DOS Utrecht,7,4,1,3,0,11,3,7.0,3.0
2107,1966-1967,34,Fortuna '54,Telstar,1,3,2,0,3,4,-2,4.0,7.0
2108,1966-1967,34,MVV Maastricht,PSV,2,3,2,0,3,5,-1,6.0,11.0
2109,1966-1967,34,NAC Breda,Go Ahead Eagles,2,4,2,0,3,6,-2,7.0,5.0
2110,1966-1967,34,Sparta Rotterdam,Sittardia,0,0,3,1,1,0,0,8.0,10.0
2111,1966-1967,34,FC Xerxes,AFC Ajax,0,4,2,0,3,4,-4,9.0,12.0
2112,1967-1968,1,AFC Ajax,Go Ahead Eagles,2,0,1,3,0,2,2,12.0,4.0
2113,1967-1968,1,FC Twente,DWS Amsterdam,1,3,2,0,3,4,-2,6.0,6.0
2114,1967-1968,1,Fortuna '54,GVAV Groningen,0,2,2,0,3,2,-2,3.0,7.0
2115,1967-1968,1,MVV Maastricht,Sittardia,6,4,1,3,0,10,2,9.0,7.0
2116,1967-1968,1,NAC Breda,ADO Den Haag,0,0,3,1,1,0,0,8.0,6.0
2117,1967-1968,1,NEC Nijmegen,Telstar,2,0,1,3,0,2,2,,7.0
2118,1967-1968,1,PSV,FC Volendam,1,1,3,1,1,2,0,11.0,5.0
2119,1967-1968,1,Sparta Rotterdam,DOS Utrecht,3,0,1,3,0,3,3,10.0,3.0
2120,1967-1968,1,Xerxes/D.H.C.,Feijenoord,0,3,2,0,3,3,-3,,13.0
2121,1967-1968,2,ADO Den Haag,Fortuna '54,0,0,3,1,1,0,0,6.0,4.0
2122,1967-1968,2,DOS Utrecht,NEC Nijmegen,2,2,3,1,1,4,0,4.0,
2123,1967-1968,2,DWS Amsterdam,PSV,1,2,2,0,3,3,-1,6.0,13.0
2124,1967-1968,2,Feijenoord,Sparta Rotterdam,3,1,1,3,0,4,2,13.0,7.0
2125,1967-1968,2,Go Ahead Eagles,NAC Breda,6,0,1,3,0,6,6,6.0,7.0
2126,1967-1968,2,GVAV Groningen,MVV Maastricht,2,2,3,1,1,4,0,5.0,7.0
2127,1967-1968,2,Sittardia,FC Twente,2,1,1,3,0,3,1,7.0,6.0
2128,1967-1968,2,Telstar,AFC Ajax,0,3,2,0,3,3,-3,7.0,15.0
2129,1967-1968,2,FC Volendam,Xerxes/D.H.C.,4,1,1,3,0,5,3,7.0,
2130,1967-1968,3,ADO Den Haag,GVAV Groningen,3,3,3,1,1,6,0,6.0,5.0
2131,1967-1968,3,AFC Ajax,DOS Utrecht,4,0,1,3,0,4,4,15.0,1.0
2132,1967-1968,3,FC Twente,MVV Maastricht,2,1,1,3,0,3,1,9.0,7.0
2133,1967-1968,3,Fortuna '54,Go Ahead Eagles,1,1,3,1,1,2,0,5.0,7.0
2134,1967-1968,3,NAC Breda,Telstar,2,1,1,3,0,3,1,7.0,6.0
2135,1967-1968,3,NEC Nijmegen,Feijenoord,0,5,2,0,3,5,-5,,15.0
2136,1967-1968,3,PSV,Sittardia,4,1,1,3,0,5,3,13.0,4.0
2137,1967-1968,3,Sparta Rotterdam,FC Volendam,1,1,3,1,1,2,0,5.0,7.0
2138,1967-1968,3,Xerxes/D.H.C.,DWS Amsterdam,1,2,2,0,3,3,-1,,9.0
2139,1967-1968,4,DOS Utrecht,NAC Breda,0,0,3,1,1,0,0,2.0,5.0
2140,1967-1968,4,DWS Amsterdam,Sparta Rotterdam,1,0,1,3,0,1,1,12.0,5.0
2141,1967-1968,4,Feijenoord,AFC Ajax,1,0,1,3,0,1,1,15.0,12.0
2142,1967-1968,4,Go Ahead Eagles,ADO Den Haag,0,4,2,0,3,4,-4,7.0,9.0
2143,1967-1968,4,GVAV Groningen,FC Twente,2,2,3,1,1,4,0,6.0,7.0
2144,1967-1968,4,MVV Maastricht,PSV,0,0,3,1,1,0,0,5.0,11.0
2145,1967-1968,4,Sittardia,Xerxes/D.H.C.,1,1,3,1,1,2,0,5.0,
2146,1967-1968,4,Telstar,Fortuna '54,3,1,1,3,0,4,2,6.0,2.0
2147,1967-1968,4,FC Volendam,NEC Nijmegen,0,0,3,1,1,0,0,7.0,
2148,1967-1968,5,ADO Den Haag,Telstar,2,1,1,3,0,3,1,9.0,3.0
2149,1967-1968,5,AFC Ajax,FC Volendam,7,1,1,3,0,8,6,12.0,6.0
2150,1967-1968,5,Fortuna '54,DOS Utrecht,2,2,3,1,1,4,0,3.0,3.0
2151,1967-1968,5,Go Ahead Eagles,GVAV Groningen,3,1,1,3,0,4,2,7.0,6.0
2152,1967-1968,5,NAC Breda,Feijenoord,0,3,2,0,3,3,-3,5.0,15.0
2153,1967-1968,5,NEC Nijmegen,DWS Amsterdam,2,2,3,1,1,4,0,6.0,10.0
2154,1967-1968,5,PSV,FC Twente,1,2,2,0,3,3,-1,8.0,7.0
2155,1967-1968,5,Sparta Rotterdam,Sittardia,5,0,1,3,0,5,5,7.0,4.0
2156,1967-1968,5,Xerxes/D.H.C.,MVV Maastricht,2,1,1,3,0,3,1,4.0,5.0
2157,1967-1968,6,DOS Utrecht,ADO Den Haag,2,2,3,1,1,4,0,4.0,9.0
2158,1967-1968,6,FC Twente,Xerxes/D.H.C.,2,0,1,3,0,2,2,10.0,4.0
2159,1967-1968,6,Feijenoord,Fortuna '54,6,0,1,3,0,6,6,15.0,3.0
2160,1967-1968,6,GVAV Groningen,PSV,2,1,1,3,0,3,1,6.0,7.0
2161,1967-1968,6,MVV Maastricht,Sparta Rotterdam,0,0,3,1,1,0,0,3.0,5.0
2162,1967-1968,6,Sittardia,NEC Nijmegen,1,3,2,0,3,4,-2,4.0,6.0
2163,1967-1968,6,Telstar,Go Ahead Eagles,2,1,1,3,0,3,1,6.0,7.0
2164,1967-1968,6,FC Volendam,NAC Breda,2,1,1,3,0,3,1,8.0,4.0
2165,1967-1968,6,DWS Amsterdam,AFC Ajax,1,4,2,0,3,5,-3,7.0,12.0
2166,1967-1968,7,ADO Den Haag,Feijenoord,3,6,2,0,3,9,-3,8.0,15.0
2167,1967-1968,7,AFC Ajax,Sittardia,4,0,1,3,0,4,4,12.0,1.0
2168,1967-1968,7,Fortuna '54,FC Volendam,5,0,1,3,0,5,5,5.0,5.0
2169,1967-1968,7,Go Ahead Eagles,DOS Utrecht,7,1,1,3,0,8,6,7.0,3.0
2170,1967-1968,7,NAC Breda,DWS Amsterdam,1,0,1,3,0,1,1,7.0,7.0
2171,1967-1968,7,NEC Nijmegen,MVV Maastricht,4,2,1,3,0,6,2,8.0,2.0
2172,1967-1968,7,Sparta Rotterdam,FC Twente,0,0,3,1,1,0,0,6.0,11.0
2173,1967-1968,7,Telstar,GVAV Groningen,0,3,2,0,3,3,-3,6.0,8.0
2174,1967-1968,7,Xerxes/D.H.C.,PSV,1,2,2,0,3,3,-1,4.0,7.0
2175,1967-1968,8,DOS Utrecht,Telstar,4,0,1,3,0,4,4,6.0,6.0
2176,1967-1968,8,DWS Amsterdam,Fortuna '54,2,0,1,3,0,2,2,7.0,4.0
2177,1967-1968,8,FC Twente,NEC Nijmegen,1,0,1,3,0,1,1,11.0,8.0
2178,1967-1968,8,Feijenoord,Go Ahead Eagles,3,1,1,3,0,4,2,15.0,6.0
2179,1967-1968,8,GVAV Groningen,Xerxes/D.H.C.,1,1,3,1,1,2,0,8.0,5.0
2180,1967-1968,8,MVV Maastricht,AFC Ajax,0,4,2,0,3,4,-4,2.0,12.0
2181,1967-1968,8,PSV,Sparta Rotterdam,1,5,2,0,3,6,-4,4.0,8.0
2182,1967-1968,8,Sittardia,NAC Breda,0,2,2,0,3,2,-2,1.0,7.0
2183,1967-1968,8,FC Volendam,ADO Den Haag,0,0,3,1,1,0,0,5.0,8.0
2184,1967-1968,9,ADO Den Haag,DWS Amsterdam,3,1,1,3,0,4,2,8.0,4.0
2185,1967-1968,9,DOS Utrecht,GVAV Groningen,2,2,3,1,1,4,0,6.0,8.0
2186,1967-1968,9,Fortuna '54,Sittardia,2,1,1,3,0,3,1,7.0,0.0
2187,1967-1968,9,Go Ahead Eagles,FC Volendam,3,1,1,3,0,4,2,9.0,4.0
2188,1967-1968,9,NAC Breda,MVV Maastricht,1,1,3,1,1,2,0,7.0,2.0
2189,1967-1968,9,NEC Nijmegen,PSV,4,0,1,3,0,4,4,10.0,3.0
2190,1967-1968,9,Sparta Rotterdam,Xerxes/D.H.C.,3,0,1,3,0,3,3,11.0,4.0
2191,1967-1968,9,Telstar,Feijenoord,1,2,2,0,3,3,-1,3.0,15.0
2192,1967-1968,9,AFC Ajax,FC Twente,2,1,1,3,0,3,1,15.0,10.0
2193,1967-1968,10,DWS Amsterdam,Go Ahead Eagles,1,3,2,0,3,4,-2,3.0,9.0
2194,1967-1968,10,FC Twente,NAC Breda,3,1,1,3,0,4,2,10.0,7.0
2195,1967-1968,10,Feijenoord,DOS Utrecht,5,0,1,3,0,5,5,15.0,5.0
2196,1967-1968,10,GVAV Groningen,Sparta Rotterdam,0,1,2,0,3,1,-1,8.0,11.0
2197,1967-1968,10,MVV Maastricht,Fortuna '54,2,0,1,3,0,2,2,5.0,6.0
2198,1967-1968,10,PSV,AFC Ajax,1,2,2,0,3,3,-1,3.0,15.0
2199,1967-1968,10,Sittardia,ADO Den Haag,2,2,3,1,1,4,0,1.0,6.0
2200,1967-1968,10,FC Volendam,Telstar,0,2,2,0,3,2,-2,4.0,6.0
2201,1967-1968,10,Xerxes/D.H.C.,NEC Nijmegen,2,1,1,3,0,3,1,4.0,9.0
2202,1967-1968,11,ADO Den Haag,MVV Maastricht,2,1,1,3,0,3,1,8.0,4.0
2203,1967-1968,11,AFC Ajax,Xerxes/D.H.C.,5,0,1,3,0,5,5,15.0,4.0
2204,1967-1968,11,DOS Utrecht,FC Volendam,2,1,1,3,0,3,1,7.0,1.0
2205,1967-1968,11,Feijenoord,GVAV Groningen,0,0,3,1,1,0,0,13.0,6.0
2206,1967-1968,11,Fortuna '54,FC Twente,4,2,1,3,0,6,2,9.0,7.0
2207,1967-1968,11,Go Ahead Eagles,Sittardia,3,0,1,3,0,3,3,12.0,1.0
2208,1967-1968,11,NAC Breda,PSV,2,1,1,3,0,3,1,10.0,3.0
2209,1967-1968,11,NEC Nijmegen,Sparta Rotterdam,3,1,1,3,0,4,2,9.0,10.0
2210,1967-1968,11,Telstar,DWS Amsterdam,1,1,3,1,1,2,0,4.0,4.0
2211,1967-1968,12,DWS Amsterdam,DOS Utrecht,3,1,1,3,0,4,2,7.0,7.0
2212,1967-1968,12,FC Twente,ADO Den Haag,0,3,2,0,3,3,-3,6.0,11.0
2213,1967-1968,12,GVAV Groningen,NEC Nijmegen,0,0,3,1,1,0,0,4.0,7.0
2214,1967-1968,12,MVV Maastricht,Go Ahead Eagles,1,1,3,1,1,2,0,5.0,10.0
2215,1967-1968,12,PSV,Fortuna '54,1,1,3,1,1,2,0,1.0,7.0
2216,1967-1968,12,Sittardia,Telstar,1,4,2,0,3,5,-3,1.0,7.0
2217,1967-1968,12,Sparta Rotterdam,AFC Ajax,1,0,1,3,0,1,1,12.0,12.0
2218,1967-1968,12,FC Volendam,Feijenoord,1,1,3,1,1,2,0,2.0,11.0
2219,1967-1968,12,Xerxes/D.H.C.,NAC Breda,3,0,1,3,0,3,3,7.0,7.0
2220,1967-1968,13,AFC Ajax,NEC Nijmegen,9,1,1,3,0,10,8,12.0,7.0
2221,1967-1968,13,Go Ahead Eagles,FC Twente,0,0,3,1,1,0,0,11.0,4.0
2222,1967-1968,13,Telstar,MVV Maastricht,0,0,3,1,1,0,0,8.0,6.0
2223,1967-1968,13,FC Volendam,GVAV Groningen,0,0,3,1,1,0,0,2.0,4.0
2224,1967-1968,13,ADO Den Haag,PSV,0,0,3,1,1,0,0,11.0,2.0
2225,1967-1968,13,DOS Utrecht,Sittardia,2,1,1,3,0,3,1,7.0,1.0
2226,1967-1968,13,Feijenoord,DWS Amsterdam,4,0,1,3,0,4,4,11.0,4.0
2227,1967-1968,13,Fortuna '54,Xerxes/D.H.C.,3,1,1,3,0,4,2,10.0,6.0
2228,1967-1968,13,NAC Breda,Sparta Rotterdam,1,0,1,3,0,1,1,7.0,9.0
2229,1967-1968,14,DWS Amsterdam,FC Volendam,3,3,3,1,1,6,0,5.0,3.0
2230,1967-1968,14,FC Twente,Telstar,4,2,1,3,0,6,2,7.0,8.0
2231,1967-1968,14,GVAV Groningen,AFC Ajax,1,1,3,1,1,2,0,4.0,10.0
2232,1967-1968,14,MVV Maastricht,DOS Utrecht,2,0,1,3,0,2,2,8.0,6.0
2233,1967-1968,14,NEC Nijmegen,NAC Breda,2,1,1,3,0,3,1,7.0,6.0
2234,1967-1968,14,PSV,Go Ahead Eagles,1,2,2,0,3,3,-1,2.0,11.0
2235,1967-1968,14,Sittardia,Feijenoord,1,2,2,0,3,3,-1,1.0,11.0
2236,1967-1968,14,Sparta Rotterdam,Fortuna '54,1,1,3,1,1,2,0,7.0,8.0
2237,1967-1968,14,Xerxes/D.H.C.,ADO Den Haag,0,1,2,0,3,1,-1,6.0,11.0
2238,1967-1968,15,ADO Den Haag,Sparta Rotterdam,2,0,1,3,0,2,2,13.0,4.0
2239,1967-1968,15,DOS Utrecht,FC Twente,5,0,1,3,0,5,5,9.0,4.0
2240,1967-1968,15,DWS Amsterdam,GVAV Groningen,1,1,3,1,1,2,0,6.0,5.0
2241,1967-1968,15,Feijenoord,MVV Maastricht,3,0,1,3,0,3,3,11.0,5.0
2242,1967-1968,15,Fortuna '54,NEC Nijmegen,2,2,3,1,1,4,0,9.0,8.0
2243,1967-1968,15,Go Ahead Eagles,Xerxes/D.H.C.,3,0,1,3,0,3,3,11.0,3.0
2244,1967-1968,15,NAC Breda,AFC Ajax,0,1,2,0,3,1,-1,6.0,10.0
2245,1967-1968,15,Telstar,PSV,2,1,1,3,0,3,1,8.0,2.0
2246,1967-1968,15,FC Volendam,Sittardia,1,0,1,3,0,1,1,6.0,0.0
2247,1967-1968,16,AFC Ajax,Fortuna '54,7,1,1,3,0,8,6,10.0,6.0
2248,1967-1968,16,FC Twente,Feijenoord,1,2,2,0,3,3,-1,4.0,13.0
2249,1967-1968,16,MVV Maastricht,FC Volendam,0,0,3,1,1,0,0,6.0,7.0
2250,1967-1968,16,NAC Breda,GVAV Groningen,0,0,3,1,1,0,0,4.0,5.0
2251,1967-1968,16,NEC Nijmegen,ADO Den Haag,1,0,1,3,0,1,1,8.0,10.0
2252,1967-1968,16,PSV,DOS Utrecht,1,1,3,1,1,2,0,3.0,7.0
2253,1967-1968,16,Sittardia,DWS Amsterdam,0,1,2,0,3,1,-1,0.0,8.0
2254,1967-1968,16,Sparta Rotterdam,Go Ahead Eagles,1,1,3,1,1,2,0,5.0,9.0
2255,1967-1968,16,Xerxes/D.H.C.,Telstar,3,0,1,3,0,3,3,6.0,7.0
2256,1967-1968,17,ADO Den Haag,AFC Ajax,1,0,1,3,0,1,1,10.0,10.0
2257,1967-1968,17,DOS Utrecht,Xerxes/D.H.C.,1,1,3,1,1,2,0,8.0,4.0
2258,1967-1968,17,DWS Amsterdam,MVV Maastricht,0,0,3,1,1,0,0,6.0,6.0
2259,1967-1968,17,Feijenoord,PSV,4,2,1,3,0,6,2,15.0,2.0
2260,1967-1968,17,Fortuna '54,NAC Breda,1,1,3,1,1,2,0,6.0,5.0
2261,1967-1968,17,Go Ahead Eagles,NEC Nijmegen,3,1,1,3,0,4,2,11.0,7.0
2262,1967-1968,17,GVAV Groningen,Sittardia,1,2,2,0,3,3,-1,4.0,3.0
2263,1967-1968,17,Telstar,Sparta Rotterdam,1,3,2,0,3,4,-2,4.0,5.0
2264,1967-1968,17,FC Volendam,FC Twente,1,1,3,1,1,2,0,7.0,5.0
2265,1967-1968,18,ADO Den Haag,NAC Breda,2,1,1,3,0,3,1,12.0,2.0
2266,1967-1968,18,DOS Utrecht,Sparta Rotterdam,1,1,3,1,1,2,0,6.0,6.0
2267,1967-1968,18,DWS Amsterdam,FC Twente,2,1,1,3,0,3,1,9.0,4.0
2268,1967-1968,18,Feijenoord,Xerxes/D.H.C.,0,1,2,0,3,1,-1,12.0,7.0
2269,1967-1968,18,Go Ahead Eagles,AFC Ajax,0,1,2,0,3,1,-1,10.0,10.0
2270,1967-1968,18,GVAV Groningen,Fortuna '54,2,0,1,3,0,2,2,6.0,3.0
2271,1967-1968,18,Sittardia,MVV Maastricht,2,2,3,1,1,4,0,4.0,6.0
2272,1967-1968,18,Telstar,NEC Nijmegen,2,0,1,3,0,2,2,6.0,7.0
2273,1967-1968,18,FC Volendam,PSV,2,0,1,3,0,2,2,9.0,1.0
2274,1967-1968,19,AFC Ajax,Telstar,3,0,1,3,0,3,3,12.0,6.0
2275,1967-1968,19,FC Twente,Sittardia,5,1,1,3,0,6,4,4.0,4.0
2276,1967-1968,19,Fortuna '54,ADO Den Haag,1,2,2,0,3,3,-1,2.0,12.0
2277,1967-1968,19,MVV Maastricht,GVAV Groningen,1,1,3,1,1,2,0,4.0,6.0
2278,1967-1968,19,NAC Breda,Go Ahead Eagles,1,2,2,0,3,3,-1,2.0,10.0
2279,1967-1968,19,NEC Nijmegen,DOS Utrecht,1,1,3,1,1,2,0,5.0,7.0
2280,1967-1968,19,PSV,DWS Amsterdam,5,1,1,3,0,6,4,4.0,8.0
2281,1967-1968,19,Sparta Rotterdam,Feijenoord,1,1,3,1,1,2,0,6.0,10.0
2282,1967-1968,19,Xerxes/D.H.C.,FC Volendam,1,1,3,1,1,2,0,8.0,9.0
2283,1967-1968,20,DOS Utrecht,AFC Ajax,1,1,3,1,1,2,0,5.0,10.0
2284,1967-1968,20,DWS Amsterdam,Xerxes/D.H.C.,1,2,2,0,3,3,-1,7.0,11.0
2285,1967-1968,20,Feijenoord,NEC Nijmegen,2,0,1,3,0,2,2,10.0,4.0
2286,1967-1968,20,MVV Maastricht,FC Twente,0,1,2,0,3,1,-1,4.0,7.0
2287,1967-1968,20,Sittardia,PSV,1,1,3,1,1,2,0,5.0,5.0
2288,1967-1968,20,Telstar,NAC Breda,4,0,1,3,0,4,4,6.0,2.0
2289,1967-1968,20,FC Volendam,Sparta Rotterdam,2,3,2,0,3,5,-1,6.0,9.0
2290,1967-1968,20,GVAV Groningen,ADO Den Haag,2,0,1,3,0,2,2,8.0,9.0
2291,1967-1968,20,Go Ahead Eagles,Fortuna '54,3,1,1,3,0,4,2,10.0,1.0
2292,1967-1968,21,ADO Den Haag,Go Ahead Eagles,0,0,3,1,1,0,0,10.0,10.0
2293,1967-1968,21,FC Twente,GVAV Groningen,1,2,2,0,3,3,-1,7.0,10.0
2294,1967-1968,21,Fortuna '54,Telstar,1,1,3,1,1,2,0,2.0,7.0
2295,1967-1968,21,NAC Breda,DOS Utrecht,1,1,3,1,1,2,0,2.0,5.0
2296,1967-1968,21,NEC Nijmegen,FC Volendam,2,2,3,1,1,4,0,2.0,6.0
2297,1967-1968,21,PSV,MVV Maastricht,0,3,2,0,3,3,-3,4.0,6.0
2298,1967-1968,21,Xerxes/D.H.C.,Sittardia,2,0,1,3,0,2,2,11.0,5.0
2299,1967-1968,21,AFC Ajax,Feijenoord,1,0,1,3,0,1,1,10.0,7.0
2300,1967-1968,21,Sparta Rotterdam,DWS Amsterdam,4,1,1,3,0,5,3,11.0,4.0
2301,1967-1968,22,DOS Utrecht,Fortuna '54,0,2,2,0,3,2,-2,4.0,4.0
2302,1967-1968,22,DWS Amsterdam,NEC Nijmegen,1,3,2,0,3,4,-2,3.0,5.0
2303,1967-1968,22,FC Twente,PSV,1,0,1,3,0,1,1,9.0,4.0
2304,1967-1968,22,Feijenoord,NAC Breda,4,0,1,3,0,4,4,7.0,1.0
2305,1967-1968,22,GVAV Groningen,Go Ahead Eagles,1,0,1,3,0,1,1,13.0,7.0
2306,1967-1968,22,MVV Maastricht,Xerxes/D.H.C.,0,0,3,1,1,0,0,6.0,11.0
2307,1967-1968,22,Sittardia,Sparta Rotterdam,0,3,2,0,3,3,-3,2.0,11.0
2308,1967-1968,22,Telstar,ADO Den Haag,0,0,3,1,1,0,0,8.0,8.0
2309,1967-1968,22,FC Volendam,AFC Ajax,1,4,2,0,3,5,-3,5.0,13.0
2310,1967-1968,23,ADO Den Haag,DOS Utrecht,5,1,1,3,0,6,4,8.0,3.0
2311,1967-1968,23,AFC Ajax,DWS Amsterdam,3,2,1,3,0,5,1,13.0,0.0
2312,1967-1968,23,Fortuna '54,Feijenoord,0,1,2,0,3,1,-1,4.0,10.0
2313,1967-1968,23,Go Ahead Eagles,Telstar,3,1,1,3,0,4,2,10.0,5.0
2314,1967-1968,23,NAC Breda,FC Volendam,0,2,2,0,3,2,-2,1.0,5.0
2315,1967-1968,23,NEC Nijmegen,Sittardia,2,2,3,1,1,4,0,6.0,2.0
2316,1967-1968,23,PSV,GVAV Groningen,0,0,3,1,1,0,0,5.0,11.0
2317,1967-1968,23,Sparta Rotterdam,MVV Maastricht,2,0,1,3,0,2,2,13.0,5.0
2318,1967-1968,23,Xerxes/D.H.C.,FC Twente,2,0,1,3,0,2,2,11.0,9.0
2319,1967-1968,24,DOS Utrecht,Go Ahead Eagles,0,1,2,0,3,1,-1,2.0,10.0
2320,1967-1968,24,DWS Amsterdam,NAC Breda,2,1,1,3,0,3,1,3.0,1.0
2321,1967-1968,24,FC Twente,Sparta Rotterdam,2,0,1,3,0,2,2,9.0,12.0
2322,1967-1968,24,Feijenoord,ADO Den Haag,1,0,1,3,0,1,1,12.0,5.0
2323,1967-1968,24,GVAV Groningen,Telstar,1,0,1,3,0,1,1,13.0,5.0
2324,1967-1968,24,MVV Maastricht,NEC Nijmegen,1,0,1,3,0,1,1,7.0,5.0
2325,1967-1968,24,PSV,Xerxes/D.H.C.,1,1,3,1,1,2,0,3.0,11.0
2326,1967-1968,24,Sittardia,AFC Ajax,1,1,3,1,1,2,0,3.0,11.0
2327,1967-1968,24,FC Volendam,Fortuna '54,1,1,3,1,1,2,0,5.0,5.0
2328,1967-1968,25,ADO Den Haag,FC Volendam,2,0,1,3,0,2,2,8.0,5.0
2329,1967-1968,25,AFC Ajax,MVV Maastricht,4,0,1,3,0,4,4,13.0,7.0
2330,1967-1968,25,Fortuna '54,DWS Amsterdam,1,1,3,1,1,2,0,6.0,4.0
2331,1967-1968,25,Go Ahead Eagles,Feijenoord,1,1,3,1,1,2,0,8.0,10.0
2332,1967-1968,25,NAC Breda,Sittardia,1,0,1,3,0,1,1,4.0,2.0
2333,1967-1968,25,NEC Nijmegen,FC Twente,1,1,3,1,1,2,0,6.0,7.0
2334,1967-1968,25,Sparta Rotterdam,PSV,3,0,1,3,0,3,3,12.0,2.0
2335,1967-1968,25,Telstar,DOS Utrecht,1,0,1,3,0,1,1,5.0,1.0
2336,1967-1968,25,Xerxes/D.H.C.,GVAV Groningen,1,0,1,3,0,1,1,11.0,10.0
2337,1967-1968,26,DWS Amsterdam,ADO Den Haag,1,0,1,3,0,1,1,7.0,7.0
2338,1967-1968,26,FC Twente,AFC Ajax,1,1,3,1,1,2,0,8.0,11.0
2339,1967-1968,26,Feijenoord,Telstar,2,0,1,3,0,2,2,13.0,4.0
2340,1967-1968,26,GVAV Groningen,DOS Utrecht,1,1,3,1,1,2,0,8.0,1.0
2341,1967-1968,26,MVV Maastricht,NAC Breda,2,0,1,3,0,2,2,7.0,3.0
2342,1967-1968,26,PSV,NEC Nijmegen,1,0,1,3,0,1,1,5.0,5.0
2343,1967-1968,26,Sittardia,Fortuna '54,3,0,1,3,0,3,3,5.0,5.0
2344,1967-1968,26,FC Volendam,Go Ahead Eagles,1,0,1,3,0,1,1,7.0,7.0
2345,1967-1968,26,Xerxes/D.H.C.,Sparta Rotterdam,1,1,3,1,1,2,0,9.0,10.0
2346,1967-1968,27,ADO Den Haag,Sittardia,4,0,1,3,0,4,4,9.0,5.0
2347,1967-1968,27,AFC Ajax,PSV,4,0,1,3,0,4,4,11.0,5.0
2348,1967-1968,27,DOS Utrecht,Feijenoord,2,0,1,3,0,2,2,4.0,10.0
2349,1967-1968,27,Fortuna '54,MVV Maastricht,2,2,3,1,1,4,0,3.0,7.0
2350,1967-1968,27,Go Ahead Eagles,DWS Amsterdam,2,1,1,3,0,3,1,10.0,7.0
2351,1967-1968,27,NAC Breda,FC Twente,1,0,1,3,0,1,1,6.0,5.0
2352,1967-1968,27,NEC Nijmegen,Xerxes/D.H.C.,0,0,3,1,1,0,0,3.0,9.0
2353,1967-1968,27,Sparta Rotterdam,GVAV Groningen,4,0,1,3,0,4,4,10.0,5.0
2354,1967-1968,27,Telstar,FC Volendam,2,1,1,3,0,3,1,6.0,7.0
2355,1967-1968,28,DWS Amsterdam,Telstar,3,1,1,3,0,4,2,10.0,6.0
2356,1967-1968,28,FC Twente,Fortuna '54,8,2,1,3,0,10,6,8.0,3.0
2357,1967-1968,28,GVAV Groningen,Feijenoord,0,0,3,1,1,0,0,5.0,8.0
2358,1967-1968,28,MVV Maastricht,ADO Den Haag,1,2,2,0,3,3,-1,7.0,9.0
2359,1967-1968,28,PSV,NAC Breda,6,0,1,3,0,6,6,7.0,6.0
2360,1967-1968,28,Sittardia,Go Ahead Eagles,0,1,2,0,3,1,-1,4.0,10.0
2361,1967-1968,28,Sparta Rotterdam,NEC Nijmegen,1,0,1,3,0,1,1,10.0,2.0
2362,1967-1968,28,FC Volendam,DOS Utrecht,1,0,1,3,0,1,1,7.0,4.0
2363,1967-1968,28,Xerxes/D.H.C.,AFC Ajax,0,1,2,0,3,1,-1,6.0,11.0
2364,1967-1968,29,ADO Den Haag,FC Twente,2,2,3,1,1,4,0,10.0,6.0
2365,1967-1968,29,AFC Ajax,Sparta Rotterdam,3,0,1,3,0,3,3,13.0,10.0
2366,1967-1968,29,DOS Utrecht,DWS Amsterdam,1,2,2,0,3,3,-1,4.0,10.0
2367,1967-1968,29,Feijenoord,FC Volendam,4,1,1,3,0,5,3,8.0,6.0
2368,1967-1968,29,Fortuna '54,PSV,0,3,2,0,3,3,-3,2.0,9.0
2369,1967-1968,29,Go Ahead Eagles,MVV Maastricht,2,0,1,3,0,2,2,10.0,4.0
2370,1967-1968,29,NAC Breda,Xerxes/D.H.C.,4,2,1,3,0,6,2,9.0,5.0
2371,1967-1968,29,NEC Nijmegen,GVAV Groningen,0,1,2,0,3,1,-1,2.0,5.0
2372,1967-1968,29,Telstar,Sittardia,1,1,3,1,1,2,0,7.0,4.0
2373,1967-1968,30,DWS Amsterdam,Feijenoord,1,2,2,0,3,3,-1,9.0,10.0
2374,1967-1968,30,FC Twente,Go Ahead Eagles,5,2,1,3,0,7,3,8.0,9.0
2375,1967-1968,30,GVAV Groningen,FC Volendam,3,0,1,3,0,3,3,8.0,6.0
2376,1967-1968,30,MVV Maastricht,Telstar,3,2,1,3,0,5,1,7.0,4.0
2377,1967-1968,30,NEC Nijmegen,AFC Ajax,0,2,2,0,3,2,-2,1.0,13.0
2378,1967-1968,30,PSV,ADO Den Haag,1,1,3,1,1,2,0,10.0,8.0
2379,1967-1968,30,Sittardia,DOS Utrecht,4,2,1,3,0,6,2,7.0,4.0
2380,1967-1968,30,Sparta Rotterdam,NAC Breda,2,1,1,3,0,3,1,10.0,6.0
2381,1967-1968,30,Xerxes/D.H.C.,Fortuna '54,5,0,1,3,0,5,5,5.0,1.0
2382,1967-1968,31,ADO Den Haag,Xerxes/D.H.C.,0,2,2,0,3,2,-2,8.0,7.0
2383,1967-1968,31,AFC Ajax,GVAV Groningen,3,1,1,3,0,4,2,15.0,7.0
2384,1967-1968,31,DOS Utrecht,MVV Maastricht,1,0,1,3,0,1,1,6.0,4.0
2385,1967-1968,31,Feijenoord,Sittardia,5,1,1,3,0,6,4,10.0,4.0
2386,1967-1968,31,Fortuna '54,Sparta Rotterdam,1,0,1,3,0,1,1,4.0,9.0
2387,1967-1968,31,Go Ahead Eagles,PSV,5,1,1,3,0,6,4,12.0,7.0
2388,1967-1968,31,NAC Breda,NEC Nijmegen,0,0,3,1,1,0,0,7.0,2.0
2389,1967-1968,31,Telstar,FC Twente,4,1,1,3,0,5,3,7.0,7.0
2390,1967-1968,31,FC Volendam,DWS Amsterdam,1,1,3,1,1,2,0,4.0,7.0
2391,1967-1968,32,AFC Ajax,NAC Breda,3,0,1,3,0,3,3,15.0,4.0
2392,1967-1968,32,FC Twente,DOS Utrecht,2,2,3,1,1,4,0,8.0,4.0
2393,1967-1968,32,GVAV Groningen,DWS Amsterdam,1,1,3,1,1,2,0,8.0,8.0
2394,1967-1968,32,MVV Maastricht,Feijenoord,0,2,2,0,3,2,-2,3.0,13.0
2395,1967-1968,32,NEC Nijmegen,Fortuna '54,0,0,3,1,1,0,0,2.0,4.0
2396,1967-1968,32,PSV,Telstar,0,1,2,0,3,1,-1,7.0,7.0
2397,1967-1968,32,Sittardia,FC Volendam,2,1,1,3,0,3,1,7.0,4.0
2398,1967-1968,32,Sparta Rotterdam,ADO Den Haag,1,4,2,0,3,5,-3,6.0,8.0
2399,1967-1968,32,Xerxes/D.H.C.,Go Ahead Eagles,4,2,1,3,0,6,2,9.0,9.0
2400,1967-1968,33,ADO Den Haag,NEC Nijmegen,0,1,2,0,3,1,-1,5.0,5.0
2401,1967-1968,33,DOS Utrecht,PSV,0,3,2,0,3,3,-3,4.0,7.0
2402,1967-1968,33,Feijenoord,FC Twente,6,0,1,3,0,6,6,15.0,5.0
2403,1967-1968,33,Fortuna '54,AFC Ajax,1,4,2,0,3,5,-3,4.0,15.0
2404,1967-1968,33,Go Ahead Eagles,Sparta Rotterdam,0,0,3,1,1,0,0,7.0,4.0
2405,1967-1968,33,GVAV Groningen,NAC Breda,0,1,2,0,3,1,-1,7.0,7.0
2406,1967-1968,33,Telstar,Xerxes/D.H.C.,2,2,3,1,1,4,0,8.0,10.0
2407,1967-1968,33,FC Volendam,MVV Maastricht,4,1,1,3,0,5,3,4.0,3.0
2408,1967-1968,33,DWS Amsterdam,Sittardia,3,0,1,3,0,3,3,8.0,7.0
2409,1967-1968,34,AFC Ajax,ADO Den Haag,2,1,1,3,0,3,1,15.0,4.0
2410,1967-1968,34,FC Twente,FC Volendam,2,1,1,3,0,3,1,7.0,4.0
2411,1967-1968,34,MVV Maastricht,DWS Amsterdam,2,0,1,3,0,2,2,6.0,5.0
2412,1967-1968,34,NAC Breda,Fortuna '54,0,0,3,1,1,0,0,5.0,5.0
2413,1967-1968,34,NEC Nijmegen,Go Ahead Eagles,3,3,3,1,1,6,0,6.0,5.0
2414,1967-1968,34,PSV,Feijenoord,1,0,1,3,0,1,1,7.0,12.0
2415,1967-1968,34,Sittardia,GVAV Groningen,3,1,1,3,0,4,2,9.0,4.0
2416,1967-1968,34,Sparta Rotterdam,Telstar,1,1,3,1,1,2,0,5.0,8.0
2417,1967-1968,34,Xerxes/D.H.C.,DOS Utrecht,2,1,1,3,0,3,1,13.0,4.0
2418,1968-1969,1,ADO Den Haag,FC Volendam,4,0,1,3,0,4,4,6.0,4.0
2419,1968-1969,1,AZ '67 Alkmaar,Holland Sport,2,0,1,3,0,2,2,,
2420,1968-1969,1,DWS Amsterdam,FC Twente,1,3,2,0,3,4,-2,5.0,7.0
2421,1968-1969,1,Go Ahead Eagles,AFC Ajax,2,1,1,3,0,3,1,8.0,12.0
2422,1968-1969,1,GVAV Groningen,DOS Utrecht,3,0,1,3,0,3,3,4.0,4.0
2423,1968-1969,1,MVV Maastricht,Feijenoord,2,3,2,0,3,5,-1,3.0,12.0
2424,1968-1969,1,NAC Breda,FSC Geleen,5,1,1,3,0,6,4,8.0,
2425,1968-1969,1,PSV,Telstar,2,0,1,3,0,2,2,9.0,8.0
2426,1968-1969,1,Sparta Rotterdam,NEC Nijmegen,0,3,2,0,3,3,-3,2.0,9.0
2427,1968-1969,2,AFC Ajax,NAC Breda,8,1,1,3,0,9,7,12.0,7.0
2428,1968-1969,2,DOS Utrecht,Go Ahead Eagles,0,4,2,0,3,4,-4,1.0,8.0
2429,1968-1969,2,FC Twente,PSV,2,1,1,3,0,3,1,10.0,9.0
2430,1968-1969,2,Feijenoord,DWS Amsterdam,3,0,1,3,0,3,3,12.0,4.0
2431,1968-1969,2,FSC Geleen,Sparta Rotterdam,0,2,2,0,3,2,-2,,5.0
2432,1968-1969,2,Holland Sport,ADO Den Haag,1,3,2,0,3,4,-2,,9.0
2433,1968-1969,2,NEC Nijmegen,MVV Maastricht,1,0,1,3,0,1,1,11.0,3.0
2434,1968-1969,2,Telstar,AZ '67 Alkmaar,1,1,3,1,1,2,0,6.0,
2435,1968-1969,2,FC Volendam,GVAV Groningen,2,0,1,3,0,2,2,6.0,4.0
2436,1968-1969,3,ADO Den Haag,Telstar,2,2,3,1,1,4,0,7.0,4.0
2437,1968-1969,3,AZ '67 Alkmaar,FC Twente,1,2,2,0,3,3,-1,,12.0
2438,1968-1969,3,DWS Amsterdam,MVV Maastricht,2,0,1,3,0,2,2,6.0,3.0
2439,1968-1969,3,FSC Geleen,NEC Nijmegen,1,1,3,1,1,2,0,,11.0
2440,1968-1969,3,Go Ahead Eagles,FC Volendam,1,0,1,3,0,1,1,11.0,6.0
2441,1968-1969,3,GVAV Groningen,Holland Sport,1,0,1,3,0,1,1,6.0,
2442,1968-1969,3,NAC Breda,DOS Utrecht,1,0,1,3,0,1,1,10.0,0.0
2443,1968-1969,3,PSV,Feijenoord,0,3,2,0,3,3,-3,9.0,12.0
2444,1968-1969,3,Sparta Rotterdam,AFC Ajax,0,1,2,0,3,1,-1,5.0,12.0
2445,1968-1969,4,AFC Ajax,FSC Geleen,2,0,1,3,0,2,2,12.0,
2446,1968-1969,4,DOS Utrecht,Sparta Rotterdam,0,3,2,0,3,3,-3,0.0,7.0
2447,1968-1969,4,FC Twente,ADO Den Haag,2,0,1,3,0,2,2,15.0,7.0
2448,1968-1969,4,Feijenoord,AZ '67 Alkmaar,2,0,1,3,0,2,2,12.0,
2449,1968-1969,4,Holland Sport,Go Ahead Eagles,1,0,1,3,0,1,1,,10.0
2450,1968-1969,4,MVV Maastricht,PSV,2,4,2,0,3,6,-2,3.0,9.0
2451,1968-1969,4,NEC Nijmegen,DWS Amsterdam,2,1,1,3,0,3,1,11.0,3.0
2452,1968-1969,4,Telstar,GVAV Groningen,1,1,3,1,1,2,0,4.0,7.0
2453,1968-1969,4,FC Volendam,NAC Breda,0,0,3,1,1,0,0,4.0,8.0
2454,1968-1969,5,ADO Den Haag,Feijenoord,2,3,2,0,3,5,-1,7.0,15.0
2455,1968-1969,5,AFC Ajax,NEC Nijmegen,2,1,1,3,0,3,1,12.0,10.0
2456,1968-1969,5,AZ '67 Alkmaar,MVV Maastricht,4,1,1,3,0,5,3,7.0,0.0
2457,1968-1969,5,FSC Geleen,DOS Utrecht,1,3,2,0,3,4,-2,1.0,3.0
2458,1968-1969,5,Go Ahead Eagles,Telstar,3,0,1,3,0,3,3,12.0,3.0
2459,1968-1969,5,GVAV Groningen,FC Twente,2,4,2,0,3,6,-2,7.0,15.0
2460,1968-1969,5,NAC Breda,Holland Sport,2,0,1,3,0,2,2,10.0,3.0
2461,1968-1969,5,PSV,DWS Amsterdam,2,1,1,3,0,3,1,9.0,3.0
2462,1968-1969,5,Sparta Rotterdam,FC Volendam,1,1,3,1,1,2,0,7.0,5.0
2463,1968-1969,6,DOS Utrecht,AFC Ajax,1,1,3,1,1,2,0,4.0,13.0
2464,1968-1969,6,DWS Amsterdam,AZ '67 Alkmaar,2,0,1,3,0,2,2,6.0,4.0
2465,1968-1969,6,FC Twente,Go Ahead Eagles,4,1,1,3,0,5,3,15.0,9.0
2466,1968-1969,6,Feijenoord,GVAV Groningen,3,0,1,3,0,3,3,15.0,4.0
2467,1968-1969,6,Holland Sport,Sparta Rotterdam,1,1,3,1,1,2,0,4.0,8.0
2468,1968-1969,6,MVV Maastricht,ADO Den Haag,1,2,2,0,3,3,-1,0.0,7.0
2469,1968-1969,6,NEC Nijmegen,PSV,1,1,3,1,1,2,0,8.0,7.0
2470,1968-1969,6,Telstar,NAC Breda,1,1,3,1,1,2,0,4.0,8.0
2471,1968-1969,6,FC Volendam,FSC Geleen,3,1,1,3,0,4,2,8.0,1.0
2472,1968-1969,7,ADO Den Haag,DWS Amsterdam,2,0,1,3,0,2,2,7.0,6.0
2473,1968-1969,7,AFC Ajax,FC Volendam,2,0,1,3,0,2,2,13.0,5.0
2474,1968-1969,7,AZ '67 Alkmaar,PSV,2,0,1,3,0,2,2,6.0,7.0
2475,1968-1969,7,DOS Utrecht,NEC Nijmegen,0,0,3,1,1,0,0,5.0,6.0
2476,1968-1969,7,FSC Geleen,Holland Sport,0,0,3,1,1,0,0,2.0,5.0
2477,1968-1969,7,Go Ahead Eagles,Feijenoord,3,1,1,3,0,4,2,9.0,12.0
2478,1968-1969,7,GVAV Groningen,MVV Maastricht,3,0,1,3,0,3,3,7.0,0.0
2479,1968-1969,7,NAC Breda,FC Twente,0,0,3,1,1,0,0,9.0,13.0
2480,1968-1969,7,Sparta Rotterdam,Telstar,2,0,1,3,0,2,2,8.0,3.0
2481,1968-1969,8,DWS Amsterdam,GVAV Groningen,2,0,1,3,0,2,2,6.0,4.0
2482,1968-1969,8,FC Twente,Sparta Rotterdam,2,1,1,3,0,3,1,13.0,8.0
2483,1968-1969,8,Feijenoord,NAC Breda,2,1,1,3,0,3,1,12.0,6.0
2484,1968-1969,8,Holland Sport,AFC Ajax,0,3,2,0,3,3,-3,5.0,13.0
2485,1968-1969,8,MVV Maastricht,Go Ahead Eagles,0,2,2,0,3,2,-2,0.0,9.0
2486,1968-1969,8,NEC Nijmegen,AZ '67 Alkmaar,1,1,3,1,1,2,0,6.0,7.0
2487,1968-1969,8,PSV,ADO Den Haag,2,0,1,3,0,2,2,10.0,6.0
2488,1968-1969,8,Telstar,FSC Geleen,3,1,1,3,0,4,2,5.0,1.0
2489,1968-1969,8,FC Volendam,DOS Utrecht,3,1,1,3,0,4,2,8.0,5.0
2490,1968-1969,9,ADO Den Haag,AZ '67 Alkmaar,2,0,1,3,0,2,2,9.0,7.0
2491,1968-1969,9,AFC Ajax,Telstar,9,2,1,3,0,11,7,13.0,4.0
2492,1968-1969,9,DOS Utrecht,Holland Sport,4,1,1,3,0,5,3,8.0,2.0
2493,1968-1969,9,FSC Geleen,FC Twente,1,4,2,0,3,5,-3,1.0,13.0
2494,1968-1969,9,Go Ahead Eagles,DWS Amsterdam,2,1,1,3,0,3,1,12.0,6.0
2495,1968-1969,9,GVAV Groningen,PSV,3,0,1,3,0,3,3,6.0,7.0
2496,1968-1969,9,NAC Breda,MVV Maastricht,0,0,3,1,1,0,0,6.0,1.0
2497,1968-1969,9,Sparta Rotterdam,Feijenoord,0,1,2,0,3,1,-1,5.0,12.0
2498,1968-1969,9,FC Volendam,NEC Nijmegen,0,0,3,1,1,0,0,8.0,4.0
2499,1968-1969,10,AZ '67 Alkmaar,GVAV Groningen,1,1,3,1,1,2,0,5.0,7.0
2500,1968-1969,10,DWS Amsterdam,NAC Breda,2,0,1,3,0,2,2,9.0,3.0
2501,1968-1969,10,FC Twente,AFC Ajax,5,1,1,3,0,6,4,13.0,10.0
2502,1968-1969,10,Feijenoord,FSC Geleen,5,0,1,3,0,5,5,12.0,1.0
2503,1968-1969,10,Holland Sport,FC Volendam,2,1,1,3,0,3,1,5.0,7.0
2504,1968-1969,10,MVV Maastricht,Sparta Rotterdam,0,0,3,1,1,0,0,2.0,5.0
2505,1968-1969,10,NEC Nijmegen,ADO Den Haag,0,1,2,0,3,1,-1,4.0,12.0
2506,1968-1969,10,PSV,Go Ahead Eagles,0,1,2,0,3,1,-1,4.0,12.0
2507,1968-1969,10,Telstar,DOS Utrecht,2,1,1,3,0,3,1,7.0,5.0
2508,1968-1969,11,AFC Ajax,Feijenoord,0,1,2,0,3,1,-1,9.0,12.0
2509,1968-1969,11,DOS Utrecht,FC Twente,0,5,2,0,3,5,-5,4.0,13.0
2510,1968-1969,11,FSC Geleen,MVV Maastricht,0,0,3,1,1,0,0,2.0,3.0
2511,1968-1969,11,Go Ahead Eagles,AZ '67 Alkmaar,5,0,1,3,0,5,5,15.0,5.0
2512,1968-1969,11,GVAV Groningen,ADO Den Haag,1,0,1,3,0,1,1,10.0,9.0
2513,1968-1969,11,Holland Sport,NEC Nijmegen,1,0,1,3,0,1,1,7.0,3.0
2514,1968-1969,11,NAC Breda,PSV,2,2,3,1,1,4,0,3.0,4.0
2515,1968-1969,11,Sparta Rotterdam,DWS Amsterdam,3,0,1,3,0,3,3,7.0,6.0
2516,1968-1969,11,FC Volendam,Telstar,1,2,2,0,3,3,-1,4.0,9.0
2517,1968-1969,12,ADO Den Haag,Go Ahead Eagles,1,1,3,1,1,2,0,7.0,13.0
2518,1968-1969,12,AZ '67 Alkmaar,NAC Breda,2,0,1,3,0,2,2,5.0,2.0
2519,1968-1969,12,DWS Amsterdam,FSC Geleen,1,0,1,3,0,1,1,9.0,1.0
2520,1968-1969,12,FC Twente,FC Volendam,1,0,1,3,0,1,1,15.0,4.0
2521,1968-1969,12,Feijenoord,DOS Utrecht,2,0,1,3,0,2,2,15.0,3.0
2522,1968-1969,12,MVV Maastricht,AFC Ajax,2,2,3,1,1,4,0,4.0,7.0
2523,1968-1969,12,NEC Nijmegen,GVAV Groningen,2,0,1,3,0,2,2,5.0,7.0
2524,1968-1969,12,PSV,Sparta Rotterdam,1,1,3,1,1,2,0,5.0,5.0
2525,1968-1969,12,Telstar,Holland Sport,1,3,2,0,3,4,-2,9.0,9.0
2526,1968-1969,13,DOS Utrecht,MVV Maastricht,2,2,3,1,1,4,0,4.0,5.0
2527,1968-1969,13,FSC Geleen,PSV,1,3,2,0,3,4,-2,1.0,5.0
2528,1968-1969,13,Go Ahead Eagles,GVAV Groningen,3,0,1,3,0,3,3,13.0,7.0
2529,1968-1969,13,Holland Sport,FC Twente,0,0,3,1,1,0,0,10.0,13.0
2530,1968-1969,13,NAC Breda,ADO Den Haag,0,1,2,0,3,1,-1,2.0,10.0
2531,1968-1969,13,Sparta Rotterdam,AZ '67 Alkmaar,3,1,1,3,0,4,2,8.0,4.0
2532,1968-1969,13,Telstar,NEC Nijmegen,1,0,1,3,0,1,1,9.0,4.0
2533,1968-1969,13,FC Volendam,Feijenoord,2,5,2,0,3,7,-3,1.0,15.0
2534,1968-1969,13,DWS Amsterdam,AFC Ajax,2,1,1,3,0,3,1,9.0,4.0
2535,1968-1969,14,ADO Den Haag,Sparta Rotterdam,0,0,3,1,1,0,0,8.0,9.0
2536,1968-1969,14,AZ '67 Alkmaar,FSC Geleen,1,1,3,1,1,2,0,5.0,2.0
2537,1968-1969,14,DWS Amsterdam,DOS Utrecht,1,0,1,3,0,1,1,12.0,1.0
2538,1968-1969,14,FC Twente,Telstar,2,1,1,3,0,3,1,13.0,9.0
2539,1968-1969,14,Feijenoord,Holland Sport,6,0,1,3,0,6,6,15.0,10.0
2540,1968-1969,14,GVAV Groningen,NAC Breda,4,2,1,3,0,6,2,7.0,1.0
2541,1968-1969,14,MVV Maastricht,FC Volendam,1,0,1,3,0,1,1,7.0,0.0
2542,1968-1969,14,NEC Nijmegen,Go Ahead Eagles,1,0,1,3,0,1,1,6.0,10.0
2543,1968-1969,14,PSV,AFC Ajax,0,1,2,0,3,1,-1,5.0,4.0
2544,1968-1969,15,AFC Ajax,AZ '67 Alkmaar,4,0,1,3,0,4,4,7.0,4.0
2545,1968-1969,15,DOS Utrecht,PSV,1,1,3,1,1,2,0,2.0,6.0
2546,1968-1969,15,FC Twente,NEC Nijmegen,4,2,1,3,0,6,2,13.0,6.0
2547,1968-1969,15,FSC Geleen,ADO Den Haag,0,0,3,1,1,0,0,3.0,6.0
2548,1968-1969,15,Holland Sport,MVV Maastricht,0,0,3,1,1,0,0,8.0,7.0
2549,1968-1969,15,NAC Breda,Go Ahead Eagles,1,1,3,1,1,2,0,2.0,8.0
2550,1968-1969,15,Sparta Rotterdam,GVAV Groningen,0,0,3,1,1,0,0,9.0,7.0
2551,1968-1969,15,Telstar,Feijenoord,0,0,3,1,1,0,0,7.0,13.0
2552,1968-1969,15,FC Volendam,DWS Amsterdam,0,1,2,0,3,1,-1,0.0,12.0
2553,1968-1969,16,AZ '67 Alkmaar,DOS Utrecht,2,3,2,0,3,5,-1,4.0,5.0
2554,1968-1969,16,DWS Amsterdam,Holland Sport,2,1,1,3,0,3,1,15.0,5.0
2555,1968-1969,16,Feijenoord,FC Twente,3,0,1,3,0,3,3,13.0,10.0
2556,1968-1969,16,MVV Maastricht,Telstar,3,0,1,3,0,3,3,9.0,4.0
2557,1968-1969,16,NAC Breda,NEC Nijmegen,2,0,1,3,0,2,2,4.0,6.0
2558,1968-1969,16,PSV,FC Volendam,4,2,1,3,0,6,2,8.0,0.0
2559,1968-1969,16,ADO Den Haag,AFC Ajax,2,5,2,0,3,7,-3,6.0,10.0
2560,1968-1969,16,Go Ahead Eagles,Sparta Rotterdam,2,1,1,3,0,3,1,8.0,6.0
2561,1968-1969,16,GVAV Groningen,FSC Geleen,0,0,3,1,1,0,0,5.0,3.0
2562,1968-1969,17,FC Twente,MVV Maastricht,3,0,1,3,0,3,3,10.0,8.0
2563,1968-1969,17,FSC Geleen,Go Ahead Eagles,1,1,3,1,1,2,0,4.0,8.0
2564,1968-1969,17,Holland Sport,PSV,0,0,3,1,1,0,0,3.0,8.0
2565,1968-1969,17,NEC Nijmegen,Feijenoord,0,1,2,0,3,1,-1,3.0,13.0
2566,1968-1969,17,FC Volendam,AZ '67 Alkmaar,2,1,1,3,0,3,1,3.0,1.0
2567,1968-1969,17,DOS Utrecht,ADO Den Haag,1,1,3,1,1,2,0,6.0,6.0
2568,1968-1969,17,AFC Ajax,GVAV Groningen,6,0,1,3,0,6,6,12.0,5.0
2569,1968-1969,17,Sparta Rotterdam,NAC Breda,3,3,3,1,1,6,0,6.0,5.0
2570,1968-1969,17,Telstar,DWS Amsterdam,0,2,2,0,3,2,-2,4.0,15.0
2571,1968-1969,18,AFC Ajax,Go Ahead Eagles,4,3,1,3,0,7,1,15.0,5.0
2572,1968-1969,18,DOS Utrecht,GVAV Groningen,1,0,1,3,0,1,1,8.0,5.0
2573,1968-1969,18,FC Twente,DWS Amsterdam,4,1,1,3,0,5,3,12.0,12.0
2574,1968-1969,18,Feijenoord,MVV Maastricht,4,1,1,3,0,5,3,13.0,7.0
2575,1968-1969,18,FSC Geleen,NAC Breda,0,0,3,1,1,0,0,5.0,6.0
2576,1968-1969,18,Holland Sport,AZ '67 Alkmaar,3,0,1,3,0,3,3,5.0,1.0
2577,1968-1969,18,NEC Nijmegen,Sparta Rotterdam,0,1,2,0,3,1,-1,3.0,6.0
2578,1968-1969,18,Telstar,PSV,0,3,2,0,3,3,-3,1.0,8.0
2579,1968-1969,18,FC Volendam,ADO Den Haag,0,0,3,1,1,0,0,4.0,4.0
2580,1968-1969,19,ADO Den Haag,Holland Sport,2,1,1,3,0,3,1,6.0,5.0
2581,1968-1969,19,AZ '67 Alkmaar,Telstar,0,0,3,1,1,0,0,1.0,2.0
2582,1968-1969,19,DWS Amsterdam,Feijenoord,0,1,2,0,3,1,-1,9.0,13.0
2583,1968-1969,19,Go Ahead Eagles,DOS Utrecht,7,0,1,3,0,7,7,8.0,8.0
2584,1968-1969,19,GVAV Groningen,FC Volendam,0,0,3,1,1,0,0,3.0,5.0
2585,1968-1969,19,MVV Maastricht,NEC Nijmegen,0,0,3,1,1,0,0,5.0,1.0
2586,1968-1969,19,NAC Breda,AFC Ajax,0,2,2,0,3,2,-2,6.0,15.0
2587,1968-1969,19,PSV,FC Twente,1,1,3,1,1,2,0,9.0,10.0
2588,1968-1969,19,Sparta Rotterdam,FSC Geleen,5,0,1,3,0,5,5,8.0,4.0
2589,1968-1969,20,AFC Ajax,Sparta Rotterdam,2,1,1,3,0,3,1,15.0,7.0
2590,1968-1969,20,DOS Utrecht,NAC Breda,3,3,3,1,1,6,0,8.0,6.0
2591,1968-1969,20,FC Twente,AZ '67 Alkmaar,1,0,1,3,0,1,1,10.0,1.0
2592,1968-1969,20,Feijenoord,PSV,2,0,1,3,0,2,2,15.0,8.0
2593,1968-1969,20,Holland Sport,GVAV Groningen,4,1,1,3,0,5,3,7.0,2.0
2594,1968-1969,20,MVV Maastricht,DWS Amsterdam,1,1,3,1,1,2,0,5.0,7.0
2595,1968-1969,20,NEC Nijmegen,FSC Geleen,4,0,1,3,0,4,4,4.0,3.0
2596,1968-1969,20,Telstar,ADO Den Haag,1,1,3,1,1,2,0,2.0,6.0
2597,1968-1969,20,FC Volendam,Go Ahead Eagles,0,3,2,0,3,3,-3,5.0,10.0
2598,1968-1969,21,ADO Den Haag,FC Twente,1,3,2,0,3,4,-2,6.0,13.0
2599,1968-1969,21,AZ '67 Alkmaar,Feijenoord,1,1,3,1,1,2,0,2.0,13.0
2600,1968-1969,21,DWS Amsterdam,NEC Nijmegen,4,0,1,3,0,4,4,7.0,4.0
2601,1968-1969,21,FSC Geleen,AFC Ajax,0,1,2,0,3,1,-1,2.0,15.0
2602,1968-1969,21,Go Ahead Eagles,Holland Sport,0,0,3,1,1,0,0,8.0,8.0
2603,1968-1969,21,GVAV Groningen,Telstar,1,0,1,3,0,1,1,4.0,2.0
2604,1968-1969,21,NAC Breda,FC Volendam,3,0,1,3,0,3,3,6.0,5.0
2605,1968-1969,21,PSV,MVV Maastricht,2,1,1,3,0,3,1,8.0,2.0
2606,1968-1969,21,Sparta Rotterdam,DOS Utrecht,2,1,1,3,0,3,1,10.0,5.0
2607,1968-1969,22,DOS Utrecht,FSC Geleen,1,2,2,0,3,3,-1,4.0,4.0
2608,1968-1969,22,DWS Amsterdam,PSV,1,2,2,0,3,3,-1,4.0,10.0
2609,1968-1969,22,FC Twente,GVAV Groningen,4,0,1,3,0,4,4,13.0,4.0
2610,1968-1969,22,Feijenoord,ADO Den Haag,1,1,3,1,1,2,0,11.0,6.0
2611,1968-1969,22,Holland Sport,NAC Breda,0,0,3,1,1,0,0,8.0,6.0
2612,1968-1969,22,MVV Maastricht,AZ '67 Alkmaar,1,0,1,3,0,1,1,5.0,2.0
2613,1968-1969,22,NEC Nijmegen,AFC Ajax,1,2,2,0,3,3,-1,4.0,15.0
2614,1968-1969,22,Telstar,Go Ahead Eagles,1,0,1,3,0,1,1,5.0,7.0
2615,1968-1969,22,FC Volendam,Sparta Rotterdam,1,0,1,3,0,1,1,5.0,9.0
2616,1968-1969,23,AFC Ajax,Holland Sport,2,2,3,1,1,4,0,13.0,6.0
2617,1968-1969,23,ADO Den Haag,PSV,0,0,3,1,1,0,0,6.0,8.0
2618,1968-1969,23,AZ '67 Alkmaar,NEC Nijmegen,3,0,1,3,0,3,3,5.0,4.0
2619,1968-1969,23,DOS Utrecht,FC Volendam,0,0,3,1,1,0,0,2.0,5.0
2620,1968-1969,23,FSC Geleen,Telstar,3,0,1,3,0,3,3,6.0,5.0
2621,1968-1969,23,Go Ahead Eagles,MVV Maastricht,2,1,1,3,0,3,1,10.0,5.0
2622,1968-1969,23,GVAV Groningen,DWS Amsterdam,2,2,3,1,1,4,0,5.0,5.0
2623,1968-1969,23,NAC Breda,Feijenoord,3,1,1,3,0,4,2,8.0,8.0
2624,1968-1969,23,Sparta Rotterdam,FC Twente,0,0,3,1,1,0,0,7.0,11.0
2625,1968-1969,24,AFC Ajax,DOS Utrecht,7,0,1,3,0,7,7,13.0,2.0
2626,1968-1969,24,ADO Den Haag,MVV Maastricht,1,0,1,3,0,1,1,6.0,4.0
2627,1968-1969,24,AZ '67 Alkmaar,DWS Amsterdam,0,0,3,1,1,0,0,5.0,6.0
2628,1968-1969,24,FSC Geleen,FC Volendam,1,1,3,1,1,2,0,7.0,5.0
2629,1968-1969,24,Go Ahead Eagles,FC Twente,4,0,1,3,0,4,4,10.0,10.0
2630,1968-1969,24,GVAV Groningen,Feijenoord,1,2,2,0,3,3,-1,4.0,8.0
2631,1968-1969,24,NAC Breda,Telstar,4,4,3,1,1,8,0,9.0,5.0
2632,1968-1969,24,PSV,NEC Nijmegen,3,1,1,3,0,4,2,10.0,3.0
2633,1968-1969,24,Sparta Rotterdam,Holland Sport,3,0,1,3,0,3,3,7.0,6.0
2634,1968-1969,25,DWS Amsterdam,ADO Den Haag,0,0,3,1,1,0,0,6.0,6.0
2635,1968-1969,25,FC Twente,NAC Breda,1,1,3,1,1,2,0,8.0,9.0
2636,1968-1969,25,Feijenoord,Go Ahead Eagles,4,0,1,3,0,4,4,8.0,7.0
2637,1968-1969,25,Holland Sport,FSC Geleen,3,0,1,3,0,3,3,6.0,7.0
2638,1968-1969,25,MVV Maastricht,GVAV Groningen,0,0,3,1,1,0,0,4.0,5.0
2639,1968-1969,25,NEC Nijmegen,DOS Utrecht,2,1,1,3,0,3,1,3.0,1.0
2640,1968-1969,25,PSV,AZ '67 Alkmaar,2,1,1,3,0,3,1,13.0,5.0
2641,1968-1969,25,Telstar,Sparta Rotterdam,0,1,2,0,3,1,-1,4.0,10.0
2642,1968-1969,25,FC Volendam,AFC Ajax,0,2,2,0,3,2,-2,5.0,13.0
2643,1968-1969,26,AZ '67 Alkmaar,ADO Den Haag,1,1,3,1,1,2,0,5.0,7.0
2644,1968-1969,26,DWS Amsterdam,Go Ahead Eagles,4,2,1,3,0,6,2,6.0,6.0
2645,1968-1969,26,FC Twente,FSC Geleen,3,0,1,3,0,3,3,8.0,7.0
2646,1968-1969,26,Feijenoord,Sparta Rotterdam,2,1,1,3,0,3,1,10.0,7.0
2647,1968-1969,26,Holland Sport,DOS Utrecht,1,1,3,1,1,2,0,6.0,2.0
2648,1968-1969,26,MVV Maastricht,NAC Breda,1,2,2,0,3,3,-1,4.0,9.0
2649,1968-1969,26,NEC Nijmegen,FC Volendam,0,0,3,1,1,0,0,4.0,6.0
2650,1968-1969,26,PSV,GVAV Groningen,0,0,3,1,1,0,0,11.0,3.0
2651,1968-1969,26,Telstar,AFC Ajax,1,4,2,0,3,5,-3,4.0,13.0
2652,1968-1969,27,FSC Geleen,Feijenoord,0,0,3,1,1,0,0,5.0,10.0
2653,1968-1969,27,ADO Den Haag,NEC Nijmegen,3,0,1,3,0,3,3,9.0,4.0
2654,1968-1969,27,DOS Utrecht,Telstar,2,0,1,3,0,2,2,5.0,1.0
2655,1968-1969,27,Go Ahead Eagles,PSV,1,1,3,1,1,2,0,7.0,9.0
2656,1968-1969,27,GVAV Groningen,AZ '67 Alkmaar,0,0,3,1,1,0,0,4.0,6.0
2657,1968-1969,27,NAC Breda,DWS Amsterdam,1,1,3,1,1,2,0,9.0,7.0
2658,1968-1969,27,Sparta Rotterdam,MVV Maastricht,1,1,3,1,1,2,0,8.0,2.0
2659,1968-1969,27,FC Volendam,Holland Sport,0,1,2,0,3,1,-1,3.0,8.0
2660,1968-1969,27,AFC Ajax,FC Twente,2,0,1,3,0,2,2,13.0,5.0
2661,1968-1969,28,ADO Den Haag,GVAV Groningen,3,2,1,3,0,5,1,11.0,3.0
2662,1968-1969,28,AZ '67 Alkmaar,Go Ahead Eagles,0,0,3,1,1,0,0,4.0,5.0
2663,1968-1969,28,DWS Amsterdam,Sparta Rotterdam,0,0,3,1,1,0,0,7.0,8.0
2664,1968-1969,28,FC Twente,DOS Utrecht,3,2,1,3,0,5,1,7.0,4.0
2665,1968-1969,28,Feijenoord,AFC Ajax,1,1,3,1,1,2,0,11.0,13.0
2666,1968-1969,28,MVV Maastricht,FSC Geleen,1,0,1,3,0,1,1,5.0,2.0
2667,1968-1969,28,NEC Nijmegen,Holland Sport,0,1,2,0,3,1,-1,4.0,10.0
2668,1968-1969,28,PSV,NAC Breda,2,0,1,3,0,2,2,11.0,6.0
2669,1968-1969,28,Telstar,FC Volendam,2,0,1,3,0,2,2,4.0,2.0
2670,1968-1969,29,AFC Ajax,MVV Maastricht,2,1,1,3,0,3,1,13.0,5.0
2671,1968-1969,29,DOS Utrecht,Feijenoord,0,3,2,0,3,3,-3,4.0,11.0
2672,1968-1969,29,FSC Geleen,DWS Amsterdam,0,0,3,1,1,0,0,2.0,7.0
2673,1968-1969,29,Go Ahead Eagles,ADO Den Haag,2,1,1,3,0,3,1,5.0,8.0
2674,1968-1969,29,GVAV Groningen,NEC Nijmegen,0,0,3,1,1,0,0,4.0,5.0
2675,1968-1969,29,Holland Sport,Telstar,2,0,1,3,0,2,2,13.0,3.0
2676,1968-1969,29,NAC Breda,AZ '67 Alkmaar,6,0,1,3,0,6,6,8.0,3.0
2677,1968-1969,29,Sparta Rotterdam,PSV,2,3,2,0,3,5,-1,5.0,11.0
2678,1968-1969,29,FC Volendam,FC Twente,2,1,1,3,0,3,1,4.0,7.0
2679,1968-1969,30,ADO Den Haag,NAC Breda,1,1,3,1,1,2,0,8.0,8.0
2680,1968-1969,30,AFC Ajax,DWS Amsterdam,3,2,1,3,0,5,1,13.0,6.0
2681,1968-1969,30,AZ '67 Alkmaar,Sparta Rotterdam,1,1,3,1,1,2,0,4.0,3.0
2682,1968-1969,30,FC Twente,Holland Sport,2,0,1,3,0,2,2,9.0,10.0
2683,1968-1969,30,Feijenoord,FC Volendam,1,0,1,3,0,1,1,11.0,4.0
2684,1968-1969,30,GVAV Groningen,Go Ahead Eagles,1,1,3,1,1,2,0,4.0,6.0
2685,1968-1969,30,MVV Maastricht,DOS Utrecht,4,0,1,3,0,4,4,7.0,4.0
2686,1968-1969,30,NEC Nijmegen,Telstar,3,1,1,3,0,4,2,5.0,3.0
2687,1968-1969,30,PSV,FSC Geleen,2,0,1,3,0,2,2,11.0,2.0
2688,1968-1969,31,AFC Ajax,PSV,1,2,2,0,3,3,-1,10.0,13.0
2689,1968-1969,31,DOS Utrecht,DWS Amsterdam,3,2,1,3,0,5,1,6.0,3.0
2690,1968-1969,31,FSC Geleen,AZ '67 Alkmaar,3,0,1,3,0,3,3,5.0,3.0
2691,1968-1969,31,Go Ahead Eagles,NEC Nijmegen,1,0,1,3,0,1,1,9.0,4.0
2692,1968-1969,31,Holland Sport,Feijenoord,1,0,1,3,0,1,1,12.0,8.0
2693,1968-1969,31,NAC Breda,GVAV Groningen,2,1,1,3,0,3,1,8.0,3.0
2694,1968-1969,31,Sparta Rotterdam,ADO Den Haag,2,2,3,1,1,4,0,4.0,8.0
2695,1968-1969,31,Telstar,FC Twente,4,2,1,3,0,6,2,6.0,6.0
2696,1968-1969,31,FC Volendam,MVV Maastricht,1,1,3,1,1,2,0,4.0,8.0
2697,1968-1969,32,ADO Den Haag,FSC Geleen,4,0,1,3,0,4,4,8.0,4.0
2698,1968-1969,32,AZ '67 Alkmaar,AFC Ajax,0,3,2,0,3,3,-3,2.0,10.0
2699,1968-1969,32,DWS Amsterdam,FC Volendam,2,1,1,3,0,3,1,5.0,4.0
2700,1968-1969,32,Feijenoord,Telstar,4,1,1,3,0,5,3,10.0,6.0
2701,1968-1969,32,Go Ahead Eagles,NAC Breda,3,1,1,3,0,4,2,11.0,7.0
2702,1968-1969,32,GVAV Groningen,Sparta Rotterdam,3,1,1,3,0,4,2,5.0,3.0
2703,1968-1969,32,MVV Maastricht,Holland Sport,3,0,1,3,0,3,3,10.0,9.0
2704,1968-1969,32,NEC Nijmegen,FC Twente,2,0,1,3,0,2,2,7.0,6.0
2705,1968-1969,32,PSV,DOS Utrecht,3,1,1,3,0,4,2,15.0,3.0
2706,1968-1969,33,AFC Ajax,ADO Den Haag,1,0,1,3,0,1,1,12.0,5.0
2707,1968-1969,33,DOS Utrecht,AZ '67 Alkmaar,1,1,3,1,1,2,0,4.0,2.0
2708,1968-1969,33,FC Twente,Feijenoord,0,1,2,0,3,1,-1,3.0,12.0
2709,1968-1969,33,FSC Geleen,GVAV Groningen,0,0,3,1,1,0,0,5.0,6.0
2710,1968-1969,33,Holland Sport,DWS Amsterdam,2,1,1,3,0,3,1,9.0,4.0
2711,1968-1969,33,NEC Nijmegen,NAC Breda,1,1,3,1,1,2,0,8.0,8.0
2712,1968-1969,33,Sparta Rotterdam,Go Ahead Eagles,3,0,1,3,0,3,3,5.0,10.0
2713,1968-1969,33,Telstar,MVV Maastricht,1,1,3,1,1,2,0,4.0,8.0
2714,1968-1969,33,FC Volendam,PSV,1,1,3,1,1,2,0,5.0,13.0
2715,1968-1969,34,PSV,Holland Sport,4,0,1,3,0,4,4,13.0,6.0
2716,1968-1969,34,ADO Den Haag,DOS Utrecht,1,3,2,0,3,4,-2,5.0,7.0
2717,1968-1969,34,AZ '67 Alkmaar,FC Volendam,0,0,3,1,1,0,0,3.0,3.0
2718,1968-1969,34,DWS Amsterdam,Telstar,0,0,3,1,1,0,0,4.0,5.0
2719,1968-1969,34,Feijenoord,NEC Nijmegen,1,0,1,3,0,1,1,12.0,7.0
2720,1968-1969,34,Go Ahead Eagles,FSC Geleen,2,0,1,3,0,2,2,10.0,4.0
2721,1968-1969,34,GVAV Groningen,AFC Ajax,1,2,2,0,3,3,-1,5.0,12.0
2722,1968-1969,34,MVV Maastricht,FC Twente,2,1,1,3,0,3,1,11.0,3.0
2723,1968-1969,34,NAC Breda,Sparta Rotterdam,1,0,1,3,0,1,1,8.0,5.0
2724,1969-1970,1,ADO Den Haag,FC Twente,4,1,1,3,0,5,3,7.0,0.0
2725,1969-1970,1,DWS Amsterdam,NAC Breda,0,1,2,0,3,1,-1,4.0,10.0
2726,1969-1970,1,Go Ahead Eagles,Holland Sport,1,2,2,0,3,3,-1,9.0,9.0
2727,1969-1970,1,GVAV Groningen,AFC Ajax,1,3,2,0,3,4,-2,4.0,12.0
2728,1969-1970,1,MVV Maastricht,PSV,1,1,3,1,1,2,0,9.0,11.0
2729,1969-1970,1,NEC Nijmegen,AZ '67 Alkmaar,1,0,1,3,0,1,1,7.0,2.0
2730,1969-1970,1,Sparta Rotterdam,HFC Haarlem,1,1,3,1,1,2,0,5.0,
2731,1969-1970,1,SVV Schiedam,DOS Utrecht,4,2,1,3,0,6,2,,7.0
2732,1969-1970,1,Telstar,Feijenoord,1,3,2,0,3,4,-2,5.0,12.0
2733,1969-1970,2,AFC Ajax,Go Ahead Eagles,2,0,1,3,0,2,2,15.0,6.0
2734,1969-1970,2,AZ '67 Alkmaar,MVV Maastricht,0,0,3,1,1,0,0,3.0,9.0
2735,1969-1970,2,DOS Utrecht,NAC Breda,0,2,2,0,3,2,-2,4.0,10.0
2736,1969-1970,2,Feijenoord,GVAV Groningen,3,0,1,3,0,3,3,15.0,4.0
2737,1969-1970,2,HFC Haarlem,ADO Den Haag,2,0,1,3,0,2,2,,6.0
2738,1969-1970,2,Holland Sport,SVV Schiedam,2,1,1,3,0,3,1,9.0,
2739,1969-1970,2,NEC Nijmegen,Sparta Rotterdam,2,4,2,0,3,6,-2,7.0,7.0
2740,1969-1970,2,Telstar,PSV,0,1,2,0,3,1,-1,2.0,11.0
2741,1969-1970,2,FC Twente,DWS Amsterdam,5,1,1,3,0,6,4,3.0,4.0
2742,1969-1970,3,SVV Schiedam,PSV,2,1,1,3,0,3,1,,8.0
2743,1969-1970,3,ADO Den Haag,Holland Sport,1,1,3,1,1,2,0,4.0,10.0
2744,1969-1970,3,DWS Amsterdam,DOS Utrecht,1,0,1,3,0,1,1,4.0,4.0
2745,1969-1970,3,Go Ahead Eagles,AZ '67 Alkmaar,1,0,1,3,0,1,1,6.0,3.0
2746,1969-1970,3,GVAV Groningen,NEC Nijmegen,0,1,2,0,3,1,-1,1.0,7.0
2747,1969-1970,3,MVV Maastricht,HFC Haarlem,1,1,3,1,1,2,0,7.0,
2748,1969-1970,3,NAC Breda,Feijenoord,0,4,2,0,3,4,-4,10.0,15.0
2749,1969-1970,3,Sparta Rotterdam,AFC Ajax,2,4,2,0,3,6,-2,7.0,15.0
2750,1969-1970,3,Telstar,FC Twente,2,0,1,3,0,2,2,5.0,3.0
2751,1969-1970,4,AFC Ajax,NEC Nijmegen,2,1,1,3,0,3,1,15.0,6.0
2752,1969-1970,4,AZ '67 Alkmaar,Sparta Rotterdam,0,1,2,0,3,1,-1,2.0,7.0
2753,1969-1970,4,DOS Utrecht,Telstar,0,1,2,0,3,1,-1,3.0,7.0
2754,1969-1970,4,FC Twente,SVV Schiedam,1,0,1,3,0,1,1,6.0,
2755,1969-1970,4,Feijenoord,DWS Amsterdam,3,2,1,3,0,5,1,15.0,4.0
2756,1969-1970,4,HFC Haarlem,Go Ahead Eagles,1,1,3,1,1,2,0,,7.0
2757,1969-1970,4,Holland Sport,MVV Maastricht,2,1,1,3,0,3,1,10.0,6.0
2758,1969-1970,4,NAC Breda,GVAV Groningen,2,0,1,3,0,2,2,12.0,0.0
2759,1969-1970,4,PSV,ADO Den Haag,3,1,1,3,0,4,2,10.0,4.0
2760,1969-1970,5,PSV,Go Ahead Eagles,4,1,1,3,0,5,3,10.0,4.0
2761,1969-1970,5,AZ '67 Alkmaar,AFC Ajax,0,1,2,0,3,1,-1,1.0,15.0
2762,1969-1970,5,DOS Utrecht,ADO Den Haag,1,1,3,1,1,2,0,1.0,5.0
2763,1969-1970,5,DWS Amsterdam,GVAV Groningen,1,2,2,0,3,3,-1,3.0,3.0
2764,1969-1970,5,FC Twente,MVV Maastricht,2,0,1,3,0,2,2,9.0,3.0
2765,1969-1970,5,Feijenoord,SVV Schiedam,6,0,1,3,0,6,6,15.0,6.0
2766,1969-1970,5,HFC Haarlem,NEC Nijmegen,2,1,1,3,0,3,1,9.0,6.0
2767,1969-1970,5,Holland Sport,Sparta Rotterdam,2,3,2,0,3,5,-1,10.0,10.0
2768,1969-1970,5,NAC Breda,Telstar,1,0,1,3,0,1,1,12.0,6.0
2769,1969-1970,6,MVV Maastricht,DOS Utrecht,2,0,1,3,0,2,2,5.0,1.0
2770,1969-1970,6,ADO Den Haag,Feijenoord,0,2,2,0,3,2,-2,2.0,15.0
2771,1969-1970,6,AFC Ajax,HFC Haarlem,4,0,1,3,0,4,4,15.0,8.0
2772,1969-1970,6,Go Ahead Eagles,FC Twente,1,1,3,1,1,2,0,5.0,10.0
2773,1969-1970,6,GVAV Groningen,AZ '67 Alkmaar,4,1,1,3,0,5,3,6.0,1.0
2774,1969-1970,6,NEC Nijmegen,Holland Sport,3,1,1,3,0,4,2,6.0,7.0
2775,1969-1970,6,Sparta Rotterdam,PSV,1,2,2,0,3,3,-1,9.0,12.0
2776,1969-1970,6,SVV Schiedam,NAC Breda,1,1,3,1,1,2,0,4.0,10.0
2777,1969-1970,6,Telstar,DWS Amsterdam,0,1,2,0,3,1,-1,6.0,6.0
2778,1969-1970,7,PSV,NEC Nijmegen,2,2,3,1,1,4,0,10.0,7.0
2779,1969-1970,7,DOS Utrecht,Go Ahead Eagles,2,3,2,0,3,5,-1,1.0,8.0
2780,1969-1970,7,DWS Amsterdam,SVV Schiedam,3,2,1,3,0,5,1,9.0,4.0
2781,1969-1970,7,FC Twente,Sparta Rotterdam,2,0,1,3,0,2,2,10.0,6.0
2782,1969-1970,7,Feijenoord,MVV Maastricht,5,1,1,3,0,6,4,15.0,4.0
2783,1969-1970,7,HFC Haarlem,AZ '67 Alkmaar,0,0,3,1,1,0,0,6.0,1.0
2784,1969-1970,7,Holland Sport,AFC Ajax,1,4,2,0,3,5,-3,4.0,15.0
2785,1969-1970,7,NAC Breda,ADO Den Haag,0,2,2,0,3,2,-2,7.0,5.0
2786,1969-1970,7,Telstar,GVAV Groningen,1,1,3,1,1,2,0,7.0,7.0
2787,1969-1970,8,ADO Den Haag,DWS Amsterdam,1,1,3,1,1,2,0,5.0,7.0
2788,1969-1970,8,AFC Ajax,PSV,3,0,1,3,0,3,3,15.0,10.0
2789,1969-1970,8,AZ '67 Alkmaar,Holland Sport,1,1,3,1,1,2,0,2.0,4.0
2790,1969-1970,8,Go Ahead Eagles,Feijenoord,0,1,2,0,3,1,-1,5.0,15.0
2791,1969-1970,8,GVAV Groningen,HFC Haarlem,0,2,2,0,3,2,-2,7.0,8.0
2792,1969-1970,8,MVV Maastricht,NAC Breda,0,0,3,1,1,0,0,4.0,8.0
2793,1969-1970,8,NEC Nijmegen,FC Twente,1,1,3,1,1,2,0,5.0,11.0
2794,1969-1970,8,Sparta Rotterdam,DOS Utrecht,0,0,3,1,1,0,0,7.0,2.0
2795,1969-1970,8,SVV Schiedam,Telstar,1,3,2,0,3,4,-2,1.0,7.0
2796,1969-1970,9,SVV Schiedam,GVAV Groningen,1,1,3,1,1,2,0,2.0,8.0
2797,1969-1970,9,DOS Utrecht,NEC Nijmegen,1,0,1,3,0,1,1,5.0,5.0
2798,1969-1970,9,DWS Amsterdam,MVV Maastricht,0,1,2,0,3,1,-1,7.0,7.0
2799,1969-1970,9,FC Twente,AFC Ajax,0,3,2,0,3,3,-3,8.0,15.0
2800,1969-1970,9,Feijenoord,Sparta Rotterdam,1,1,3,1,1,2,0,13.0,5.0
2801,1969-1970,9,Holland Sport,HFC Haarlem,0,1,2,0,3,1,-1,1.0,10.0
2802,1969-1970,9,NAC Breda,Go Ahead Eagles,2,0,1,3,0,2,2,8.0,4.0
2803,1969-1970,9,PSV,AZ '67 Alkmaar,7,2,1,3,0,9,5,10.0,2.0
2804,1969-1970,9,Telstar,ADO Den Haag,1,2,2,0,3,3,-1,4.0,8.0
2805,1969-1970,10,ADO Den Haag,SVV Schiedam,5,0,1,3,0,5,5,10.0,2.0
2806,1969-1970,10,AFC Ajax,DOS Utrecht,4,0,1,3,0,4,4,15.0,4.0
2807,1969-1970,10,AZ '67 Alkmaar,FC Twente,0,1,2,0,3,1,-1,2.0,8.0
2808,1969-1970,10,Go Ahead Eagles,DWS Amsterdam,1,0,1,3,0,1,1,7.0,7.0
2809,1969-1970,10,GVAV Groningen,Holland Sport,0,2,2,0,3,2,-2,5.0,4.0
2810,1969-1970,10,HFC Haarlem,PSV,0,1,2,0,3,1,-1,7.0,10.0
2811,1969-1970,10,MVV Maastricht,Telstar,0,0,3,1,1,0,0,8.0,5.0
2812,1969-1970,10,NEC Nijmegen,Feijenoord,0,2,2,0,3,2,-2,5.0,13.0
2813,1969-1970,10,Sparta Rotterdam,NAC Breda,1,2,2,0,3,3,-1,2.0,8.0
2814,1969-1970,11,ADO Den Haag,GVAV Groningen,1,0,1,3,0,1,1,13.0,2.0
2815,1969-1970,11,DOS Utrecht,AZ '67 Alkmaar,0,2,2,0,3,2,-2,4.0,5.0
2816,1969-1970,11,DWS Amsterdam,Sparta Rotterdam,0,2,2,0,3,2,-2,4.0,5.0
2817,1969-1970,11,FC Twente,HFC Haarlem,1,0,1,3,0,1,1,10.0,7.0
2818,1969-1970,11,Feijenoord,AFC Ajax,1,0,1,3,0,1,1,13.0,12.0
2819,1969-1970,11,NAC Breda,NEC Nijmegen,0,0,3,1,1,0,0,8.0,3.0
2820,1969-1970,11,PSV,Holland Sport,4,1,1,3,0,5,3,10.0,4.0
2821,1969-1970,11,SVV Schiedam,MVV Maastricht,3,7,2,0,3,10,-4,1.0,8.0
2822,1969-1970,11,Telstar,Go Ahead Eagles,1,1,3,1,1,2,0,6.0,7.0
2823,1969-1970,12,ADO Den Haag,AZ '67 Alkmaar,4,0,1,3,0,4,4,13.0,4.0
2824,1969-1970,12,DWS Amsterdam,PSV,0,0,3,1,1,0,0,2.0,10.0
2825,1969-1970,12,Feijenoord,DOS Utrecht,6,0,1,3,0,6,6,13.0,4.0
2826,1969-1970,12,Go Ahead Eagles,NEC Nijmegen,1,1,3,1,1,2,0,5.0,3.0
2827,1969-1970,12,MVV Maastricht,AFC Ajax,1,1,3,1,1,2,0,9.0,10.0
2828,1969-1970,12,NAC Breda,FC Twente,1,1,3,1,1,2,0,9.0,8.0
2829,1969-1970,12,SVV Schiedam,HFC Haarlem,0,0,3,1,1,0,0,2.0,7.0
2830,1969-1970,12,Telstar,Holland Sport,3,0,1,3,0,3,3,8.0,4.0
2831,1969-1970,12,Sparta Rotterdam,GVAV Groningen,2,0,1,3,0,2,2,8.0,1.0
2832,1969-1970,13,GVAV Groningen,PSV,0,3,2,0,3,3,-3,1.0,13.0
2833,1969-1970,13,AFC Ajax,NAC Breda,2,1,1,3,0,3,1,10.0,8.0
2834,1969-1970,13,Go Ahead Eagles,SVV Schiedam,1,0,1,3,0,1,1,8.0,2.0
2835,1969-1970,13,HFC Haarlem,DOS Utrecht,0,0,3,1,1,0,0,5.0,4.0
2836,1969-1970,13,Holland Sport,FC Twente,3,1,1,3,0,4,2,6.0,7.0
2837,1969-1970,13,MVV Maastricht,ADO Den Haag,2,2,3,1,1,4,0,9.0,13.0
2838,1969-1970,13,NEC Nijmegen,DWS Amsterdam,1,0,1,3,0,1,1,5.0,1.0
2839,1969-1970,13,Sparta Rotterdam,Telstar,3,2,1,3,0,5,1,10.0,5.0
2840,1969-1970,13,AZ '67 Alkmaar,Feijenoord,1,1,3,1,1,2,0,4.0,11.0
2841,1969-1970,14,ADO Den Haag,Go Ahead Eagles,0,0,3,1,1,0,0,11.0,9.0
2842,1969-1970,14,DOS Utrecht,Holland Sport,0,1,2,0,3,1,-1,1.0,9.0
2843,1969-1970,14,DWS Amsterdam,AFC Ajax,0,2,2,0,3,2,-2,1.0,10.0
2844,1969-1970,14,FC Twente,PSV,1,1,3,1,1,2,0,8.0,11.0
2845,1969-1970,14,Feijenoord,HFC Haarlem,4,0,1,3,0,4,4,13.0,2.0
2846,1969-1970,14,MVV Maastricht,GVAV Groningen,2,0,1,3,0,2,2,9.0,0.0
2847,1969-1970,14,NAC Breda,AZ '67 Alkmaar,2,2,3,1,1,4,0,6.0,5.0
2848,1969-1970,14,SVV Schiedam,Sparta Rotterdam,2,2,3,1,1,4,0,2.0,10.0
2849,1969-1970,14,Telstar,NEC Nijmegen,0,1,2,0,3,1,-1,5.0,8.0
2850,1969-1970,15,PSV,DOS Utrecht,1,0,1,3,0,1,1,11.0,1.0
2851,1969-1970,15,Holland Sport,Feijenoord,0,0,3,1,1,0,0,7.0,11.0
2852,1969-1970,15,AFC Ajax,Telstar,4,1,1,3,0,5,3,10.0,4.0
2853,1969-1970,15,AZ '67 Alkmaar,DWS Amsterdam,3,1,1,3,0,4,2,8.0,1.0
2854,1969-1970,15,Go Ahead Eagles,MVV Maastricht,3,3,3,1,1,6,0,7.0,9.0
2855,1969-1970,15,GVAV Groningen,FC Twente,0,0,3,1,1,0,0,1.0,6.0
2856,1969-1970,15,HFC Haarlem,NAC Breda,2,1,1,3,0,3,1,5.0,3.0
2857,1969-1970,15,NEC Nijmegen,SVV Schiedam,4,0,1,3,0,4,4,11.0,2.0
2858,1969-1970,15,Sparta Rotterdam,ADO Den Haag,1,2,2,0,3,3,-1,10.0,11.0
2859,1969-1970,16,ADO Den Haag,NEC Nijmegen,0,0,3,1,1,0,0,9.0,11.0
2860,1969-1970,16,DOS Utrecht,FC Twente,1,1,3,1,1,2,0,2.0,4.0
2861,1969-1970,16,DWS Amsterdam,HFC Haarlem,1,1,3,1,1,2,0,2.0,6.0
2862,1969-1970,16,Go Ahead Eagles,GVAV Groningen,1,1,3,1,1,2,0,7.0,2.0
2863,1969-1970,16,MVV Maastricht,Sparta Rotterdam,2,1,1,3,0,3,1,9.0,7.0
2864,1969-1970,16,SVV Schiedam,AFC Ajax,0,6,2,0,3,6,-6,2.0,13.0
2865,1969-1970,16,Telstar,AZ '67 Alkmaar,0,3,2,0,3,3,-3,3.0,8.0
2866,1969-1970,16,Feijenoord,PSV,1,0,1,3,0,1,1,11.0,8.0
2867,1969-1970,16,NAC Breda,Holland Sport,2,3,2,0,3,5,-1,2.0,10.0
2868,1969-1970,17,AFC Ajax,ADO Den Haag,2,1,1,3,0,3,1,15.0,6.0
2869,1969-1970,17,AZ '67 Alkmaar,SVV Schiedam,1,0,1,3,0,1,1,11.0,1.0
2870,1969-1970,17,DOS Utrecht,GVAV Groningen,2,0,1,3,0,2,2,5.0,2.0
2871,1969-1970,17,FC Twente,Feijenoord,1,1,3,1,1,2,0,4.0,9.0
2872,1969-1970,17,HFC Haarlem,Telstar,1,1,3,1,1,2,0,6.0,1.0
2873,1969-1970,17,Holland Sport,DWS Amsterdam,3,0,1,3,0,3,3,13.0,1.0
2874,1969-1970,17,NEC Nijmegen,MVV Maastricht,0,0,3,1,1,0,0,11.0,9.0
2875,1969-1970,17,PSV,NAC Breda,3,1,1,3,0,4,2,10.0,1.0
2876,1969-1970,17,Sparta Rotterdam,Go Ahead Eagles,3,0,1,3,0,3,3,7.0,6.0
2877,1969-1970,18,DOS Utrecht,SVV Schiedam,1,0,1,3,0,1,1,7.0,1.0
2878,1969-1970,18,Feijenoord,Telstar,2,0,1,3,0,2,2,11.0,1.0
2879,1969-1970,18,HFC Haarlem,Sparta Rotterdam,0,2,2,0,3,2,-2,5.0,7.0
2880,1969-1970,18,Holland Sport,Go Ahead Eagles,2,2,3,1,1,4,0,11.0,4.0
2881,1969-1970,18,NAC Breda,DWS Amsterdam,2,0,1,3,0,2,2,4.0,1.0
2882,1969-1970,18,PSV,MVV Maastricht,2,4,2,0,3,6,-2,7.0,11.0
2883,1969-1970,18,AZ '67 Alkmaar,NEC Nijmegen,1,1,3,1,1,2,0,11.0,9.0
2884,1969-1970,18,FC Twente,ADO Den Haag,3,1,1,3,0,4,2,7.0,5.0
2885,1969-1970,18,AFC Ajax,GVAV Groningen,3,0,1,3,0,3,3,15.0,2.0
2886,1969-1970,19,ADO Den Haag,HFC Haarlem,0,0,3,1,1,0,0,5.0,6.0
2887,1969-1970,19,DWS Amsterdam,FC Twente,0,1,2,0,3,1,-1,1.0,9.0
2888,1969-1970,19,MVV Maastricht,AZ '67 Alkmaar,0,1,2,0,3,1,-1,8.0,13.0
2889,1969-1970,19,NAC Breda,DOS Utrecht,2,1,1,3,0,3,1,6.0,7.0
2890,1969-1970,19,Sparta Rotterdam,NEC Nijmegen,3,1,1,3,0,4,2,9.0,6.0
2891,1969-1970,19,SVV Schiedam,Holland Sport,0,1,2,0,3,1,-1,0.0,11.0
2892,1969-1970,19,PSV,Telstar,3,1,1,3,0,4,2,9.0,1.0
2893,1969-1970,19,Go Ahead Eagles,AFC Ajax,1,3,2,0,3,4,-2,3.0,15.0
2894,1969-1970,19,GVAV Groningen,Feijenoord,0,1,2,0,3,1,-1,2.0,11.0
2895,1969-1970,20,AZ '67 Alkmaar,Go Ahead Eagles,2,1,1,3,0,3,1,13.0,2.0
2896,1969-1970,20,DOS Utrecht,DWS Amsterdam,1,1,3,1,1,2,0,8.0,2.0
2897,1969-1970,20,FC Twente,Telstar,2,2,3,1,1,4,0,9.0,2.0
2898,1969-1970,20,Feijenoord,NAC Breda,5,0,1,3,0,5,5,13.0,6.0
2899,1969-1970,20,Holland Sport,ADO Den Haag,4,2,1,3,0,6,2,13.0,2.0
2900,1969-1970,20,PSV,SVV Schiedam,6,0,1,3,0,6,6,9.0,0.0
2901,1969-1970,20,AFC Ajax,Sparta Rotterdam,2,1,1,3,0,3,1,15.0,9.0
2902,1969-1970,20,HFC Haarlem,MVV Maastricht,0,1,2,0,3,1,-1,3.0,10.0
2903,1969-1970,20,NEC Nijmegen,GVAV Groningen,0,2,2,0,3,2,-2,3.0,4.0
2904,1969-1970,21,ADO Den Haag,PSV,2,1,1,3,0,3,1,4.0,9.0
2905,1969-1970,21,DWS Amsterdam,Feijenoord,0,3,2,0,3,3,-3,1.0,13.0
2906,1969-1970,21,Go Ahead Eagles,HFC Haarlem,2,1,1,3,0,3,1,4.0,2.0
2907,1969-1970,21,MVV Maastricht,Holland Sport,2,0,1,3,0,2,2,10.0,10.0
2908,1969-1970,21,NEC Nijmegen,AFC Ajax,0,0,3,1,1,0,0,3.0,13.0
2909,1969-1970,21,Sparta Rotterdam,AZ '67 Alkmaar,0,0,3,1,1,0,0,10.0,11.0
2910,1969-1970,21,SVV Schiedam,FC Twente,1,0,1,3,0,1,1,3.0,8.0
2911,1969-1970,21,Telstar,DOS Utrecht,1,2,2,0,3,3,-1,2.0,10.0
2912,1969-1970,21,GVAV Groningen,NAC Breda,0,2,2,0,3,2,-2,3.0,9.0
2913,1969-1970,22,MVV Maastricht,FC Twente,1,3,2,0,3,4,-2,9.0,10.0
2914,1969-1970,22,SVV Schiedam,Feijenoord,3,4,2,0,3,7,-1,3.0,15.0
2915,1969-1970,22,ADO Den Haag,DOS Utrecht,5,0,1,3,0,5,5,7.0,7.0
2916,1969-1970,22,AFC Ajax,AZ '67 Alkmaar,4,1,1,3,0,5,3,13.0,8.0
2917,1969-1970,22,Sparta Rotterdam,Holland Sport,2,1,1,3,0,3,1,10.0,7.0
2918,1969-1970,22,Telstar,NAC Breda,1,1,3,1,1,2,0,2.0,10.0
2919,1969-1970,22,Go Ahead Eagles,PSV,2,1,1,3,0,3,1,7.0,6.0
2920,1969-1970,22,GVAV Groningen,DWS Amsterdam,1,0,1,3,0,1,1,6.0,1.0
2921,1969-1970,22,NEC Nijmegen,HFC Haarlem,0,0,3,1,1,0,0,3.0,2.0
2922,1969-1970,23,AZ '67 Alkmaar,GVAV Groningen,0,1,2,0,3,1,-1,7.0,9.0
2923,1969-1970,23,DOS Utrecht,MVV Maastricht,1,1,3,1,1,2,0,5.0,7.0
2924,1969-1970,23,DWS Amsterdam,Telstar,3,0,1,3,0,3,3,4.0,2.0
2925,1969-1970,23,FC Twente,Go Ahead Eagles,3,0,1,3,0,3,3,10.0,6.0
2926,1969-1970,23,Feijenoord,ADO Den Haag,0,0,3,1,1,0,0,13.0,8.0
2927,1969-1970,23,HFC Haarlem,AFC Ajax,0,1,2,0,3,1,-1,2.0,13.0
2928,1969-1970,23,Holland Sport,NEC Nijmegen,2,0,1,3,0,2,2,9.0,2.0
2929,1969-1970,23,NAC Breda,SVV Schiedam,4,0,1,3,0,4,4,10.0,3.0
2930,1969-1970,23,PSV,Sparta Rotterdam,1,1,3,1,1,2,0,7.0,8.0
2931,1969-1970,24,ADO Den Haag,NAC Breda,5,0,1,3,0,5,5,10.0,7.0
2932,1969-1970,24,AFC Ajax,Holland Sport,5,1,1,3,0,6,4,13.0,6.0
2933,1969-1970,24,AZ '67 Alkmaar,HFC Haarlem,1,1,3,1,1,2,0,5.0,2.0
2934,1969-1970,24,Go Ahead Eagles,DOS Utrecht,3,0,1,3,0,3,3,9.0,5.0
2935,1969-1970,24,GVAV Groningen,Telstar,1,1,3,1,1,2,0,10.0,3.0
2936,1969-1970,24,NEC Nijmegen,PSV,1,1,3,1,1,2,0,3.0,5.0
2937,1969-1970,24,Sparta Rotterdam,FC Twente,3,0,1,3,0,3,3,8.0,7.0
2938,1969-1970,24,SVV Schiedam,DWS Amsterdam,0,2,2,0,3,2,-2,3.0,7.0
2939,1969-1970,24,MVV Maastricht,Feijenoord,1,1,3,1,1,2,0,8.0,11.0
2940,1969-1970,25,HFC Haarlem,GVAV Groningen,0,0,3,1,1,0,0,3.0,8.0
2941,1969-1970,25,DOS Utrecht,Sparta Rotterdam,2,1,1,3,0,3,1,7.0,8.0
2942,1969-1970,25,DWS Amsterdam,ADO Den Haag,1,0,1,3,0,1,1,9.0,10.0
2943,1969-1970,25,FC Twente,NEC Nijmegen,3,1,1,3,0,4,2,9.0,3.0
2944,1969-1970,25,Feijenoord,Go Ahead Eagles,0,0,3,1,1,0,0,9.0,10.0
2945,1969-1970,25,Holland Sport,AZ '67 Alkmaar,2,3,2,0,3,5,-1,3.0,5.0
2946,1969-1970,25,PSV,AFC Ajax,1,3,2,0,3,4,-2,2.0,13.0
2947,1969-1970,25,Telstar,SVV Schiedam,2,0,1,3,0,2,2,5.0,3.0
2948,1969-1970,25,NAC Breda,MVV Maastricht,3,1,1,3,0,4,2,10.0,5.0
2949,1969-1970,26,ADO Den Haag,Telstar,1,1,3,1,1,2,0,8.0,6.0
2950,1969-1970,26,AFC Ajax,FC Twente,3,0,1,3,0,3,3,15.0,9.0
2951,1969-1970,26,AZ '67 Alkmaar,PSV,0,0,3,1,1,0,0,5.0,3.0
2952,1969-1970,26,Go Ahead Eagles,NAC Breda,2,0,1,3,0,2,2,10.0,7.0
2953,1969-1970,26,GVAV Groningen,SVV Schiedam,1,0,1,3,0,1,1,11.0,0.0
2954,1969-1970,26,HFC Haarlem,Holland Sport,0,0,3,1,1,0,0,4.0,4.0
2955,1969-1970,26,MVV Maastricht,DWS Amsterdam,2,1,1,3,0,3,1,5.0,9.0
2956,1969-1970,26,NEC Nijmegen,DOS Utrecht,1,0,1,3,0,1,1,5.0,4.0
2957,1969-1970,26,Sparta Rotterdam,Feijenoord,0,0,3,1,1,0,0,8.0,7.0
2958,1969-1970,27,DOS Utrecht,AFC Ajax,1,7,2,0,3,8,-6,4.0,15.0
2959,1969-1970,27,DWS Amsterdam,Go Ahead Eagles,0,0,3,1,1,0,0,10.0,8.0
2960,1969-1970,27,FC Twente,AZ '67 Alkmaar,5,1,1,3,0,6,4,9.0,5.0
2961,1969-1970,27,Feijenoord,NEC Nijmegen,0,0,3,1,1,0,0,5.0,5.0
2962,1969-1970,27,Holland Sport,GVAV Groningen,2,1,1,3,0,3,1,7.0,8.0
2963,1969-1970,27,NAC Breda,Sparta Rotterdam,1,2,2,0,3,3,-1,6.0,8.0
2964,1969-1970,27,PSV,HFC Haarlem,2,1,1,3,0,3,1,6.0,3.0
2965,1969-1970,27,SVV Schiedam,ADO Den Haag,1,3,2,0,3,4,-2,0.0,8.0
2966,1969-1970,27,Telstar,MVV Maastricht,1,1,3,1,1,2,0,6.0,6.0
2967,1969-1970,28,AFC Ajax,Feijenoord,3,3,3,1,1,6,0,13.0,5.0
2968,1969-1970,28,AZ '67 Alkmaar,DOS Utrecht,1,0,1,3,0,1,1,8.0,3.0
2969,1969-1970,28,Go Ahead Eagles,Telstar,1,1,3,1,1,2,0,9.0,7.0
2970,1969-1970,28,GVAV Groningen,ADO Den Haag,0,2,2,0,3,2,-2,5.0,10.0
2971,1969-1970,28,HFC Haarlem,FC Twente,0,2,2,0,3,2,-2,3.0,9.0
2972,1969-1970,28,Holland Sport,PSV,0,3,2,0,3,3,-3,4.0,8.0
2973,1969-1970,28,MVV Maastricht,SVV Schiedam,2,1,1,3,0,3,1,8.0,0.0
2974,1969-1970,28,NEC Nijmegen,NAC Breda,1,0,1,3,0,1,1,8.0,3.0
2975,1969-1970,28,Sparta Rotterdam,DWS Amsterdam,2,0,1,3,0,2,2,10.0,7.0
2976,1969-1970,29,AFC Ajax,MVV Maastricht,2,0,1,3,0,2,2,13.0,7.0
2977,1969-1970,29,AZ '67 Alkmaar,ADO Den Haag,1,1,3,1,1,2,0,8.0,8.0
2978,1969-1970,29,DOS Utrecht,Feijenoord,1,1,3,1,1,2,0,4.0,5.0
2979,1969-1970,29,FC Twente,NAC Breda,7,0,1,3,0,7,7,12.0,3.0
2980,1969-1970,29,GVAV Groningen,Sparta Rotterdam,0,0,3,1,1,0,0,5.0,8.0
2981,1969-1970,29,HFC Haarlem,SVV Schiedam,0,0,3,1,1,0,0,3.0,1.0
2982,1969-1970,29,Holland Sport,Telstar,2,0,1,3,0,2,2,7.0,6.0
2983,1969-1970,29,NEC Nijmegen,Go Ahead Eagles,1,1,3,1,1,2,0,8.0,7.0
2984,1969-1970,29,PSV,DWS Amsterdam,3,0,1,3,0,3,3,10.0,4.0
2985,1969-1970,30,ADO Den Haag,MVV Maastricht,1,1,3,1,1,2,0,9.0,8.0
2986,1969-1970,30,DOS Utrecht,HFC Haarlem,2,1,1,3,0,3,1,4.0,2.0
2987,1969-1970,30,DWS Amsterdam,NEC Nijmegen,1,1,3,1,1,2,0,2.0,9.0
2988,1969-1970,30,FC Twente,Holland Sport,3,0,1,3,0,3,3,12.0,7.0
2989,1969-1970,30,NAC Breda,AFC Ajax,1,1,3,1,1,2,0,1.0,11.0
2990,1969-1970,30,PSV,GVAV Groningen,2,0,1,3,0,2,2,13.0,4.0
2991,1969-1970,30,SVV Schiedam,Go Ahead Eagles,0,3,2,0,3,3,-3,1.0,9.0
2992,1969-1970,30,Telstar,Sparta Rotterdam,1,1,3,1,1,2,0,4.0,9.0
2993,1969-1970,30,Feijenoord,AZ '67 Alkmaar,2,0,1,3,0,2,2,7.0,5.0
2994,1969-1970,31,AFC Ajax,DWS Amsterdam,6,1,1,3,0,7,5,11.0,2.0
2995,1969-1970,31,AZ '67 Alkmaar,NAC Breda,1,1,3,1,1,2,0,5.0,2.0
2996,1969-1970,31,Go Ahead Eagles,ADO Den Haag,2,0,1,3,0,2,2,9.0,8.0
2997,1969-1970,31,GVAV Groningen,MVV Maastricht,1,0,1,3,0,1,1,4.0,5.0
2998,1969-1970,31,Holland Sport,DOS Utrecht,3,3,3,1,1,6,0,7.0,5.0
2999,1969-1970,31,NEC Nijmegen,Telstar,1,1,3,1,1,2,0,7.0,4.0
3000,1969-1970,31,PSV,FC Twente,3,0,1,3,0,3,3,15.0,12.0
3001,1969-1970,31,Sparta Rotterdam,SVV Schiedam,3,1,1,3,0,4,2,11.0,1.0
3002,1969-1970,31,HFC Haarlem,Feijenoord,1,2,2,0,3,3,-1,1.0,9.0
3003,1969-1970,32,ADO Den Haag,Sparta Rotterdam,2,0,1,3,0,2,2,8.0,8.0
3004,1969-1970,32,DOS Utrecht,PSV,0,0,3,1,1,0,0,6.0,13.0
3005,1969-1970,32,DWS Amsterdam,AZ '67 Alkmaar,1,0,1,3,0,1,1,4.0,5.0
3006,1969-1970,32,FC Twente,GVAV Groningen,2,1,1,3,0,3,1,12.0,4.0
3007,1969-1970,32,Feijenoord,Holland Sport,8,2,1,3,0,10,6,11.0,4.0
3008,1969-1970,32,MVV Maastricht,Go Ahead Eagles,0,1,2,0,3,1,-1,4.0,11.0
3009,1969-1970,32,NAC Breda,HFC Haarlem,1,1,3,1,1,2,0,3.0,2.0
3010,1969-1970,32,SVV Schiedam,NEC Nijmegen,4,2,1,3,0,6,2,4.0,6.0
3011,1969-1970,32,Telstar,AFC Ajax,1,1,3,1,1,2,0,4.0,9.0
3012,1969-1970,33,AFC Ajax,SVV Schiedam,8,0,1,3,0,8,8,11.0,4.0
3013,1969-1970,33,AZ '67 Alkmaar,Telstar,0,0,3,1,1,0,0,3.0,4.0
3014,1969-1970,33,FC Twente,DOS Utrecht,7,2,1,3,0,9,5,12.0,6.0
3015,1969-1970,33,GVAV Groningen,Go Ahead Eagles,1,1,3,1,1,2,0,5.0,11.0
3016,1969-1970,33,HFC Haarlem,DWS Amsterdam,0,1,2,0,3,1,-1,2.0,7.0
3017,1969-1970,33,Holland Sport,NAC Breda,1,1,3,1,1,2,0,5.0,4.0
3018,1969-1970,33,NEC Nijmegen,ADO Den Haag,0,3,2,0,3,3,-3,3.0,8.0
3019,1969-1970,33,PSV,Feijenoord,3,0,1,3,0,3,3,13.0,10.0
3020,1969-1970,33,Sparta Rotterdam,MVV Maastricht,4,3,1,3,0,7,1,8.0,1.0
3021,1969-1970,34,Feijenoord,FC Twente,5,1,1,3,0,6,4,12.0,9.0
3022,1969-1970,34,ADO Den Haag,AFC Ajax,1,1,3,1,1,2,0,8.0,9.0
3023,1969-1970,34,DWS Amsterdam,Holland Sport,2,0,1,3,0,2,2,10.0,2.0
3024,1969-1970,34,Go Ahead Eagles,Sparta Rotterdam,2,3,2,0,3,5,-1,10.0,10.0
3025,1969-1970,34,GVAV Groningen,DOS Utrecht,0,1,2,0,3,1,-1,4.0,8.0
3026,1969-1970,34,MVV Maastricht,NEC Nijmegen,1,1,3,1,1,2,0,2.0,3.0
3027,1969-1970,34,NAC Breda,PSV,2,4,2,0,3,6,-2,4.0,13.0
3028,1969-1970,34,SVV Schiedam,AZ '67 Alkmaar,3,2,1,3,0,5,1,6.0,2.0
3029,1969-1970,34,Telstar,HFC Haarlem,2,3,2,0,3,5,-1,4.0,4.0
3030,1970-1971,1,Feijenoord,FC Utrecht,4,1,1,3,0,5,3,12.0,
3031,1970-1971,1,ADO Den Haag,NAC Breda,3,0,1,3,0,3,3,10.0,3.0
3032,1970-1971,1,DWS Amsterdam,PSV,0,1,2,0,3,1,-1,9.0,13.0
3033,1970-1971,1,SBV Excelsior,AZ '67 Alkmaar,0,0,3,1,1,0,0,,3.0
3034,1970-1971,1,Go Ahead Eagles,HFC Haarlem,1,1,3,1,1,2,0,8.0,5.0
3035,1970-1971,1,MVV Maastricht,Holland Sport,0,1,2,0,3,1,-1,1.0,5.0
3036,1970-1971,1,NEC Nijmegen,AFC Ajax,0,0,3,1,1,0,0,3.0,9.0
3037,1970-1971,1,Telstar,Sparta Rotterdam,1,4,2,0,3,5,-3,3.0,12.0
3038,1970-1971,1,FC Volendam,FC Twente,0,1,2,0,3,1,-1,3.0,9.0
3039,1970-1971,2,AFC Ajax,MVV Maastricht,2,0,1,3,0,2,2,9.0,1.0
3040,1970-1971,2,AZ '67 Alkmaar,Feijenoord,0,4,2,0,3,4,-4,2.0,12.0
3041,1970-1971,2,FC Twente,Telstar,1,1,3,1,1,2,0,10.0,3.0
3042,1970-1971,2,FC Utrecht,Go Ahead Eagles,4,1,1,3,0,5,3,,5.0
3043,1970-1971,2,HFC Haarlem,NEC Nijmegen,1,1,3,1,1,2,0,6.0,3.0
3044,1970-1971,2,Holland Sport,ADO Den Haag,2,3,2,0,3,5,-1,4.0,13.0
3045,1970-1971,2,NAC Breda,DWS Amsterdam,1,4,2,0,3,5,-3,2.0,12.0
3046,1970-1971,2,PSV,FC Volendam,4,2,1,3,0,6,2,13.0,2.0
3047,1970-1971,2,Sparta Rotterdam,SBV Excelsior,5,1,1,3,0,6,4,12.0,
3048,1970-1971,3,ADO Den Haag,AFC Ajax,1,0,1,3,0,1,1,13.0,8.0
3049,1970-1971,3,DWS Amsterdam,Holland Sport,0,0,3,1,1,0,0,10.0,5.0
3050,1970-1971,3,SBV Excelsior,FC Twente,1,2,2,0,3,3,-1,,10.0
3051,1970-1971,3,Go Ahead Eagles,Feijenoord,1,2,2,0,3,3,-1,2.0,12.0
3052,1970-1971,3,MVV Maastricht,HFC Haarlem,1,1,3,1,1,2,0,2.0,6.0
3053,1970-1971,3,NEC Nijmegen,FC Utrecht,2,1,1,3,0,3,1,6.0,
3054,1970-1971,3,Sparta Rotterdam,AZ '67 Alkmaar,2,1,1,3,0,3,1,15.0,2.0
3055,1970-1971,3,Telstar,PSV,1,1,3,1,1,2,0,3.0,13.0
3056,1970-1971,3,FC Volendam,NAC Breda,2,1,1,3,0,3,1,5.0,1.0
3057,1970-1971,4,PSV,SBV Excelsior,3,0,1,3,0,3,3,13.0,
3058,1970-1971,4,AFC Ajax,DWS Amsterdam,4,0,1,3,0,4,4,8.0,7.0
3059,1970-1971,4,AZ '67 Alkmaar,Go Ahead Eagles,0,1,2,0,3,1,-1,1.0,4.0
3060,1970-1971,4,FC Twente,Sparta Rotterdam,0,1,2,0,3,1,-1,7.0,15.0
3061,1970-1971,4,FC Utrecht,MVV Maastricht,0,0,3,1,1,0,0,,3.0
3062,1970-1971,4,Feijenoord,NEC Nijmegen,1,0,1,3,0,1,1,15.0,6.0
3063,1970-1971,4,HFC Haarlem,ADO Den Haag,1,2,2,0,3,3,-1,6.0,13.0
3064,1970-1971,4,Holland Sport,FC Volendam,2,1,1,3,0,3,1,7.0,4.0
3065,1970-1971,4,NAC Breda,Telstar,2,0,1,3,0,2,2,3.0,2.0
3066,1970-1971,5,ADO Den Haag,FC Utrecht,4,0,1,3,0,4,4,15.0,4.0
3067,1970-1971,5,DWS Amsterdam,HFC Haarlem,1,0,1,3,0,1,1,7.0,3.0
3068,1970-1971,5,SBV Excelsior,NAC Breda,2,2,3,1,1,4,0,2.0,4.0
3069,1970-1971,5,FC Twente,AZ '67 Alkmaar,2,0,1,3,0,2,2,10.0,1.0
3070,1970-1971,5,MVV Maastricht,Feijenoord,1,1,3,1,1,2,0,3.0,13.0
3071,1970-1971,5,NEC Nijmegen,Go Ahead Eagles,2,1,1,3,0,3,1,8.0,4.0
3072,1970-1971,5,Sparta Rotterdam,PSV,1,0,1,3,0,1,1,15.0,10.0
3073,1970-1971,5,Telstar,Holland Sport,1,1,3,1,1,2,0,3.0,8.0
3074,1970-1971,5,FC Volendam,AFC Ajax,0,3,2,0,3,3,-3,3.0,10.0
3075,1970-1971,6,PSV,FC Twente,0,0,3,1,1,0,0,8.0,8.0
3076,1970-1971,6,Feijenoord,ADO Den Haag,0,0,3,1,1,0,0,11.0,13.0
3077,1970-1971,6,AFC Ajax,Telstar,3,1,1,3,0,4,2,12.0,3.0
3078,1970-1971,6,AZ '67 Alkmaar,NEC Nijmegen,1,1,3,1,1,2,0,1.0,8.0
3079,1970-1971,6,FC Utrecht,DWS Amsterdam,2,1,1,3,0,3,1,7.0,7.0
3080,1970-1971,6,Go Ahead Eagles,MVV Maastricht,1,0,1,3,0,1,1,6.0,3.0
3081,1970-1971,6,HFC Haarlem,FC Volendam,0,1,2,0,3,1,-1,2.0,6.0
3082,1970-1971,6,Holland Sport,SBV Excelsior,2,3,2,0,3,5,-1,5.0,4.0
3083,1970-1971,6,NAC Breda,Sparta Rotterdam,0,0,3,1,1,0,0,5.0,13.0
3084,1970-1971,7,SBV Excelsior,AFC Ajax,1,1,3,1,1,2,0,5.0,10.0
3085,1970-1971,7,ADO Den Haag,Go Ahead Eagles,3,0,1,3,0,3,3,13.0,6.0
3086,1970-1971,7,DWS Amsterdam,Feijenoord,0,4,2,0,3,4,-4,4.0,11.0
3087,1970-1971,7,FC Twente,NAC Breda,3,0,1,3,0,3,3,10.0,5.0
3088,1970-1971,7,MVV Maastricht,NEC Nijmegen,2,0,1,3,0,2,2,6.0,7.0
3089,1970-1971,7,PSV,AZ '67 Alkmaar,6,0,1,3,0,6,6,8.0,1.0
3090,1970-1971,7,Sparta Rotterdam,Holland Sport,1,0,1,3,0,1,1,13.0,5.0
3091,1970-1971,7,Telstar,HFC Haarlem,6,3,1,3,0,9,3,5.0,1.0
3092,1970-1971,7,FC Volendam,FC Utrecht,2,3,2,0,3,5,-1,6.0,7.0
3093,1970-1971,8,AFC Ajax,Sparta Rotterdam,2,2,3,1,1,4,0,11.0,11.0
3094,1970-1971,8,AZ '67 Alkmaar,MVV Maastricht,0,2,2,0,3,2,-2,1.0,8.0
3095,1970-1971,8,FC Utrecht,Telstar,4,1,1,3,0,5,3,10.0,4.0
3096,1970-1971,8,Feijenoord,FC Volendam,3,0,1,3,0,3,3,11.0,3.0
3097,1970-1971,8,Go Ahead Eagles,DWS Amsterdam,0,0,3,1,1,0,0,7.0,4.0
3098,1970-1971,8,HFC Haarlem,SBV Excelsior,2,0,1,3,0,2,2,3.0,5.0
3099,1970-1971,8,Holland Sport,FC Twente,0,0,3,1,1,0,0,5.0,8.0
3100,1970-1971,8,NAC Breda,PSV,0,3,2,0,3,3,-3,5.0,10.0
3101,1970-1971,8,NEC Nijmegen,ADO Den Haag,1,2,2,0,3,3,-1,4.0,13.0
3102,1970-1971,9,ADO Den Haag,MVV Maastricht,4,0,1,3,0,4,4,13.0,7.0
3103,1970-1971,9,DWS Amsterdam,NEC Nijmegen,2,2,3,1,1,4,0,5.0,5.0
3104,1970-1971,9,SBV Excelsior,FC Utrecht,1,2,2,0,3,3,-1,5.0,12.0
3105,1970-1971,9,FC Twente,AFC Ajax,1,0,1,3,0,1,1,11.0,8.0
3106,1970-1971,9,NAC Breda,AZ '67 Alkmaar,5,2,1,3,0,7,3,5.0,1.0
3107,1970-1971,9,PSV,Holland Sport,3,0,1,3,0,3,3,10.0,2.0
3108,1970-1971,9,Sparta Rotterdam,HFC Haarlem,0,0,3,1,1,0,0,9.0,4.0
3109,1970-1971,9,Telstar,Feijenoord,1,0,1,3,0,1,1,7.0,8.0
3110,1970-1971,9,FC Volendam,Go Ahead Eagles,0,0,3,1,1,0,0,4.0,5.0
3111,1970-1971,10,AFC Ajax,PSV,1,0,1,3,0,1,1,8.0,10.0
3112,1970-1971,10,AZ '67 Alkmaar,ADO Den Haag,1,1,3,1,1,2,0,2.0,11.0
3113,1970-1971,10,FC Utrecht,Sparta Rotterdam,1,1,3,1,1,2,0,13.0,7.0
3114,1970-1971,10,Feijenoord,SBV Excelsior,4,2,1,3,0,6,2,10.0,4.0
3115,1970-1971,10,Go Ahead Eagles,Telstar,3,1,1,3,0,4,2,8.0,6.0
3116,1970-1971,10,HFC Haarlem,FC Twente,0,4,2,0,3,4,-4,4.0,11.0
3117,1970-1971,10,Holland Sport,NAC Breda,0,0,3,1,1,0,0,2.0,5.0
3118,1970-1971,10,MVV Maastricht,DWS Amsterdam,2,0,1,3,0,2,2,9.0,2.0
3119,1970-1971,10,NEC Nijmegen,FC Volendam,4,0,1,3,0,4,4,5.0,4.0
3120,1970-1971,11,DWS Amsterdam,ADO Den Haag,0,1,2,0,3,1,-1,2.0,13.0
3121,1970-1971,11,SBV Excelsior,Go Ahead Eagles,0,2,2,0,3,2,-2,1.0,8.0
3122,1970-1971,11,FC Twente,FC Utrecht,2,0,1,3,0,2,2,13.0,10.0
3123,1970-1971,11,Holland Sport,AZ '67 Alkmaar,3,1,1,3,0,4,2,5.0,1.0
3124,1970-1971,11,NAC Breda,AFC Ajax,0,2,2,0,3,2,-2,4.0,8.0
3125,1970-1971,11,PSV,HFC Haarlem,1,0,1,3,0,1,1,12.0,4.0
3126,1970-1971,11,Sparta Rotterdam,Feijenoord,1,1,3,1,1,2,0,7.0,10.0
3127,1970-1971,11,Telstar,NEC Nijmegen,0,1,2,0,3,1,-1,6.0,7.0
3128,1970-1971,11,FC Volendam,MVV Maastricht,3,1,1,3,0,4,2,4.0,9.0
3129,1970-1971,12,ADO Den Haag,FC Volendam,2,1,1,3,0,3,1,13.0,4.0
3130,1970-1971,12,AFC Ajax,Holland Sport,2,1,1,3,0,3,1,10.0,5.0
3131,1970-1971,12,AZ '67 Alkmaar,DWS Amsterdam,0,0,3,1,1,0,0,2.0,3.0
3132,1970-1971,12,FC Utrecht,PSV,0,3,2,0,3,3,-3,7.0,12.0
3133,1970-1971,12,Feijenoord,FC Twente,1,1,3,1,1,2,0,8.0,11.0
3134,1970-1971,12,Go Ahead Eagles,Sparta Rotterdam,0,1,2,0,3,1,-1,8.0,7.0
3135,1970-1971,12,HFC Haarlem,NAC Breda,2,2,3,1,1,4,0,5.0,5.0
3136,1970-1971,12,MVV Maastricht,Telstar,1,1,3,1,1,2,0,7.0,4.0
3137,1970-1971,12,NEC Nijmegen,SBV Excelsior,5,0,1,3,0,5,5,10.0,0.0
3138,1970-1971,13,PSV,Feijenoord,2,3,2,0,3,5,-1,9.0,8.0
3139,1970-1971,13,AFC Ajax,AZ '67 Alkmaar,8,1,1,3,0,9,7,12.0,2.0
3140,1970-1971,13,SBV Excelsior,MVV Maastricht,3,0,1,3,0,3,3,3.0,4.0
3141,1970-1971,13,FC Twente,Go Ahead Eagles,2,0,1,3,0,2,2,13.0,7.0
3142,1970-1971,13,Holland Sport,HFC Haarlem,1,1,3,1,1,2,0,5.0,3.0
3143,1970-1971,13,NAC Breda,FC Utrecht,1,2,2,0,3,3,-1,5.0,7.0
3144,1970-1971,13,Sparta Rotterdam,NEC Nijmegen,2,1,1,3,0,3,1,9.0,10.0
3145,1970-1971,13,Telstar,ADO Den Haag,0,2,2,0,3,2,-2,4.0,13.0
3146,1970-1971,13,FC Volendam,DWS Amsterdam,2,2,3,1,1,4,0,5.0,3.0
3147,1970-1971,14,ADO Den Haag,SBV Excelsior,0,0,3,1,1,0,0,11.0,4.0
3148,1970-1971,14,AZ '67 Alkmaar,FC Volendam,1,1,3,1,1,2,0,3.0,5.0
3149,1970-1971,14,DWS Amsterdam,Telstar,0,0,3,1,1,0,0,3.0,2.0
3150,1970-1971,14,FC Utrecht,Holland Sport,2,1,1,3,0,3,1,7.0,5.0
3151,1970-1971,14,Feijenoord,NAC Breda,3,0,1,3,0,3,3,11.0,2.0
3152,1970-1971,14,Go Ahead Eagles,PSV,3,3,3,1,1,6,0,7.0,7.0
3153,1970-1971,14,HFC Haarlem,AFC Ajax,0,5,2,0,3,5,-5,2.0,15.0
3154,1970-1971,14,MVV Maastricht,Sparta Rotterdam,3,3,3,1,1,6,0,5.0,9.0
3155,1970-1971,14,NEC Nijmegen,FC Twente,0,0,3,1,1,0,0,10.0,11.0
3156,1970-1971,15,AFC Ajax,FC Utrecht,7,1,1,3,0,8,6,15.0,6.0
3157,1970-1971,15,SBV Excelsior,DWS Amsterdam,0,0,3,1,1,0,0,5.0,4.0
3158,1970-1971,15,HFC Haarlem,AZ '67 Alkmaar,2,3,2,0,3,5,-1,2.0,5.0
3159,1970-1971,15,Holland Sport,Feijenoord,2,3,2,0,3,5,-1,4.0,11.0
3160,1970-1971,15,NAC Breda,Go Ahead Eagles,3,1,1,3,0,4,2,4.0,4.0
3161,1970-1971,15,PSV,NEC Nijmegen,2,0,1,3,0,2,2,10.0,7.0
3162,1970-1971,15,Sparta Rotterdam,ADO Den Haag,4,2,1,3,0,6,2,11.0,10.0
3163,1970-1971,15,Telstar,FC Volendam,0,0,3,1,1,0,0,3.0,6.0
3164,1970-1971,15,FC Twente,MVV Maastricht,2,0,1,3,0,2,2,11.0,2.0
3165,1970-1971,16,ADO Den Haag,FC Twente,1,1,3,1,1,2,0,8.0,9.0
3166,1970-1971,16,DWS Amsterdam,Sparta Rotterdam,2,1,1,3,0,3,1,7.0,10.0
3167,1970-1971,16,FC Utrecht,HFC Haarlem,1,0,1,3,0,1,1,9.0,2.0
3168,1970-1971,16,Feijenoord,AFC Ajax,1,1,3,1,1,2,0,11.0,13.0
3169,1970-1971,16,Go Ahead Eagles,Holland Sport,4,0,1,3,0,4,4,4.0,1.0
3170,1970-1971,16,MVV Maastricht,PSV,0,3,2,0,3,3,-3,2.0,10.0
3171,1970-1971,16,NEC Nijmegen,NAC Breda,1,1,3,1,1,2,0,5.0,5.0
3172,1970-1971,16,Telstar,AZ '67 Alkmaar,4,0,1,3,0,4,4,6.0,5.0
3173,1970-1971,16,FC Volendam,SBV Excelsior,3,0,1,3,0,3,3,6.0,5.0
3174,1970-1971,17,AFC Ajax,NEC Nijmegen,4,1,1,3,0,5,3,13.0,2.0
3175,1970-1971,17,AZ '67 Alkmaar,SBV Excelsior,1,1,3,1,1,2,0,5.0,6.0
3176,1970-1971,17,FC Utrecht,Feijenoord,1,2,2,0,3,3,-1,9.0,13.0
3177,1970-1971,17,HFC Haarlem,Go Ahead Eagles,0,0,3,1,1,0,0,2.0,5.0
3178,1970-1971,17,Holland Sport,MVV Maastricht,1,1,3,1,1,2,0,2.0,2.0
3179,1970-1971,17,NAC Breda,ADO Den Haag,0,3,2,0,3,3,-3,4.0,8.0
3180,1970-1971,17,PSV,DWS Amsterdam,8,0,1,3,0,8,8,10.0,6.0
3181,1970-1971,17,Sparta Rotterdam,Telstar,1,0,1,3,0,1,1,10.0,5.0
3182,1970-1971,17,FC Twente,FC Volendam,2,1,1,3,0,3,1,11.0,6.0
3183,1970-1971,18,SBV Excelsior,Sparta Rotterdam,0,2,2,0,3,2,-2,3.0,10.0
3184,1970-1971,18,ADO Den Haag,Holland Sport,0,0,3,1,1,0,0,6.0,2.0
3185,1970-1971,18,DWS Amsterdam,NAC Breda,1,1,3,1,1,2,0,6.0,5.0
3186,1970-1971,18,Feijenoord,AZ '67 Alkmaar,6,1,1,3,0,7,5,13.0,5.0
3187,1970-1971,18,MVV Maastricht,AFC Ajax,1,0,1,3,0,1,1,5.0,10.0
3188,1970-1971,18,Telstar,FC Twente,0,0,3,1,1,0,0,6.0,9.0
3189,1970-1971,18,FC Volendam,PSV,0,2,2,0,3,2,-2,5.0,13.0
3190,1970-1971,18,NEC Nijmegen,HFC Haarlem,1,0,1,3,0,1,1,5.0,1.0
3191,1970-1971,18,Go Ahead Eagles,FC Utrecht,2,0,1,3,0,2,2,8.0,6.0
3192,1970-1971,19,FC Twente,SBV Excelsior,5,0,1,3,0,5,5,11.0,2.0
3193,1970-1971,19,AFC Ajax,ADO Den Haag,3,0,1,3,0,3,3,10.0,5.0
3194,1970-1971,19,AZ '67 Alkmaar,Sparta Rotterdam,1,1,3,1,1,2,0,5.0,10.0
3195,1970-1971,19,FC Utrecht,NEC Nijmegen,3,0,1,3,0,3,3,6.0,4.0
3196,1970-1971,19,Feijenoord,Go Ahead Eagles,3,0,1,3,0,3,3,13.0,7.0
3197,1970-1971,19,HFC Haarlem,MVV Maastricht,1,1,3,1,1,2,0,2.0,5.0
3198,1970-1971,19,Holland Sport,DWS Amsterdam,1,1,3,1,1,2,0,3.0,6.0
3199,1970-1971,19,NAC Breda,FC Volendam,2,1,1,3,0,3,1,8.0,4.0
3200,1970-1971,19,PSV,Telstar,2,1,1,3,0,3,1,15.0,5.0
3201,1970-1971,20,SBV Excelsior,PSV,1,4,2,0,3,5,-3,1.0,15.0
3202,1970-1971,20,ADO Den Haag,HFC Haarlem,6,0,1,3,0,6,6,8.0,2.0
3203,1970-1971,20,DWS Amsterdam,AFC Ajax,0,1,2,0,3,1,-1,5.0,10.0
3204,1970-1971,20,Go Ahead Eagles,AZ '67 Alkmaar,2,0,1,3,0,2,2,10.0,2.0
3205,1970-1971,20,MVV Maastricht,FC Utrecht,6,0,1,3,0,6,6,8.0,6.0
3206,1970-1971,20,NEC Nijmegen,Feijenoord,1,0,1,3,0,1,1,7.0,10.0
3207,1970-1971,20,Sparta Rotterdam,FC Twente,2,1,1,3,0,3,1,10.0,8.0
3208,1970-1971,20,Telstar,NAC Breda,2,1,1,3,0,3,1,7.0,5.0
3209,1970-1971,20,FC Volendam,Holland Sport,1,0,1,3,0,1,1,6.0,3.0
3210,1970-1971,21,AFC Ajax,Go Ahead Eagles,5,1,1,3,0,6,4,12.0,7.0
3211,1970-1971,21,AZ '67 Alkmaar,FC Utrecht,1,3,2,0,3,4,-2,2.0,6.0
3212,1970-1971,21,SBV Excelsior,Telstar,1,2,2,0,3,3,-1,1.0,7.0
3213,1970-1971,21,FC Twente,DWS Amsterdam,1,1,3,1,1,2,0,8.0,3.0
3214,1970-1971,21,HFC Haarlem,Feijenoord,0,1,2,0,3,1,-1,2.0,12.0
3215,1970-1971,21,Holland Sport,NEC Nijmegen,1,0,1,3,0,1,1,6.0,6.0
3216,1970-1971,21,NAC Breda,MVV Maastricht,3,1,1,3,0,4,2,7.0,8.0
3217,1970-1971,21,PSV,ADO Den Haag,1,0,1,3,0,1,1,15.0,7.0
3218,1970-1971,21,Sparta Rotterdam,FC Volendam,1,0,1,3,0,1,1,13.0,3.0
3219,1970-1971,22,Feijenoord,MVV Maastricht,1,0,1,3,0,1,1,12.0,7.0
3220,1970-1971,22,PSV,Sparta Rotterdam,0,0,3,1,1,0,0,13.0,11.0
3221,1970-1971,22,AFC Ajax,FC Volendam,4,0,1,3,0,4,4,12.0,3.0
3222,1970-1971,22,AZ '67 Alkmaar,FC Twente,0,2,2,0,3,2,-2,1.0,8.0
3223,1970-1971,22,FC Utrecht,ADO Den Haag,3,1,1,3,0,4,2,9.0,4.0
3224,1970-1971,22,Go Ahead Eagles,NEC Nijmegen,2,2,3,1,1,4,0,7.0,7.0
3225,1970-1971,22,HFC Haarlem,DWS Amsterdam,2,2,3,1,1,4,0,2.0,4.0
3226,1970-1971,22,Holland Sport,Telstar,1,1,3,1,1,2,0,6.0,8.0
3227,1970-1971,22,NAC Breda,SBV Excelsior,1,0,1,3,0,1,1,10.0,0.0
3228,1970-1971,23,ADO Den Haag,Feijenoord,2,0,1,3,0,2,2,6.0,9.0
3229,1970-1971,23,DWS Amsterdam,FC Utrecht,2,2,3,1,1,4,0,4.0,10.0
3230,1970-1971,23,SBV Excelsior,Holland Sport,1,0,1,3,0,1,1,3.0,5.0
3231,1970-1971,23,FC Twente,PSV,2,1,1,3,0,3,1,10.0,10.0
3232,1970-1971,23,MVV Maastricht,Go Ahead Eagles,0,1,2,0,3,1,-1,4.0,7.0
3233,1970-1971,23,NEC Nijmegen,AZ '67 Alkmaar,3,0,1,3,0,3,3,7.0,1.0
3234,1970-1971,23,Sparta Rotterdam,NAC Breda,1,1,3,1,1,2,0,9.0,10.0
3235,1970-1971,23,Telstar,AFC Ajax,0,1,2,0,3,1,-1,7.0,15.0
3236,1970-1971,23,FC Volendam,HFC Haarlem,1,0,1,3,0,1,1,6.0,2.0
3237,1970-1971,24,PSV,NAC Breda,1,1,3,1,1,2,0,8.0,8.0
3238,1970-1971,24,ADO Den Haag,NEC Nijmegen,3,1,1,3,0,4,2,9.0,7.0
3239,1970-1971,24,DWS Amsterdam,Go Ahead Eagles,2,1,1,3,0,3,1,6.0,7.0
3240,1970-1971,24,SBV Excelsior,HFC Haarlem,1,0,1,3,0,1,1,6.0,1.0
3241,1970-1971,24,FC Twente,Holland Sport,3,1,1,3,0,4,2,10.0,4.0
3242,1970-1971,24,MVV Maastricht,AZ '67 Alkmaar,1,0,1,3,0,1,1,6.0,0.0
3243,1970-1971,24,Sparta Rotterdam,AFC Ajax,0,0,3,1,1,0,0,9.0,13.0
3244,1970-1971,24,Telstar,FC Utrecht,3,0,1,3,0,3,3,10.0,7.0
3245,1970-1971,24,FC Volendam,Feijenoord,0,1,2,0,3,1,-1,6.0,9.0
3246,1970-1971,25,AFC Ajax,FC Twente,3,0,1,3,0,3,3,13.0,10.0
3247,1970-1971,25,AZ '67 Alkmaar,NAC Breda,2,1,1,3,0,3,1,3.0,8.0
3248,1970-1971,25,FC Utrecht,SBV Excelsior,1,0,1,3,0,1,1,10.0,6.0
3249,1970-1971,25,Feijenoord,Telstar,4,0,1,3,0,4,4,12.0,7.0
3250,1970-1971,25,Go Ahead Eagles,FC Volendam,0,0,3,1,1,0,0,5.0,4.0
3251,1970-1971,25,HFC Haarlem,Sparta Rotterdam,1,1,3,1,1,2,0,2.0,7.0
3252,1970-1971,25,Holland Sport,PSV,0,5,2,0,3,5,-5,4.0,8.0
3253,1970-1971,25,MVV Maastricht,ADO Den Haag,0,1,2,0,3,1,-1,3.0,9.0
3254,1970-1971,25,NEC Nijmegen,DWS Amsterdam,1,0,1,3,0,1,1,7.0,6.0
3255,1970-1971,26,AFC Ajax,SBV Excelsior,7,0,1,3,0,7,7,13.0,6.0
3256,1970-1971,26,AZ '67 Alkmaar,PSV,0,1,2,0,3,1,-1,3.0,8.0
3257,1970-1971,26,FC Utrecht,FC Volendam,2,2,3,1,1,4,0,8.0,5.0
3258,1970-1971,26,Feijenoord,DWS Amsterdam,3,0,1,3,0,3,3,12.0,5.0
3259,1970-1971,26,Go Ahead Eagles,ADO Den Haag,3,0,1,3,0,3,3,8.0,9.0
3260,1970-1971,26,HFC Haarlem,Telstar,0,1,2,0,3,1,-1,2.0,7.0
3261,1970-1971,26,Holland Sport,Sparta Rotterdam,0,2,2,0,3,2,-2,1.0,7.0
3262,1970-1971,26,NAC Breda,FC Twente,0,1,2,0,3,1,-1,5.0,12.0
3263,1970-1971,26,NEC Nijmegen,MVV Maastricht,3,0,1,3,0,3,3,10.0,3.0
3264,1970-1971,27,SBV Excelsior,Feijenoord,0,4,2,0,3,4,-4,6.0,12.0
3265,1970-1971,27,ADO Den Haag,AZ '67 Alkmaar,3,0,1,3,0,3,3,12.0,3.0
3266,1970-1971,27,DWS Amsterdam,MVV Maastricht,1,0,1,3,0,1,1,7.0,3.0
3267,1970-1971,27,FC Twente,HFC Haarlem,2,0,1,3,0,2,2,12.0,1.0
3268,1970-1971,27,NAC Breda,Holland Sport,3,4,2,0,3,7,-1,2.0,3.0
3269,1970-1971,27,PSV,AFC Ajax,0,3,2,0,3,3,-3,7.0,13.0
3270,1970-1971,27,Sparta Rotterdam,FC Utrecht,3,1,1,3,0,4,2,9.0,5.0
3271,1970-1971,27,Telstar,Go Ahead Eagles,0,1,2,0,3,1,-1,6.0,10.0
3272,1970-1971,27,FC Volendam,NEC Nijmegen,1,0,1,3,0,1,1,8.0,9.0
3273,1970-1971,28,ADO Den Haag,DWS Amsterdam,4,0,1,3,0,4,4,12.0,6.0
3274,1970-1971,28,AZ '67 Alkmaar,Holland Sport,3,3,3,1,1,6,0,4.0,4.0
3275,1970-1971,28,FC Utrecht,FC Twente,1,2,2,0,3,3,-1,4.0,12.0
3276,1970-1971,28,Feijenoord,Sparta Rotterdam,4,1,1,3,0,5,3,15.0,8.0
3277,1970-1971,28,Go Ahead Eagles,SBV Excelsior,3,0,1,3,0,3,3,10.0,3.0
3278,1970-1971,28,HFC Haarlem,PSV,1,3,2,0,3,4,-2,1.0,10.0
3279,1970-1971,28,MVV Maastricht,FC Volendam,0,0,3,1,1,0,0,4.0,6.0
3280,1970-1971,28,NEC Nijmegen,Telstar,3,0,1,3,0,3,3,9.0,6.0
3281,1970-1971,28,AFC Ajax,NAC Breda,3,0,1,3,0,3,3,13.0,1.0
3282,1970-1971,29,DWS Amsterdam,AZ '67 Alkmaar,0,0,3,1,1,0,0,4.0,5.0
3283,1970-1971,29,SBV Excelsior,NEC Nijmegen,2,1,1,3,0,3,1,3.0,9.0
3284,1970-1971,29,FC Twente,Feijenoord,1,2,2,0,3,3,-1,9.0,15.0
3285,1970-1971,29,Holland Sport,AFC Ajax,0,3,2,0,3,3,-3,4.0,15.0
3286,1970-1971,29,NAC Breda,HFC Haarlem,2,0,1,3,0,2,2,3.0,1.0
3287,1970-1971,29,PSV,FC Utrecht,4,1,1,3,0,5,3,12.0,4.0
3288,1970-1971,29,Sparta Rotterdam,Go Ahead Eagles,1,2,2,0,3,3,-1,7.0,13.0
3289,1970-1971,29,Telstar,MVV Maastricht,0,1,2,0,3,1,-1,3.0,4.0
3290,1970-1971,29,FC Volendam,ADO Den Haag,2,3,2,0,3,5,-1,6.0,12.0
3291,1970-1971,30,ADO Den Haag,Telstar,1,0,1,3,0,1,1,12.0,3.0
3292,1970-1971,30,AZ '67 Alkmaar,AFC Ajax,0,3,2,0,3,3,-3,2.0,15.0
3293,1970-1971,30,DWS Amsterdam,FC Volendam,2,2,3,1,1,4,0,5.0,6.0
3294,1970-1971,30,FC Utrecht,NAC Breda,0,0,3,1,1,0,0,2.0,4.0
3295,1970-1971,30,Feijenoord,PSV,2,1,1,3,0,3,1,15.0,9.0
3296,1970-1971,30,Go Ahead Eagles,FC Twente,1,0,1,3,0,1,1,15.0,9.0
3297,1970-1971,30,HFC Haarlem,Holland Sport,1,1,3,1,1,2,0,1.0,5.0
3298,1970-1971,30,MVV Maastricht,SBV Excelsior,0,0,3,1,1,0,0,5.0,4.0
3299,1970-1971,30,NEC Nijmegen,Sparta Rotterdam,3,0,1,3,0,3,3,9.0,6.0
3300,1970-1971,31,AFC Ajax,HFC Haarlem,4,0,1,3,0,4,4,15.0,1.0
3301,1970-1971,31,SBV Excelsior,ADO Den Haag,1,1,3,1,1,2,0,5.0,13.0
3302,1970-1971,31,FC Twente,NEC Nijmegen,2,0,1,3,0,2,2,9.0,6.0
3303,1970-1971,31,Holland Sport,FC Utrecht,1,1,3,1,1,2,0,6.0,2.0
3304,1970-1971,31,NAC Breda,Feijenoord,1,3,2,0,3,4,-2,4.0,15.0
3305,1970-1971,31,PSV,Go Ahead Eagles,2,1,1,3,0,3,1,9.0,12.0
3306,1970-1971,31,Sparta Rotterdam,MVV Maastricht,0,0,3,1,1,0,0,4.0,6.0
3307,1970-1971,31,Telstar,DWS Amsterdam,1,1,3,1,1,2,0,1.0,6.0
3308,1970-1971,31,FC Volendam,AZ '67 Alkmaar,1,0,1,3,0,1,1,8.0,2.0
3309,1970-1971,32,Feijenoord,Holland Sport,6,1,1,3,0,7,5,15.0,3.0
3310,1970-1971,32,ADO Den Haag,Sparta Rotterdam,2,1,1,3,0,3,1,13.0,1.0
3311,1970-1971,32,AZ '67 Alkmaar,HFC Haarlem,4,0,1,3,0,4,4,5.0,1.0
3312,1970-1971,32,DWS Amsterdam,SBV Excelsior,0,0,3,1,1,0,0,4.0,6.0
3313,1970-1971,32,Go Ahead Eagles,NAC Breda,4,3,1,3,0,7,1,12.0,4.0
3314,1970-1971,32,MVV Maastricht,FC Twente,0,2,2,0,3,2,-2,6.0,9.0
3315,1970-1971,32,NEC Nijmegen,PSV,0,0,3,1,1,0,0,7.0,10.0
3316,1970-1971,32,FC Volendam,Telstar,2,0,1,3,0,2,2,8.0,1.0
3317,1970-1971,32,FC Utrecht,AFC Ajax,0,3,2,0,3,3,-3,2.0,15.0
3318,1970-1971,33,AFC Ajax,Feijenoord,1,3,2,0,3,4,-2,12.0,15.0
3319,1970-1971,33,AZ '67 Alkmaar,Telstar,0,1,2,0,3,1,-1,4.0,4.0
3320,1970-1971,33,SBV Excelsior,FC Volendam,0,0,3,1,1,0,0,7.0,8.0
3321,1970-1971,33,FC Twente,ADO Den Haag,0,0,3,1,1,0,0,7.0,11.0
3322,1970-1971,33,HFC Haarlem,FC Utrecht,1,1,3,1,1,2,0,2.0,3.0
3323,1970-1971,33,Holland Sport,Go Ahead Eagles,2,2,3,1,1,4,0,3.0,10.0
3324,1970-1971,33,NAC Breda,NEC Nijmegen,1,1,3,1,1,2,0,5.0,5.0
3325,1970-1971,33,PSV,MVV Maastricht,2,0,1,3,0,2,2,10.0,5.0
3326,1970-1971,33,Sparta Rotterdam,DWS Amsterdam,6,1,1,3,0,7,5,4.0,4.0
3327,1970-1971,34,Go Ahead Eagles,AFC Ajax,4,1,1,3,0,5,3,10.0,9.0
3328,1970-1971,34,NEC Nijmegen,Holland Sport,1,1,3,1,1,2,0,6.0,4.0
3329,1970-1971,34,ADO Den Haag,PSV,1,1,3,1,1,2,0,9.0,8.0
3330,1970-1971,34,DWS Amsterdam,FC Twente,0,0,3,1,1,0,0,4.0,8.0
3331,1970-1971,34,FC Utrecht,AZ '67 Alkmaar,2,0,1,3,0,2,2,6.0,3.0
3332,1970-1971,34,Feijenoord,HFC Haarlem,2,1,1,3,0,3,1,15.0,2.0
3333,1970-1971,34,MVV Maastricht,NAC Breda,3,1,1,3,0,4,2,5.0,2.0
3334,1970-1971,34,Telstar,SBV Excelsior,1,0,1,3,0,1,1,7.0,4.0
3335,1970-1971,34,FC Volendam,Sparta Rotterdam,2,2,3,1,1,4,0,9.0,5.0
3336,1971-1972,1,DWS Amsterdam,Vitesse,1,0,1,3,0,1,1,6.0,
3337,1971-1972,1,SBV Excelsior,Telstar,0,1,2,0,3,1,-1,3.0,10.0
3338,1971-1972,1,FC Den Haag-ADO,FC Den Bosch '67,2,1,1,3,0,3,1,,
3339,1971-1972,1,FC Groningen,FC Utrecht,0,1,2,0,3,1,-1,,8.0
3340,1971-1972,1,FC Twente,AFC Ajax,0,2,2,0,3,2,-2,8.0,9.0
3341,1971-1972,1,NAC Breda,Feijenoord,1,2,2,0,3,3,-1,1.0,15.0
3342,1971-1972,1,NEC Nijmegen,Go Ahead Eagles,3,0,1,3,0,3,3,6.0,7.0
3343,1971-1972,1,PSV,MVV Maastricht,0,1,2,0,3,1,-1,8.0,7.0
3344,1971-1972,1,Sparta Rotterdam,FC Volendam,4,1,1,3,0,5,3,8.0,8.0
3345,1971-1972,2,AFC Ajax,FC Den Haag-ADO,1,0,1,3,0,1,1,9.0,
3346,1971-1972,2,FC Den Bosch '67,Sparta Rotterdam,0,3,2,0,3,3,-3,,10.0
3347,1971-1972,2,FC Utrecht,NAC Breda,1,2,2,0,3,3,-1,7.0,4.0
3348,1971-1972,2,Feijenoord,PSV,1,0,1,3,0,1,1,15.0,5.0
3349,1971-1972,2,Go Ahead Eagles,DWS Amsterdam,0,1,2,0,3,1,-1,7.0,8.0
3350,1971-1972,2,MVV Maastricht,NEC Nijmegen,0,1,2,0,3,1,-1,6.0,9.0
3351,1971-1972,2,Telstar,FC Groningen,0,0,3,1,1,0,0,10.0,
3352,1971-1972,2,Vitesse,FC Twente,0,1,2,0,3,1,-1,,8.0
3353,1971-1972,2,FC Volendam,SBV Excelsior,1,0,1,3,0,1,1,8.0,2.0
3354,1971-1972,3,DWS Amsterdam,MVV Maastricht,2,3,2,0,3,5,-1,7.0,9.0
3355,1971-1972,3,SBV Excelsior,FC Den Bosch '67,0,0,3,1,1,0,0,2.0,
3356,1971-1972,3,FC Den Haag-ADO,FC Twente,0,0,3,1,1,0,0,,6.0
3357,1971-1972,3,FC Groningen,FC Volendam,1,1,3,1,1,2,0,,6.0
3358,1971-1972,3,Go Ahead Eagles,Vitesse,5,1,1,3,0,6,4,7.0,
3359,1971-1972,3,NAC Breda,Telstar,1,1,3,1,1,2,0,5.0,11.0
3360,1971-1972,3,NEC Nijmegen,Feijenoord,1,2,2,0,3,3,-1,8.0,15.0
3361,1971-1972,3,PSV,FC Utrecht,1,0,1,3,0,1,1,7.0,7.0
3362,1971-1972,3,Sparta Rotterdam,AFC Ajax,1,1,3,1,1,2,0,11.0,7.0
3363,1971-1972,4,AFC Ajax,SBV Excelsior,1,0,1,3,0,1,1,10.0,1.0
3364,1971-1972,4,FC Den Bosch '67,FC Groningen,1,1,3,1,1,2,0,,
3365,1971-1972,4,FC Twente,Sparta Rotterdam,1,0,1,3,0,1,1,8.0,8.0
3366,1971-1972,4,FC Utrecht,NEC Nijmegen,3,1,1,3,0,4,2,9.0,7.0
3367,1971-1972,4,Feijenoord,DWS Amsterdam,4,0,1,3,0,4,4,15.0,7.0
3368,1971-1972,4,MVV Maastricht,Go Ahead Eagles,3,1,1,3,0,4,2,12.0,6.0
3369,1971-1972,4,Telstar,PSV,2,1,1,3,0,3,1,11.0,4.0
3370,1971-1972,4,Vitesse,FC Den Haag-ADO,0,2,2,0,3,2,-2,,
3371,1971-1972,4,FC Volendam,NAC Breda,1,1,3,1,1,2,0,6.0,5.0
3372,1971-1972,5,FC Groningen,AFC Ajax,0,0,3,1,1,0,0,4.0,11.0
3373,1971-1972,5,Go Ahead Eagles,Feijenoord,0,1,2,0,3,1,-1,3.0,15.0
3374,1971-1972,5,PSV,FC Volendam,4,0,1,3,0,4,4,6.0,5.0
3375,1971-1972,5,DWS Amsterdam,FC Utrecht,2,0,1,3,0,2,2,9.0,6.0
3376,1971-1972,5,SBV Excelsior,FC Twente,0,0,3,1,1,0,0,2.0,8.0
3377,1971-1972,5,MVV Maastricht,Vitesse,0,0,3,1,1,0,0,10.0,1.0
3378,1971-1972,5,NAC Breda,FC Den Bosch '67,1,0,1,3,0,1,1,8.0,2.0
3379,1971-1972,5,NEC Nijmegen,Telstar,2,1,1,3,0,3,1,9.0,8.0
3380,1971-1972,5,Sparta Rotterdam,FC Den Haag-ADO,5,2,1,3,0,7,3,10.0,7.0
3381,1971-1972,6,AFC Ajax,NAC Breda,5,0,1,3,0,5,5,11.0,8.0
3382,1971-1972,6,FC Den Bosch '67,PSV,0,7,2,0,3,7,-7,2.0,9.0
3383,1971-1972,6,FC Den Haag-ADO,SBV Excelsior,3,0,1,3,0,3,3,7.0,2.0
3384,1971-1972,6,FC Twente,FC Groningen,4,2,1,3,0,6,2,11.0,4.0
3385,1971-1972,6,FC Utrecht,Go Ahead Eagles,3,3,3,1,1,6,0,4.0,4.0
3386,1971-1972,6,Feijenoord,MVV Maastricht,2,0,1,3,0,2,2,15.0,7.0
3387,1971-1972,6,Telstar,DWS Amsterdam,1,1,3,1,1,2,0,6.0,7.0
3388,1971-1972,6,Vitesse,Sparta Rotterdam,0,6,2,0,3,6,-6,1.0,10.0
3389,1971-1972,6,FC Volendam,NEC Nijmegen,0,1,2,0,3,1,-1,5.0,9.0
3390,1971-1972,7,PSV,AFC Ajax,1,1,3,1,1,2,0,10.0,9.0
3391,1971-1972,7,DWS Amsterdam,FC Volendam,1,0,1,3,0,1,1,7.0,2.0
3392,1971-1972,7,SBV Excelsior,Sparta Rotterdam,0,0,3,1,1,0,0,3.0,8.0
3393,1971-1972,7,FC Groningen,FC Den Haag-ADO,1,2,2,0,3,3,-1,3.0,10.0
3394,1971-1972,7,Feijenoord,Vitesse,4,0,1,3,0,4,4,15.0,1.0
3395,1971-1972,7,Go Ahead Eagles,Telstar,5,0,1,3,0,5,5,7.0,5.0
3396,1971-1972,7,MVV Maastricht,FC Utrecht,0,1,2,0,3,1,-1,7.0,7.0
3397,1971-1972,7,NAC Breda,FC Twente,0,0,3,1,1,0,0,6.0,9.0
3398,1971-1972,7,NEC Nijmegen,FC Den Bosch '67,1,0,1,3,0,1,1,9.0,2.0
3399,1971-1972,8,AFC Ajax,NEC Nijmegen,1,0,1,3,0,1,1,11.0,9.0
3400,1971-1972,8,FC Den Bosch '67,DWS Amsterdam,0,0,3,1,1,0,0,2.0,8.0
3401,1971-1972,8,FC Den Haag-ADO,NAC Breda,2,1,1,3,0,3,1,12.0,5.0
3402,1971-1972,8,FC Twente,PSV,2,0,1,3,0,2,2,11.0,7.0
3403,1971-1972,8,FC Utrecht,Feijenoord,0,0,3,1,1,0,0,8.0,13.0
3404,1971-1972,8,Sparta Rotterdam,FC Groningen,3,3,3,1,1,6,0,8.0,3.0
3405,1971-1972,8,Telstar,MVV Maastricht,1,0,1,3,0,1,1,7.0,4.0
3406,1971-1972,8,Vitesse,SBV Excelsior,1,0,1,3,0,1,1,4.0,2.0
3407,1971-1972,8,FC Volendam,Go Ahead Eagles,0,0,3,1,1,0,0,2.0,5.0
3408,1971-1972,9,DWS Amsterdam,AFC Ajax,0,2,2,0,3,2,-2,8.0,11.0
3409,1971-1972,9,Go Ahead Eagles,FC Den Bosch '67,1,0,1,3,0,1,1,8.0,1.0
3410,1971-1972,9,PSV,FC Den Haag-ADO,0,1,2,0,3,1,-1,7.0,12.0
3411,1971-1972,9,FC Groningen,SBV Excelsior,2,3,2,0,3,5,-1,2.0,5.0
3412,1971-1972,9,FC Utrecht,Vitesse,5,1,1,3,0,6,4,8.0,4.0
3413,1971-1972,9,Feijenoord,Telstar,2,0,1,3,0,2,2,13.0,4.0
3414,1971-1972,9,MVV Maastricht,FC Volendam,1,0,1,3,0,1,1,4.0,1.0
3415,1971-1972,9,NAC Breda,Sparta Rotterdam,3,3,3,1,1,6,0,5.0,9.0
3416,1971-1972,9,NEC Nijmegen,FC Twente,0,2,2,0,3,2,-2,9.0,11.0
3417,1971-1972,10,AFC Ajax,Go Ahead Eagles,4,1,1,3,0,5,3,13.0,8.0
3418,1971-1972,10,SBV Excelsior,NAC Breda,1,1,3,1,1,2,0,5.0,3.0
3419,1971-1972,10,FC Den Bosch '67,MVV Maastricht,2,3,2,0,3,5,-1,1.0,6.0
3420,1971-1972,10,FC Den Haag-ADO,NEC Nijmegen,4,0,1,3,0,4,4,15.0,6.0
3421,1971-1972,10,FC Twente,DWS Amsterdam,0,0,3,1,1,0,0,11.0,6.0
3422,1971-1972,10,Sparta Rotterdam,PSV,1,1,3,1,1,2,0,7.0,5.0
3423,1971-1972,10,Telstar,FC Utrecht,0,2,2,0,3,2,-2,4.0,11.0
3424,1971-1972,10,Vitesse,FC Groningen,1,2,2,0,3,3,-1,3.0,4.0
3425,1971-1972,10,FC Volendam,Feijenoord,0,3,2,0,3,3,-3,1.0,13.0
3426,1971-1972,11,Feijenoord,FC Den Bosch '67,5,0,1,3,0,5,5,13.0,1.0
3427,1971-1972,11,PSV,SBV Excelsior,1,2,2,0,3,3,-1,2.0,8.0
3428,1971-1972,11,DWS Amsterdam,FC Den Haag-ADO,0,1,2,0,3,1,-1,5.0,15.0
3429,1971-1972,11,FC Utrecht,FC Volendam,2,1,1,3,0,3,1,13.0,1.0
3430,1971-1972,11,Go Ahead Eagles,FC Twente,1,4,2,0,3,5,-3,7.0,11.0
3431,1971-1972,11,MVV Maastricht,AFC Ajax,0,3,2,0,3,3,-3,6.0,13.0
3432,1971-1972,11,NAC Breda,FC Groningen,2,1,1,3,0,3,1,6.0,4.0
3433,1971-1972,11,NEC Nijmegen,Sparta Rotterdam,1,2,2,0,3,3,-1,3.0,7.0
3434,1971-1972,11,Telstar,Vitesse,2,0,1,3,0,2,2,6.0,3.0
3435,1971-1972,12,AFC Ajax,Feijenoord,2,1,1,3,0,3,1,15.0,10.0
3436,1971-1972,12,SBV Excelsior,NEC Nijmegen,2,1,1,3,0,3,1,10.0,0.0
3437,1971-1972,12,FC Den Bosch '67,FC Utrecht,1,4,2,0,3,5,-3,1.0,13.0
3438,1971-1972,12,FC Den Haag-ADO,Go Ahead Eagles,2,0,1,3,0,2,2,15.0,4.0
3439,1971-1972,12,FC Groningen,PSV,1,1,3,1,1,2,0,5.0,2.0
3440,1971-1972,12,FC Twente,MVV Maastricht,2,0,1,3,0,2,2,13.0,6.0
3441,1971-1972,12,Sparta Rotterdam,DWS Amsterdam,3,1,1,3,0,4,2,9.0,2.0
3442,1971-1972,12,Vitesse,NAC Breda,1,2,2,0,3,3,-1,3.0,8.0
3443,1971-1972,12,FC Volendam,Telstar,1,5,2,0,3,6,-4,1.0,9.0
3444,1971-1972,13,DWS Amsterdam,SBV Excelsior,1,0,1,3,0,1,1,4.0,10.0
3445,1971-1972,13,FC Utrecht,AFC Ajax,2,3,2,0,3,5,-1,12.0,15.0
3446,1971-1972,13,Feijenoord,FC Twente,0,1,2,0,3,1,-1,9.0,13.0
3447,1971-1972,13,Go Ahead Eagles,Sparta Rotterdam,1,1,3,1,1,2,0,4.0,9.0
3448,1971-1972,13,MVV Maastricht,FC Den Haag-ADO,2,0,1,3,0,2,2,9.0,12.0
3449,1971-1972,13,NEC Nijmegen,FC Groningen,0,0,3,1,1,0,0,1.0,5.0
3450,1971-1972,13,PSV,NAC Breda,2,2,3,1,1,4,0,3.0,9.0
3451,1971-1972,13,Telstar,FC Den Bosch '67,1,0,1,3,0,1,1,9.0,0.0
3452,1971-1972,13,FC Volendam,Vitesse,0,0,3,1,1,0,0,1.0,1.0
3453,1971-1972,14,AFC Ajax,Telstar,5,2,1,3,0,7,3,15.0,9.0
3454,1971-1972,14,SBV Excelsior,Go Ahead Eagles,0,2,2,0,3,2,-2,7.0,4.0
3455,1971-1972,14,FC Den Haag-ADO,Feijenoord,1,2,2,0,3,3,-1,9.0,9.0
3456,1971-1972,14,FC Groningen,DWS Amsterdam,4,0,1,3,0,4,4,8.0,4.0
3457,1971-1972,14,FC Twente,FC Utrecht,0,1,2,0,3,1,-1,10.0,12.0
3458,1971-1972,14,Sparta Rotterdam,MVV Maastricht,3,0,1,3,0,3,3,11.0,6.0
3459,1971-1972,14,Vitesse,PSV,1,1,3,1,1,2,0,2.0,4.0
3460,1971-1972,14,FC Den Bosch '67,FC Volendam,0,1,2,0,3,1,-1,0.0,4.0
3461,1971-1972,14,NAC Breda,NEC Nijmegen,1,1,3,1,1,2,0,9.0,2.0
3462,1971-1972,15,DWS Amsterdam,NAC Breda,2,4,2,0,3,6,-2,3.0,11.0
3463,1971-1972,15,FC Den Bosch '67,Vitesse,2,1,1,3,0,3,1,3.0,2.0
3464,1971-1972,15,FC Utrecht,FC Den Haag-ADO,1,1,3,1,1,2,0,10.0,7.0
3465,1971-1972,15,Feijenoord,Sparta Rotterdam,2,0,1,3,0,2,2,9.0,10.0
3466,1971-1972,15,Go Ahead Eagles,FC Groningen,2,1,1,3,0,3,1,7.0,5.0
3467,1971-1972,15,MVV Maastricht,SBV Excelsior,3,0,1,3,0,3,3,6.0,6.0
3468,1971-1972,15,NEC Nijmegen,PSV,1,0,1,3,0,1,1,5.0,3.0
3469,1971-1972,15,Telstar,FC Twente,0,2,2,0,3,2,-2,9.0,12.0
3470,1971-1972,15,FC Volendam,AFC Ajax,0,1,2,0,3,1,-1,4.0,15.0
3471,1971-1972,16,SBV Excelsior,Feijenoord,0,1,2,0,3,1,-1,3.0,9.0
3472,1971-1972,16,AFC Ajax,FC Den Bosch '67,5,0,1,3,0,5,5,15.0,3.0
3473,1971-1972,16,FC Den Haag-ADO,Telstar,2,2,3,1,1,4,0,5.0,7.0
3474,1971-1972,16,FC Groningen,MVV Maastricht,1,0,1,3,0,1,1,8.0,6.0
3475,1971-1972,16,FC Twente,FC Volendam,4,0,1,3,0,4,4,12.0,4.0
3476,1971-1972,16,NAC Breda,Go Ahead Eagles,0,1,2,0,3,1,-1,8.0,10.0
3477,1971-1972,16,NEC Nijmegen,Vitesse,2,0,1,3,0,2,2,8.0,2.0
3478,1971-1972,16,PSV,DWS Amsterdam,1,0,1,3,0,1,1,6.0,3.0
3479,1971-1972,16,Sparta Rotterdam,FC Utrecht,2,1,1,3,0,3,1,10.0,7.0
3480,1971-1972,17,DWS Amsterdam,NEC Nijmegen,2,3,2,0,3,5,-1,3.0,11.0
3481,1971-1972,17,FC Den Bosch '67,FC Twente,0,0,3,1,1,0,0,4.0,10.0
3482,1971-1972,17,FC Utrecht,SBV Excelsior,6,1,1,3,0,7,5,7.0,0.0
3483,1971-1972,17,Feijenoord,FC Groningen,4,1,1,3,0,5,3,12.0,7.0
3484,1971-1972,17,Go Ahead Eagles,PSV,3,1,1,3,0,4,2,13.0,5.0
3485,1971-1972,17,MVV Maastricht,NAC Breda,2,1,1,3,0,3,1,9.0,5.0
3486,1971-1972,17,Telstar,Sparta Rotterdam,1,2,2,0,3,3,-1,4.0,10.0
3487,1971-1972,17,Vitesse,AFC Ajax,1,3,2,0,3,4,-2,2.0,15.0
3488,1971-1972,17,FC Volendam,FC Den Haag-ADO,0,0,3,1,1,0,0,5.0,3.0
3489,1971-1972,18,AFC Ajax,FC Twente,1,0,1,3,0,1,1,15.0,7.0
3490,1971-1972,18,FC Den Bosch '67,FC Den Haag-ADO,2,3,2,0,3,5,-1,4.0,6.0
3491,1971-1972,18,FC Utrecht,FC Groningen,2,2,3,1,1,4,0,8.0,7.0
3492,1971-1972,18,Feijenoord,NAC Breda,3,1,1,3,0,4,2,15.0,4.0
3493,1971-1972,18,Go Ahead Eagles,NEC Nijmegen,2,2,3,1,1,4,0,13.0,11.0
3494,1971-1972,18,MVV Maastricht,PSV,1,1,3,1,1,2,0,7.0,5.0
3495,1971-1972,18,Telstar,SBV Excelsior,1,1,3,1,1,2,0,2.0,1.0
3496,1971-1972,18,Vitesse,DWS Amsterdam,3,2,1,3,0,5,1,4.0,0.0
3497,1971-1972,18,FC Volendam,Sparta Rotterdam,1,2,2,0,3,3,-1,4.0,12.0
3498,1971-1972,19,DWS Amsterdam,Go Ahead Eagles,1,1,3,1,1,2,0,1.0,11.0
3499,1971-1972,19,SBV Excelsior,FC Volendam,1,0,1,3,0,1,1,4.0,1.0
3500,1971-1972,19,FC Den Haag-ADO,AFC Ajax,1,2,2,0,3,3,-1,6.0,15.0
3501,1971-1972,19,FC Groningen,Telstar,1,1,3,1,1,2,0,5.0,3.0
3502,1971-1972,19,FC Twente,Vitesse,0,0,3,1,1,0,0,8.0,4.0
3503,1971-1972,19,NAC Breda,FC Utrecht,1,2,2,0,3,3,-1,3.0,8.0
3504,1971-1972,19,NEC Nijmegen,MVV Maastricht,0,0,3,1,1,0,0,11.0,8.0
3505,1971-1972,19,PSV,Feijenoord,2,0,1,3,0,2,2,7.0,12.0
3506,1971-1972,19,Sparta Rotterdam,FC Den Bosch '67,0,0,3,1,1,0,0,10.0,5.0
3507,1971-1972,20,AFC Ajax,Sparta Rotterdam,2,1,1,3,0,3,1,15.0,10.0
3508,1971-1972,20,FC Den Bosch '67,SBV Excelsior,0,0,3,1,1,0,0,3.0,5.0
3509,1971-1972,20,FC Twente,FC Den Haag-ADO,0,0,3,1,1,0,0,6.0,6.0
3510,1971-1972,20,FC Utrecht,PSV,1,0,1,3,0,1,1,10.0,7.0
3511,1971-1972,20,Feijenoord,NEC Nijmegen,5,1,1,3,0,6,4,12.0,8.0
3512,1971-1972,20,MVV Maastricht,DWS Amsterdam,2,0,1,3,0,2,2,8.0,1.0
3513,1971-1972,20,Telstar,NAC Breda,2,2,3,1,1,4,0,4.0,1.0
3514,1971-1972,20,Vitesse,Go Ahead Eagles,1,3,2,0,3,4,-2,4.0,11.0
3515,1971-1972,20,FC Volendam,FC Groningen,0,2,2,0,3,2,-2,1.0,8.0
3516,1971-1972,21,DWS Amsterdam,Telstar,0,1,2,0,3,1,-1,1.0,6.0
3517,1971-1972,21,SBV Excelsior,FC Den Haag-ADO,1,1,3,1,1,2,0,6.0,6.0
3518,1971-1972,21,Go Ahead Eagles,FC Utrecht,1,1,3,1,1,2,0,9.0,11.0
3519,1971-1972,21,MVV Maastricht,Feijenoord,0,2,2,0,3,2,-2,8.0,12.0
3520,1971-1972,21,NAC Breda,AFC Ajax,2,5,2,0,3,7,-3,1.0,15.0
3521,1971-1972,21,NEC Nijmegen,FC Volendam,2,0,1,3,0,2,2,8.0,1.0
3522,1971-1972,21,PSV,FC Den Bosch '67,2,0,1,3,0,2,2,7.0,3.0
3523,1971-1972,21,Sparta Rotterdam,Vitesse,4,0,1,3,0,4,4,10.0,4.0
3524,1971-1972,21,FC Groningen,FC Twente,0,1,2,0,3,1,-1,5.0,6.0
3525,1971-1972,22,SBV Excelsior,AFC Ajax,0,4,2,0,3,4,-4,6.0,15.0
3526,1971-1972,22,DWS Amsterdam,Feijenoord,0,2,2,0,3,2,-2,1.0,12.0
3527,1971-1972,22,FC Den Haag-ADO,Vitesse,4,0,1,3,0,4,4,8.0,4.0
3528,1971-1972,22,FC Groningen,FC Den Bosch '67,1,0,1,3,0,1,1,8.0,2.0
3529,1971-1972,22,Go Ahead Eagles,MVV Maastricht,1,1,3,1,1,2,0,7.0,6.0
3530,1971-1972,22,NAC Breda,FC Volendam,2,0,1,3,0,2,2,4.0,0.0
3531,1971-1972,22,NEC Nijmegen,FC Utrecht,3,1,1,3,0,4,2,8.0,8.0
3532,1971-1972,22,PSV,Telstar,3,0,1,3,0,3,3,10.0,6.0
3533,1971-1972,22,Sparta Rotterdam,FC Twente,1,1,3,1,1,2,0,8.0,6.0
3534,1971-1972,23,AFC Ajax,FC Groningen,7,0,1,3,0,7,7,15.0,7.0
3535,1971-1972,23,Feijenoord,Go Ahead Eagles,1,0,1,3,0,1,1,12.0,6.0
3536,1971-1972,23,FC Den Bosch '67,NAC Breda,3,2,1,3,0,5,1,5.0,4.0
3537,1971-1972,23,FC Den Haag-ADO,Sparta Rotterdam,1,1,3,1,1,2,0,6.0,6.0
3538,1971-1972,23,FC Twente,SBV Excelsior,3,0,1,3,0,3,3,9.0,5.0
3539,1971-1972,23,FC Utrecht,DWS Amsterdam,1,0,1,3,0,1,1,10.0,1.0
3540,1971-1972,23,Telstar,NEC Nijmegen,2,2,3,1,1,4,0,6.0,8.0
3541,1971-1972,23,Vitesse,MVV Maastricht,1,1,3,1,1,2,0,2.0,6.0
3542,1971-1972,23,FC Volendam,PSV,1,1,3,1,1,2,0,1.0,10.0
3543,1971-1972,24,AFC Ajax,PSV,4,1,1,3,0,5,3,15.0,7.0
3544,1971-1972,24,FC Den Bosch '67,NEC Nijmegen,1,1,3,1,1,2,0,5.0,8.0
3545,1971-1972,24,FC Den Haag-ADO,FC Groningen,5,0,1,3,0,5,5,9.0,6.0
3546,1971-1972,24,FC Twente,NAC Breda,5,1,1,3,0,6,4,11.0,4.0
3547,1971-1972,24,FC Utrecht,MVV Maastricht,1,0,1,3,0,1,1,10.0,5.0
3548,1971-1972,24,Sparta Rotterdam,SBV Excelsior,5,1,1,3,0,6,4,8.0,2.0
3549,1971-1972,24,Telstar,Go Ahead Eagles,1,1,3,1,1,2,0,6.0,6.0
3550,1971-1972,24,Vitesse,Feijenoord,0,2,2,0,3,2,-2,1.0,15.0
3551,1971-1972,24,FC Volendam,DWS Amsterdam,3,0,1,3,0,3,3,4.0,0.0
3552,1971-1972,25,Feijenoord,FC Utrecht,0,0,3,1,1,0,0,13.0,8.0
3553,1971-1972,25,DWS Amsterdam,FC Den Bosch '67,2,3,2,0,3,5,-1,0.0,7.0
3554,1971-1972,25,SBV Excelsior,Vitesse,0,0,3,1,1,0,0,2.0,2.0
3555,1971-1972,25,FC Groningen,Sparta Rotterdam,1,0,1,3,0,1,1,6.0,8.0
3556,1971-1972,25,Go Ahead Eagles,FC Volendam,3,0,1,3,0,3,3,6.0,4.0
3557,1971-1972,25,MVV Maastricht,Telstar,1,2,2,0,3,3,-1,2.0,8.0
3558,1971-1972,25,NAC Breda,FC Den Haag-ADO,0,2,2,0,3,2,-2,3.0,11.0
3559,1971-1972,25,NEC Nijmegen,AFC Ajax,0,1,2,0,3,1,-1,8.0,15.0
3560,1971-1972,25,PSV,FC Twente,0,0,3,1,1,0,0,8.0,11.0
3561,1971-1972,26,AFC Ajax,DWS Amsterdam,2,0,1,3,0,2,2,15.0,0.0
3562,1971-1972,26,SBV Excelsior,FC Groningen,1,1,3,1,1,2,0,2.0,7.0
3563,1971-1972,26,FC Den Bosch '67,Go Ahead Eagles,2,1,1,3,0,3,1,10.0,5.0
3564,1971-1972,26,FC Den Haag-ADO,PSV,1,1,3,1,1,2,0,11.0,6.0
3565,1971-1972,26,FC Twente,NEC Nijmegen,1,1,3,1,1,2,0,9.0,6.0
3566,1971-1972,26,Sparta Rotterdam,NAC Breda,4,1,1,3,0,5,3,8.0,3.0
3567,1971-1972,26,Telstar,Feijenoord,1,3,2,0,3,4,-2,5.0,13.0
3568,1971-1972,26,Vitesse,FC Utrecht,1,0,1,3,0,1,1,5.0,7.0
3569,1971-1972,26,FC Volendam,MVV Maastricht,1,0,1,3,0,1,1,7.0,2.0
3570,1971-1972,27,Go Ahead Eagles,AFC Ajax,3,2,1,3,0,5,1,7.0,12.0
3571,1971-1972,27,DWS Amsterdam,FC Twente,1,1,3,1,1,2,0,1.0,9.0
3572,1971-1972,27,FC Groningen,Vitesse,1,0,1,3,0,1,1,7.0,5.0
3573,1971-1972,27,FC Utrecht,Telstar,1,1,3,1,1,2,0,8.0,6.0
3574,1971-1972,27,Feijenoord,FC Volendam,2,0,1,3,0,2,2,13.0,7.0
3575,1971-1972,27,MVV Maastricht,FC Den Bosch '67,1,1,3,1,1,2,0,2.0,11.0
3576,1971-1972,27,NAC Breda,SBV Excelsior,0,0,3,1,1,0,0,1.0,3.0
3577,1971-1972,27,NEC Nijmegen,FC Den Haag-ADO,1,0,1,3,0,1,1,6.0,8.0
3578,1971-1972,27,PSV,Sparta Rotterdam,0,1,2,0,3,1,-1,3.0,10.0
3579,1971-1972,28,AFC Ajax,MVV Maastricht,8,0,1,3,0,8,8,12.0,1.0
3580,1971-1972,28,SBV Excelsior,PSV,0,3,2,0,3,3,-3,3.0,5.0
3581,1971-1972,28,FC Den Bosch '67,Feijenoord,0,5,2,0,3,5,-5,8.0,13.0
3582,1971-1972,28,FC Den Haag-ADO,DWS Amsterdam,2,0,1,3,0,2,2,10.0,1.0
3583,1971-1972,28,FC Groningen,NAC Breda,1,0,1,3,0,1,1,10.0,1.0
3584,1971-1972,28,FC Twente,Go Ahead Eagles,4,0,1,3,0,4,4,9.0,7.0
3585,1971-1972,28,Sparta Rotterdam,NEC Nijmegen,3,0,1,3,0,3,3,12.0,5.0
3586,1971-1972,28,Vitesse,Telstar,1,1,3,1,1,2,0,5.0,6.0
3587,1971-1972,28,FC Volendam,FC Utrecht,3,1,1,3,0,4,2,9.0,5.0
3588,1971-1972,29,Feijenoord,AFC Ajax,1,5,2,0,3,6,-4,10.0,12.0
3589,1971-1972,29,DWS Amsterdam,Sparta Rotterdam,1,2,2,0,3,3,-1,1.0,12.0
3590,1971-1972,29,FC Utrecht,FC Den Bosch '67,6,3,1,3,0,9,3,5.0,7.0
3591,1971-1972,29,Go Ahead Eagles,FC Den Haag-ADO,2,3,2,0,3,5,-1,6.0,10.0
3592,1971-1972,29,MVV Maastricht,FC Twente,1,1,3,1,1,2,0,2.0,7.0
3593,1971-1972,29,NAC Breda,Vitesse,1,0,1,3,0,1,1,4.0,5.0
3594,1971-1972,29,NEC Nijmegen,SBV Excelsior,1,0,1,3,0,1,1,7.0,3.0
3595,1971-1972,29,PSV,FC Groningen,2,1,1,3,0,3,1,8.0,10.0
3596,1971-1972,29,Telstar,FC Volendam,3,0,1,3,0,3,3,8.0,6.0
3597,1971-1972,30,AFC Ajax,FC Utrecht,4,0,1,3,0,4,4,12.0,4.0
3598,1971-1972,30,SBV Excelsior,DWS Amsterdam,0,2,2,0,3,2,-2,2.0,4.0
3599,1971-1972,30,FC Den Bosch '67,Telstar,1,0,1,3,0,1,1,7.0,5.0
3600,1971-1972,30,FC Den Haag-ADO,MVV Maastricht,3,3,3,1,1,6,0,8.0,3.0
3601,1971-1972,30,FC Groningen,NEC Nijmegen,2,2,3,1,1,4,0,8.0,8.0
3602,1971-1972,30,FC Twente,Feijenoord,1,0,1,3,0,1,1,9.0,9.0
3603,1971-1972,30,NAC Breda,PSV,0,2,2,0,3,2,-2,4.0,10.0
3604,1971-1972,30,Sparta Rotterdam,Go Ahead Eagles,3,1,1,3,0,4,2,15.0,3.0
3605,1971-1972,30,Vitesse,FC Volendam,1,0,1,3,0,1,1,7.0,6.0
3606,1971-1972,31,DWS Amsterdam,FC Groningen,3,0,1,3,0,3,3,7.0,7.0
3607,1971-1972,31,FC Utrecht,FC Twente,1,1,3,1,1,2,0,5.0,9.0
3608,1971-1972,31,Feijenoord,FC Den Haag-ADO,2,1,1,3,0,3,1,9.0,7.0
3609,1971-1972,31,Go Ahead Eagles,SBV Excelsior,1,0,1,3,0,1,1,6.0,1.0
3610,1971-1972,31,MVV Maastricht,Sparta Rotterdam,3,0,1,3,0,3,3,6.0,12.0
3611,1971-1972,31,NEC Nijmegen,NAC Breda,1,0,1,3,0,1,1,10.0,4.0
3612,1971-1972,31,PSV,Vitesse,2,1,1,3,0,3,1,12.0,4.0
3613,1971-1972,31,Telstar,AFC Ajax,1,2,2,0,3,3,-1,5.0,12.0
3614,1971-1972,31,FC Volendam,FC Den Bosch '67,0,1,2,0,3,1,-1,3.0,7.0
3615,1971-1972,32,AFC Ajax,FC Volendam,2,0,1,3,0,2,2,15.0,3.0
3616,1971-1972,32,SBV Excelsior,MVV Maastricht,1,1,3,1,1,2,0,1.0,6.0
3617,1971-1972,32,FC Den Haag-ADO,FC Utrecht,1,1,3,1,1,2,0,8.0,5.0
3618,1971-1972,32,FC Groningen,Go Ahead Eagles,0,1,2,0,3,1,-1,4.0,6.0
3619,1971-1972,32,FC Twente,Telstar,1,0,1,3,0,1,1,11.0,4.0
3620,1971-1972,32,NAC Breda,DWS Amsterdam,1,0,1,3,0,1,1,6.0,6.0
3621,1971-1972,32,PSV,NEC Nijmegen,2,1,1,3,0,3,1,15.0,7.0
3622,1971-1972,32,Sparta Rotterdam,Feijenoord,3,5,2,0,3,8,-2,9.0,9.0
3623,1971-1972,32,Vitesse,FC Den Bosch '67,2,0,1,3,0,2,2,7.0,6.0
3624,1971-1972,33,DWS Amsterdam,PSV,1,1,3,1,1,2,0,7.0,13.0
3625,1971-1972,33,FC Den Bosch '67,AFC Ajax,0,1,2,0,3,1,-1,6.0,15.0
3626,1971-1972,33,FC Utrecht,Sparta Rotterdam,0,0,3,1,1,0,0,6.0,7.0
3627,1971-1972,33,Feijenoord,SBV Excelsior,1,1,3,1,1,2,0,7.0,2.0
3628,1971-1972,33,Go Ahead Eagles,NAC Breda,1,0,1,3,0,1,1,9.0,6.0
3629,1971-1972,33,MVV Maastricht,FC Groningen,2,2,3,1,1,4,0,7.0,2.0
3630,1971-1972,33,Telstar,FC Den Haag-ADO,1,2,2,0,3,3,-1,3.0,8.0
3631,1971-1972,33,Vitesse,NEC Nijmegen,2,3,2,0,3,5,-1,6.0,10.0
3632,1971-1972,33,FC Volendam,FC Twente,0,0,3,1,1,0,0,1.0,9.0
3633,1971-1972,34,FC Groningen,Feijenoord,1,3,2,0,3,4,-2,2.0,10.0
3634,1971-1972,34,AFC Ajax,Vitesse,12,1,1,3,0,13,11,15.0,6.0
3635,1971-1972,34,PSV,Go Ahead Eagles,2,0,1,3,0,2,2,13.0,9.0
3636,1971-1972,34,SBV Excelsior,FC Utrecht,2,4,2,0,3,6,-2,2.0,6.0
3637,1971-1972,34,NEC Nijmegen,DWS Amsterdam,3,1,1,3,0,4,2,10.0,7.0
3638,1971-1972,34,FC Den Haag-ADO,FC Volendam,4,0,1,3,0,4,4,8.0,1.0
3639,1971-1972,34,FC Twente,FC Den Bosch '67,7,0,1,3,0,7,7,11.0,6.0
3640,1971-1972,34,NAC Breda,MVV Maastricht,2,1,1,3,0,3,1,6.0,6.0
3641,1971-1972,34,Sparta Rotterdam,Telstar,4,1,1,3,0,5,3,7.0,0.0
3642,1972-1973,1,AFC Ajax,HFC Haarlem,3,0,1,3,0,3,3,15.0,1.0
3643,1972-1973,1,SBV Excelsior,FC Utrecht,0,3,2,0,3,3,-3,2.0,9.0
3644,1972-1973,1,FC Den Bosch '67,MVV Maastricht,1,0,1,3,0,1,1,6.0,5.0
3645,1972-1973,1,FC Den Haag-ADO,Sparta Rotterdam,1,1,3,1,1,2,0,8.0,5.0
3646,1972-1973,1,FC Groningen,PSV,1,1,3,1,1,2,0,2.0,11.0
3647,1972-1973,1,FC Twente,AZ '67 Alkmaar,2,0,1,3,0,2,2,11.0,3.0
3648,1972-1973,1,Feijenoord,NEC Nijmegen,1,0,1,3,0,1,1,13.0,9.0
3649,1972-1973,1,NAC Breda,Go Ahead Eagles,0,0,3,1,1,0,0,7.0,10.0
3650,1972-1973,1,Telstar,FC Amsterdam,2,1,1,3,0,3,1,3.0,
3651,1972-1973,2,AZ '67 Alkmaar,FC Den Bosch '67,0,0,3,1,1,0,0,4.0,4.0
3652,1972-1973,2,FC Amsterdam,AFC Ajax,1,2,2,0,3,3,-1,,15.0
3653,1972-1973,2,FC Utrecht,Feijenoord,0,4,2,0,3,4,-4,8.0,13.0
3654,1972-1973,2,Go Ahead Eagles,Telstar,2,1,1,3,0,3,1,10.0,3.0
3655,1972-1973,2,HFC Haarlem,FC Twente,4,0,1,3,0,4,4,4.0,10.0
3656,1972-1973,2,MVV Maastricht,FC Den Haag-ADO,4,1,1,3,0,5,3,5.0,8.0
3657,1972-1973,2,NEC Nijmegen,FC Groningen,1,1,3,1,1,2,0,7.0,3.0
3658,1972-1973,2,PSV,NAC Breda,5,0,1,3,0,5,5,11.0,7.0
3659,1972-1973,2,Sparta Rotterdam,SBV Excelsior,0,1,2,0,3,1,-1,5.0,5.0
3660,1972-1973,3,AFC Ajax,Go Ahead Eagles,6,0,1,3,0,6,6,15.0,7.0
3661,1972-1973,3,SBV Excelsior,MVV Maastricht,0,0,3,1,1,0,0,5.0,5.0
3662,1972-1973,3,FC Den Bosch '67,HFC Haarlem,0,0,3,1,1,0,0,5.0,5.0
3663,1972-1973,3,FC Den Haag-ADO,AZ '67 Alkmaar,4,0,1,3,0,4,4,10.0,1.0
3664,1972-1973,3,FC Groningen,Feijenoord,1,4,2,0,3,5,-3,3.0,13.0
3665,1972-1973,3,FC Twente,FC Amsterdam,2,1,1,3,0,3,1,10.0,
3666,1972-1973,3,NAC Breda,NEC Nijmegen,1,0,1,3,0,1,1,7.0,7.0
3667,1972-1973,3,Sparta Rotterdam,FC Utrecht,6,0,1,3,0,6,6,8.0,7.0
3668,1972-1973,3,Telstar,PSV,0,1,2,0,3,1,-1,3.0,11.0
3669,1972-1973,4,Go Ahead Eagles,FC Twente,1,2,2,0,3,3,-1,4.0,12.0
3670,1972-1973,4,PSV,AFC Ajax,0,3,2,0,3,3,-3,10.0,15.0
3671,1972-1973,4,AZ '67 Alkmaar,SBV Excelsior,3,1,1,3,0,4,2,4.0,4.0
3672,1972-1973,4,FC Amsterdam,FC Den Bosch '67,3,2,1,3,0,5,1,,5.0
3673,1972-1973,4,FC Utrecht,FC Groningen,0,0,3,1,1,0,0,7.0,3.0
3674,1972-1973,4,Feijenoord,NAC Breda,3,1,1,3,0,4,2,15.0,7.0
3675,1972-1973,4,HFC Haarlem,FC Den Haag-ADO,0,0,3,1,1,0,0,5.0,8.0
3676,1972-1973,4,MVV Maastricht,Sparta Rotterdam,3,2,1,3,0,5,1,7.0,7.0
3677,1972-1973,4,NEC Nijmegen,Telstar,2,0,1,3,0,2,2,7.0,3.0
3678,1972-1973,5,FC Twente,PSV,1,0,1,3,0,1,1,12.0,7.0
3679,1972-1973,5,AFC Ajax,NEC Nijmegen,4,0,1,3,0,4,4,15.0,4.0
3680,1972-1973,5,SBV Excelsior,HFC Haarlem,0,1,2,0,3,1,-1,4.0,8.0
3681,1972-1973,5,FC Den Bosch '67,Go Ahead Eagles,2,1,1,3,0,3,1,8.0,4.0
3682,1972-1973,5,FC Den Haag-ADO,FC Amsterdam,1,1,3,1,1,2,0,6.0,4.0
3683,1972-1973,5,MVV Maastricht,FC Utrecht,2,0,1,3,0,2,2,10.0,4.0
3684,1972-1973,5,NAC Breda,FC Groningen,1,1,3,1,1,2,0,5.0,4.0
3685,1972-1973,5,Sparta Rotterdam,AZ '67 Alkmaar,4,1,1,3,0,5,3,7.0,4.0
3686,1972-1973,5,Telstar,Feijenoord,0,1,2,0,3,1,-1,3.0,15.0
3687,1972-1973,6,PSV,FC Den Bosch '67,3,0,1,3,0,3,3,9.0,5.0
3688,1972-1973,6,AZ '67 Alkmaar,MVV Maastricht,2,1,1,3,0,3,1,7.0,10.0
3689,1972-1973,6,FC Amsterdam,SBV Excelsior,4,0,1,3,0,4,4,7.0,4.0
3690,1972-1973,6,FC Groningen,Telstar,0,2,2,0,3,2,-2,3.0,3.0
3691,1972-1973,6,FC Utrecht,NAC Breda,3,1,1,3,0,4,2,4.0,4.0
3692,1972-1973,6,Feijenoord,AFC Ajax,2,0,1,3,0,2,2,15.0,12.0
3693,1972-1973,6,Go Ahead Eagles,FC Den Haag-ADO,0,1,2,0,3,1,-1,3.0,8.0
3694,1972-1973,6,HFC Haarlem,Sparta Rotterdam,0,4,2,0,3,4,-4,8.0,9.0
3695,1972-1973,6,NEC Nijmegen,FC Twente,2,0,1,3,0,2,2,7.0,9.0
3696,1972-1973,7,FC Twente,Feijenoord,0,0,3,1,1,0,0,10.0,13.0
3697,1972-1973,7,AFC Ajax,FC Groningen,3,0,1,3,0,3,3,12.0,2.0
3698,1972-1973,7,AZ '67 Alkmaar,FC Utrecht,2,2,3,1,1,4,0,7.0,5.0
3699,1972-1973,7,SBV Excelsior,Go Ahead Eagles,0,2,2,0,3,2,-2,1.0,3.0
3700,1972-1973,7,FC Den Bosch '67,NEC Nijmegen,0,1,2,0,3,1,-1,4.0,9.0
3701,1972-1973,7,FC Den Haag-ADO,PSV,3,0,1,3,0,3,3,11.0,6.0
3702,1972-1973,7,MVV Maastricht,HFC Haarlem,2,0,1,3,0,2,2,10.0,5.0
3703,1972-1973,7,Sparta Rotterdam,FC Amsterdam,5,0,1,3,0,5,5,12.0,7.0
3704,1972-1973,7,Telstar,NAC Breda,2,0,1,3,0,2,2,6.0,4.0
3705,1972-1973,8,Go Ahead Eagles,Sparta Rotterdam,2,0,1,3,0,2,2,6.0,9.0
3706,1972-1973,8,FC Amsterdam,MVV Maastricht,2,0,1,3,0,2,2,10.0,9.0
3707,1972-1973,8,FC Groningen,FC Twente,0,3,2,0,3,3,-3,2.0,10.0
3708,1972-1973,8,FC Utrecht,Telstar,1,1,3,1,1,2,0,6.0,7.0
3709,1972-1973,8,Feijenoord,FC Den Bosch '67,4,0,1,3,0,4,4,13.0,3.0
3710,1972-1973,8,HFC Haarlem,AZ '67 Alkmaar,2,0,1,3,0,2,2,7.0,7.0
3711,1972-1973,8,NAC Breda,AFC Ajax,2,0,1,3,0,2,2,4.0,9.0
3712,1972-1973,8,NEC Nijmegen,FC Den Haag-ADO,1,3,2,0,3,4,-2,9.0,11.0
3713,1972-1973,8,PSV,SBV Excelsior,2,0,1,3,0,2,2,6.0,0.0
3714,1972-1973,9,AFC Ajax,Telstar,9,2,1,3,0,11,7,9.0,7.0
3715,1972-1973,9,AZ '67 Alkmaar,FC Amsterdam,1,4,2,0,3,5,-3,4.0,10.0
3716,1972-1973,9,SBV Excelsior,NEC Nijmegen,1,1,3,1,1,2,0,1.0,7.0
3717,1972-1973,9,FC Den Bosch '67,FC Groningen,1,1,3,1,1,2,0,4.0,2.0
3718,1972-1973,9,FC Den Haag-ADO,Feijenoord,3,2,1,3,0,5,1,13.0,10.0
3719,1972-1973,9,FC Twente,NAC Breda,2,0,1,3,0,2,2,10.0,4.0
3720,1972-1973,9,HFC Haarlem,FC Utrecht,0,2,2,0,3,2,-2,6.0,8.0
3721,1972-1973,9,MVV Maastricht,Go Ahead Eagles,1,1,3,1,1,2,0,7.0,7.0
3722,1972-1973,9,Sparta Rotterdam,PSV,3,0,1,3,0,3,3,12.0,6.0
3723,1972-1973,10,FC Amsterdam,HFC Haarlem,2,1,1,3,0,3,1,12.0,3.0
3724,1972-1973,10,FC Groningen,FC Den Haag-ADO,1,2,2,0,3,3,-1,1.0,15.0
3725,1972-1973,10,FC Utrecht,AFC Ajax,0,1,2,0,3,1,-1,8.0,9.0
3726,1972-1973,10,Feijenoord,SBV Excelsior,7,0,1,3,0,7,7,10.0,1.0
3727,1972-1973,10,Go Ahead Eagles,AZ '67 Alkmaar,1,2,2,0,3,3,-1,7.0,7.0
3728,1972-1973,10,NAC Breda,FC Den Bosch '67,4,0,1,3,0,4,4,6.0,1.0
3729,1972-1973,10,NEC Nijmegen,Sparta Rotterdam,3,3,3,1,1,6,0,8.0,10.0
3730,1972-1973,10,PSV,MVV Maastricht,1,3,2,0,3,4,-2,6.0,7.0
3731,1972-1973,10,Telstar,FC Twente,0,2,2,0,3,2,-2,7.0,10.0
3732,1972-1973,11,FC Twente,AFC Ajax,0,1,2,0,3,1,-1,10.0,12.0
3733,1972-1973,11,AZ '67 Alkmaar,PSV,2,1,1,3,0,3,1,7.0,3.0
3734,1972-1973,11,SBV Excelsior,FC Groningen,0,0,3,1,1,0,0,2.0,2.0
3735,1972-1973,11,FC Amsterdam,FC Utrecht,2,1,1,3,0,3,1,12.0,5.0
3736,1972-1973,11,FC Den Bosch '67,Telstar,0,1,2,0,3,1,-1,1.0,7.0
3737,1972-1973,11,FC Den Haag-ADO,NAC Breda,1,1,3,1,1,2,0,13.0,7.0
3738,1972-1973,11,HFC Haarlem,Go Ahead Eagles,5,2,1,3,0,7,3,6.0,7.0
3739,1972-1973,11,MVV Maastricht,NEC Nijmegen,2,0,1,3,0,2,2,10.0,5.0
3740,1972-1973,11,Sparta Rotterdam,Feijenoord,1,1,3,1,1,2,0,8.0,8.0
3741,1972-1973,12,AFC Ajax,FC Den Bosch '67,9,0,1,3,0,9,9,12.0,1.0
3742,1972-1973,12,FC Groningen,Sparta Rotterdam,1,4,2,0,3,5,-3,2.0,8.0
3743,1972-1973,12,FC Utrecht,FC Twente,1,2,2,0,3,3,-1,4.0,12.0
3744,1972-1973,12,Feijenoord,MVV Maastricht,2,1,1,3,0,3,1,10.0,7.0
3745,1972-1973,12,Go Ahead Eagles,FC Amsterdam,0,0,3,1,1,0,0,5.0,13.0
3746,1972-1973,12,NAC Breda,SBV Excelsior,2,1,1,3,0,3,1,10.0,2.0
3747,1972-1973,12,NEC Nijmegen,AZ '67 Alkmaar,3,2,1,3,0,5,1,5.0,6.0
3748,1972-1973,12,PSV,HFC Haarlem,2,1,1,3,0,3,1,6.0,6.0
3749,1972-1973,12,Telstar,FC Den Haag-ADO,4,1,1,3,0,5,3,7.0,10.0
3750,1972-1973,13,Go Ahead Eagles,FC Utrecht,3,4,2,0,3,7,-1,2.0,6.0
3751,1972-1973,13,AZ '67 Alkmaar,Feijenoord,0,2,2,0,3,2,-2,6.0,10.0
3752,1972-1973,13,SBV Excelsior,Telstar,1,1,3,1,1,2,0,3.0,7.0
3753,1972-1973,13,FC Amsterdam,PSV,1,1,3,1,1,2,0,11.0,4.0
3754,1972-1973,13,FC Den Bosch '67,FC Twente,0,2,2,0,3,2,-2,1.0,12.0
3755,1972-1973,13,FC Den Haag-ADO,AFC Ajax,0,1,2,0,3,1,-1,7.0,15.0
3756,1972-1973,13,HFC Haarlem,NEC Nijmegen,1,1,3,1,1,2,0,4.0,6.0
3757,1972-1973,13,MVV Maastricht,FC Groningen,3,0,1,3,0,3,3,10.0,2.0
3758,1972-1973,13,Sparta Rotterdam,NAC Breda,2,0,1,3,0,2,2,11.0,7.0
3759,1972-1973,14,AFC Ajax,SBV Excelsior,8,0,1,3,0,8,8,15.0,2.0
3760,1972-1973,14,FC Twente,FC Den Haag-ADO,2,0,1,3,0,2,2,12.0,4.0
3761,1972-1973,14,FC Groningen,AZ '67 Alkmaar,4,2,1,3,0,6,2,4.0,6.0
3762,1972-1973,14,FC Utrecht,FC Den Bosch '67,1,0,1,3,0,1,1,6.0,0.0
3763,1972-1973,14,Feijenoord,HFC Haarlem,1,0,1,3,0,1,1,13.0,4.0
3764,1972-1973,14,NAC Breda,MVV Maastricht,1,1,3,1,1,2,0,8.0,10.0
3765,1972-1973,14,NEC Nijmegen,FC Amsterdam,1,0,1,3,0,1,1,8.0,8.0
3766,1972-1973,14,PSV,Go Ahead Eagles,0,0,3,1,1,0,0,5.0,2.0
3767,1972-1973,14,Telstar,Sparta Rotterdam,0,1,2,0,3,1,-1,7.0,11.0
3768,1972-1973,15,AZ '67 Alkmaar,NAC Breda,2,2,3,1,1,4,0,4.0,6.0
3769,1972-1973,15,SBV Excelsior,FC Twente,0,0,3,1,1,0,0,3.0,10.0
3770,1972-1973,15,FC Amsterdam,Feijenoord,1,3,2,0,3,4,-2,5.0,13.0
3771,1972-1973,15,FC Den Haag-ADO,FC Den Bosch '67,0,0,3,1,1,0,0,2.0,1.0
3772,1972-1973,15,Go Ahead Eagles,NEC Nijmegen,0,1,2,0,3,1,-1,2.0,10.0
3773,1972-1973,15,HFC Haarlem,FC Groningen,1,1,3,1,1,2,0,5.0,5.0
3774,1972-1973,15,MVV Maastricht,Telstar,4,0,1,3,0,4,4,10.0,7.0
3775,1972-1973,15,PSV,FC Utrecht,5,1,1,3,0,6,4,8.0,6.0
3776,1972-1973,15,Sparta Rotterdam,AFC Ajax,3,1,1,3,0,4,2,13.0,12.0
3777,1972-1973,16,AFC Ajax,MVV Maastricht,4,0,1,3,0,4,4,12.0,7.0
3778,1972-1973,16,FC Den Bosch '67,SBV Excelsior,0,0,3,1,1,0,0,2.0,3.0
3779,1972-1973,16,FC Den Haag-ADO,FC Utrecht,1,1,3,1,1,2,0,2.0,7.0
3780,1972-1973,16,FC Groningen,FC Amsterdam,4,0,1,3,0,4,4,7.0,2.0
3781,1972-1973,16,FC Twente,Sparta Rotterdam,0,1,2,0,3,1,-1,10.0,15.0
3782,1972-1973,16,Feijenoord,Go Ahead Eagles,2,1,1,3,0,3,1,15.0,2.0
3783,1972-1973,16,NAC Breda,HFC Haarlem,1,1,3,1,1,2,0,6.0,3.0
3784,1972-1973,16,NEC Nijmegen,PSV,1,1,3,1,1,2,0,11.0,9.0
3785,1972-1973,16,Telstar,AZ '67 Alkmaar,0,0,3,1,1,0,0,5.0,2.0
3786,1972-1973,17,AZ '67 Alkmaar,AFC Ajax,0,5,2,0,3,5,-5,2.0,12.0
3787,1972-1973,17,SBV Excelsior,FC Den Haag-ADO,0,2,2,0,3,2,-2,3.0,5.0
3788,1972-1973,17,FC Amsterdam,NAC Breda,0,0,3,1,1,0,0,2.0,4.0
3789,1972-1973,17,FC Utrecht,NEC Nijmegen,2,0,1,3,0,2,2,10.0,8.0
3790,1972-1973,17,Go Ahead Eagles,FC Groningen,0,0,3,1,1,0,0,2.0,8.0
3791,1972-1973,17,HFC Haarlem,Telstar,1,2,2,0,3,3,-1,3.0,5.0
3792,1972-1973,17,MVV Maastricht,FC Twente,1,0,1,3,0,1,1,10.0,7.0
3793,1972-1973,17,PSV,Feijenoord,0,1,2,0,3,1,-1,6.0,15.0
3794,1972-1973,17,Sparta Rotterdam,FC Den Bosch '67,3,1,1,3,0,4,2,15.0,2.0
3795,1972-1973,18,AZ '67 Alkmaar,FC Twente,2,2,3,1,1,4,0,3.0,5.0
3796,1972-1973,18,FC Amsterdam,Telstar,2,0,1,3,0,2,2,4.0,4.0
3797,1972-1973,18,FC Utrecht,SBV Excelsior,2,0,1,3,0,2,2,10.0,2.0
3798,1972-1973,18,Go Ahead Eagles,NAC Breda,3,0,1,3,0,3,3,5.0,4.0
3799,1972-1973,18,HFC Haarlem,AFC Ajax,0,4,2,0,3,4,-4,2.0,12.0
3800,1972-1973,18,MVV Maastricht,FC Den Bosch '67,1,1,3,1,1,2,0,8.0,3.0
3801,1972-1973,18,NEC Nijmegen,Feijenoord,2,3,2,0,3,5,-1,7.0,15.0
3802,1972-1973,18,PSV,FC Groningen,0,0,3,1,1,0,0,6.0,9.0
3803,1972-1973,18,Sparta Rotterdam,FC Den Haag-ADO,3,1,1,3,0,4,2,15.0,5.0
3804,1972-1973,19,AFC Ajax,FC Amsterdam,2,1,1,3,0,3,1,12.0,4.0
3805,1972-1973,19,SBV Excelsior,Sparta Rotterdam,0,4,2,0,3,4,-4,2.0,15.0
3806,1972-1973,19,FC Den Bosch '67,AZ '67 Alkmaar,1,2,2,0,3,3,-1,3.0,6.0
3807,1972-1973,19,FC Den Haag-ADO,MVV Maastricht,1,1,3,1,1,2,0,6.0,8.0
3808,1972-1973,19,FC Groningen,NEC Nijmegen,1,1,3,1,1,2,0,7.0,5.0
3809,1972-1973,19,FC Twente,HFC Haarlem,1,1,3,1,1,2,0,3.0,3.0
3810,1972-1973,19,Feijenoord,FC Utrecht,2,1,1,3,0,3,1,15.0,7.0
3811,1972-1973,19,NAC Breda,PSV,1,2,2,0,3,3,-1,3.0,8.0
3812,1972-1973,19,Telstar,Go Ahead Eagles,3,0,1,3,0,3,3,7.0,4.0
3813,1972-1973,20,AZ '67 Alkmaar,FC Den Haag-ADO,0,1,2,0,3,1,-1,5.0,8.0
3814,1972-1973,20,FC Amsterdam,FC Twente,1,1,3,1,1,2,0,5.0,3.0
3815,1972-1973,20,FC Utrecht,Sparta Rotterdam,1,5,2,0,3,6,-4,7.0,15.0
3816,1972-1973,20,Feijenoord,FC Groningen,5,1,1,3,0,6,4,15.0,6.0
3817,1972-1973,20,Go Ahead Eagles,AFC Ajax,0,1,2,0,3,1,-1,4.0,15.0
3818,1972-1973,20,HFC Haarlem,FC Den Bosch '67,2,1,1,3,0,3,1,5.0,2.0
3819,1972-1973,20,MVV Maastricht,SBV Excelsior,3,0,1,3,0,3,3,8.0,1.0
3820,1972-1973,20,NEC Nijmegen,NAC Breda,0,2,2,0,3,2,-2,2.0,5.0
3821,1972-1973,20,PSV,Telstar,3,0,1,3,0,3,3,8.0,7.0
3822,1972-1973,21,AFC Ajax,PSV,3,1,1,3,0,4,2,15.0,7.0
3823,1972-1973,21,SBV Excelsior,AZ '67 Alkmaar,1,0,1,3,0,1,1,3.0,4.0
3824,1972-1973,21,FC Den Bosch '67,FC Amsterdam,0,0,3,1,1,0,0,2.0,6.0
3825,1972-1973,21,FC Den Haag-ADO,HFC Haarlem,3,0,1,3,0,3,3,10.0,4.0
3826,1972-1973,21,FC Groningen,FC Utrecht,2,1,1,3,0,3,1,6.0,6.0
3827,1972-1973,21,FC Twente,Go Ahead Eagles,3,0,1,3,0,3,3,6.0,4.0
3828,1972-1973,21,NAC Breda,Feijenoord,0,5,2,0,3,5,-5,4.0,15.0
3829,1972-1973,21,Sparta Rotterdam,MVV Maastricht,4,0,1,3,0,4,4,15.0,8.0
3830,1972-1973,21,Telstar,NEC Nijmegen,3,1,1,3,0,4,2,9.0,1.0
3831,1972-1973,22,AZ '67 Alkmaar,Sparta Rotterdam,1,0,1,3,0,1,1,7.0,12.0
3832,1972-1973,22,FC Amsterdam,FC Den Haag-ADO,0,2,2,0,3,2,-2,5.0,10.0
3833,1972-1973,22,FC Utrecht,MVV Maastricht,1,1,3,1,1,2,0,4.0,6.0
3834,1972-1973,22,Go Ahead Eagles,FC Den Bosch '67,1,0,1,3,0,1,1,6.0,2.0
3835,1972-1973,22,HFC Haarlem,SBV Excelsior,2,0,1,3,0,2,2,7.0,3.0
3836,1972-1973,22,NEC Nijmegen,AFC Ajax,0,4,2,0,3,4,-4,1.0,15.0
3837,1972-1973,22,FC Groningen,NAC Breda,1,0,1,3,0,1,1,8.0,3.0
3838,1972-1973,22,Feijenoord,Telstar,2,0,1,3,0,2,2,15.0,6.0
3839,1972-1973,22,PSV,FC Twente,0,1,2,0,3,1,-1,7.0,9.0
3840,1972-1973,23,FC Den Bosch '67,PSV,1,4,2,0,3,5,-3,1.0,9.0
3841,1972-1973,23,MVV Maastricht,AZ '67 Alkmaar,1,0,1,3,0,1,1,8.0,6.0
3842,1972-1973,23,FC Twente,NEC Nijmegen,2,0,1,3,0,2,2,11.0,1.0
3843,1972-1973,23,AFC Ajax,Feijenoord,2,1,1,3,0,3,1,15.0,12.0
3844,1972-1973,23,SBV Excelsior,FC Amsterdam,2,3,2,0,3,5,-1,3.0,5.0
3845,1972-1973,23,FC Den Haag-ADO,Go Ahead Eagles,2,0,1,3,0,2,2,13.0,3.0
3846,1972-1973,23,NAC Breda,FC Utrecht,0,3,2,0,3,3,-3,3.0,4.0
3847,1972-1973,23,Sparta Rotterdam,HFC Haarlem,4,1,1,3,0,5,3,12.0,7.0
3848,1972-1973,23,Telstar,FC Groningen,5,1,1,3,0,6,4,9.0,7.0
3849,1972-1973,24,PSV,FC Den Haag-ADO,0,0,3,1,1,0,0,7.0,13.0
3850,1972-1973,24,NEC Nijmegen,FC Den Bosch '67,7,0,1,3,0,7,7,3.0,1.0
3851,1972-1973,24,FC Amsterdam,Sparta Rotterdam,4,2,1,3,0,6,2,8.0,9.0
3852,1972-1973,24,FC Groningen,AFC Ajax,0,2,2,0,3,2,-2,6.0,15.0
3853,1972-1973,24,FC Utrecht,AZ '67 Alkmaar,2,0,1,3,0,2,2,7.0,3.0
3854,1972-1973,24,Feijenoord,FC Twente,1,3,2,0,3,4,-2,9.0,13.0
3855,1972-1973,24,Go Ahead Eagles,SBV Excelsior,2,1,1,3,0,3,1,6.0,3.0
3856,1972-1973,24,HFC Haarlem,MVV Maastricht,3,2,1,3,0,5,1,9.0,7.0
3857,1972-1973,24,NAC Breda,Telstar,0,1,2,0,3,1,-1,3.0,9.0
3858,1972-1973,25,FC Twente,FC Groningen,4,2,1,3,0,6,2,15.0,6.0
3859,1972-1973,25,AFC Ajax,NAC Breda,4,0,1,3,0,4,4,15.0,0.0
3860,1972-1973,25,AZ '67 Alkmaar,HFC Haarlem,2,1,1,3,0,3,1,6.0,6.0
3861,1972-1973,25,SBV Excelsior,PSV,2,3,2,0,3,5,-1,3.0,7.0
3862,1972-1973,25,FC Den Bosch '67,Feijenoord,0,2,2,0,3,2,-2,1.0,9.0
3863,1972-1973,25,FC Den Haag-ADO,NEC Nijmegen,1,0,1,3,0,1,1,13.0,3.0
3864,1972-1973,25,MVV Maastricht,FC Amsterdam,0,3,2,0,3,3,-3,4.0,10.0
3865,1972-1973,25,Sparta Rotterdam,Go Ahead Eagles,1,0,1,3,0,1,1,9.0,6.0
3866,1972-1973,25,Telstar,FC Utrecht,0,1,2,0,3,1,-1,9.0,10.0
3867,1972-1973,26,Go Ahead Eagles,MVV Maastricht,2,2,3,1,1,4,0,7.0,5.0
3868,1972-1973,26,FC Amsterdam,AZ '67 Alkmaar,0,3,2,0,3,3,-3,9.0,9.0
3869,1972-1973,26,FC Groningen,FC Den Bosch '67,4,2,1,3,0,6,2,6.0,0.0
3870,1972-1973,26,FC Utrecht,HFC Haarlem,1,1,3,1,1,2,0,11.0,7.0
3871,1972-1973,26,Feijenoord,FC Den Haag-ADO,2,0,1,3,0,2,2,9.0,10.0
3872,1972-1973,26,NAC Breda,FC Twente,0,1,2,0,3,1,-1,0.0,15.0
3873,1972-1973,26,NEC Nijmegen,SBV Excelsior,2,1,1,3,0,3,1,6.0,0.0
3874,1972-1973,26,PSV,Sparta Rotterdam,2,1,1,3,0,3,1,10.0,6.0
3875,1972-1973,26,Telstar,AFC Ajax,0,1,2,0,3,1,-1,6.0,15.0
3876,1972-1973,27,SBV Excelsior,Feijenoord,1,6,2,0,3,7,-5,0.0,9.0
3877,1972-1973,27,AFC Ajax,FC Utrecht,3,1,1,3,0,4,2,15.0,10.0
3878,1972-1973,27,AZ '67 Alkmaar,Go Ahead Eagles,1,1,3,1,1,2,0,7.0,5.0
3879,1972-1973,27,FC Den Bosch '67,NAC Breda,2,0,1,3,0,2,2,3.0,0.0
3880,1972-1973,27,FC Den Haag-ADO,FC Groningen,3,0,1,3,0,3,3,10.0,3.0
3881,1972-1973,27,FC Twente,Telstar,2,0,1,3,0,2,2,15.0,6.0
3882,1972-1973,27,HFC Haarlem,FC Amsterdam,1,4,2,0,3,5,-3,4.0,12.0
3883,1972-1973,27,MVV Maastricht,PSV,0,1,2,0,3,1,-1,4.0,13.0
3884,1972-1973,27,Sparta Rotterdam,NEC Nijmegen,2,2,3,1,1,4,0,7.0,7.0
3885,1972-1973,28,AFC Ajax,FC Twente,1,0,1,3,0,1,1,15.0,12.0
3886,1972-1973,28,FC Groningen,SBV Excelsior,1,1,3,1,1,2,0,4.0,1.0
3887,1972-1973,28,FC Utrecht,FC Amsterdam,2,0,1,3,0,2,2,10.0,9.0
3888,1972-1973,28,Feijenoord,Sparta Rotterdam,3,3,3,1,1,6,0,10.0,5.0
3889,1972-1973,28,Go Ahead Eagles,HFC Haarlem,0,4,2,0,3,4,-4,5.0,7.0
3890,1972-1973,28,NAC Breda,FC Den Haag-ADO,1,2,2,0,3,3,-1,0.0,10.0
3891,1972-1973,28,NEC Nijmegen,MVV Maastricht,0,0,3,1,1,0,0,8.0,2.0
3892,1972-1973,28,PSV,AZ '67 Alkmaar,1,0,1,3,0,1,1,13.0,7.0
3893,1972-1973,28,Telstar,FC Den Bosch '67,3,1,1,3,0,4,2,6.0,3.0
3894,1972-1973,29,AZ '67 Alkmaar,NEC Nijmegen,0,0,3,1,1,0,0,8.0,6.0
3895,1972-1973,29,SBV Excelsior,NAC Breda,2,0,1,3,0,2,2,4.0,0.0
3896,1972-1973,29,FC Amsterdam,Go Ahead Eagles,0,1,2,0,3,1,-1,6.0,5.0
3897,1972-1973,29,FC Den Bosch '67,AFC Ajax,1,2,2,0,3,3,-1,3.0,15.0
3898,1972-1973,29,FC Den Haag-ADO,Telstar,1,0,1,3,0,1,1,12.0,3.0
3899,1972-1973,29,FC Twente,FC Utrecht,3,1,1,3,0,4,2,12.0,7.0
3900,1972-1973,29,HFC Haarlem,PSV,1,1,3,1,1,2,0,5.0,13.0
3901,1972-1973,29,MVV Maastricht,Feijenoord,1,2,2,0,3,3,-1,2.0,13.0
3902,1972-1973,29,Sparta Rotterdam,FC Groningen,2,0,1,3,0,2,2,8.0,4.0
3903,1972-1973,30,AFC Ajax,FC Den Haag-ADO,5,0,1,3,0,5,5,15.0,9.0
3904,1972-1973,30,FC Twente,FC Den Bosch '67,2,0,1,3,0,2,2,12.0,3.0
3905,1972-1973,30,FC Groningen,MVV Maastricht,1,4,2,0,3,5,-3,4.0,5.0
3906,1972-1973,30,FC Utrecht,Go Ahead Eagles,1,0,1,3,0,1,1,7.0,5.0
3907,1972-1973,30,Feijenoord,AZ '67 Alkmaar,2,1,1,3,0,3,1,13.0,5.0
3908,1972-1973,30,NAC Breda,Sparta Rotterdam,0,1,2,0,3,1,-1,0.0,8.0
3909,1972-1973,30,NEC Nijmegen,HFC Haarlem,2,1,1,3,0,3,1,9.0,5.0
3910,1972-1973,30,PSV,FC Amsterdam,2,0,1,3,0,2,2,13.0,3.0
3911,1972-1973,30,Telstar,SBV Excelsior,1,3,2,0,3,4,-2,3.0,7.0
3912,1972-1973,31,AZ '67 Alkmaar,FC Groningen,1,1,3,1,1,2,0,3.0,2.0
3913,1972-1973,31,SBV Excelsior,AFC Ajax,0,1,2,0,3,1,-1,7.0,15.0
3914,1972-1973,31,FC Amsterdam,NEC Nijmegen,1,1,3,1,1,2,0,4.0,7.0
3915,1972-1973,31,FC Den Bosch '67,FC Utrecht,3,0,1,3,0,3,3,6.0,6.0
3916,1972-1973,31,FC Den Haag-ADO,FC Twente,0,4,2,0,3,4,-4,9.0,12.0
3917,1972-1973,31,Go Ahead Eagles,PSV,1,0,1,3,0,1,1,7.0,10.0
3918,1972-1973,31,HFC Haarlem,Feijenoord,0,0,3,1,1,0,0,5.0,11.0
3919,1972-1973,31,MVV Maastricht,NAC Breda,3,0,1,3,0,3,3,7.0,0.0
3920,1972-1973,31,Sparta Rotterdam,Telstar,2,1,1,3,0,3,1,11.0,3.0
3921,1972-1973,32,AFC Ajax,Sparta Rotterdam,4,2,1,3,0,6,2,15.0,10.0
3922,1972-1973,32,FC Den Bosch '67,FC Den Haag-ADO,2,1,1,3,0,3,1,6.0,6.0
3923,1972-1973,32,FC Groningen,HFC Haarlem,4,1,1,3,0,5,3,5.0,5.0
3924,1972-1973,32,FC Twente,SBV Excelsior,2,0,1,3,0,2,2,12.0,7.0
3925,1972-1973,32,FC Utrecht,PSV,1,1,3,1,1,2,0,7.0,8.0
3926,1972-1973,32,Feijenoord,FC Amsterdam,7,2,1,3,0,9,5,11.0,1.0
3927,1972-1973,32,NAC Breda,AZ '67 Alkmaar,3,0,1,3,0,3,3,3.0,2.0
3928,1972-1973,32,NEC Nijmegen,Go Ahead Eagles,1,1,3,1,1,2,0,7.0,7.0
3929,1972-1973,32,Telstar,MVV Maastricht,2,1,1,3,0,3,1,6.0,7.0
3930,1972-1973,33,PSV,NEC Nijmegen,2,0,1,3,0,2,2,8.0,6.0
3931,1972-1973,33,AZ '67 Alkmaar,Telstar,0,0,3,1,1,0,0,3.0,4.0
3932,1972-1973,33,SBV Excelsior,FC Den Bosch '67,4,1,1,3,0,5,3,9.0,6.0
3933,1972-1973,33,FC Amsterdam,FC Groningen,0,1,2,0,3,1,-1,1.0,7.0
3934,1972-1973,33,FC Utrecht,FC Den Haag-ADO,1,1,3,1,1,2,0,5.0,4.0
3935,1972-1973,33,Go Ahead Eagles,Feijenoord,2,4,2,0,3,6,-2,7.0,13.0
3936,1972-1973,33,HFC Haarlem,NAC Breda,3,1,1,3,0,4,2,5.0,3.0
3937,1972-1973,33,MVV Maastricht,AFC Ajax,1,0,1,3,0,1,1,9.0,12.0
3938,1972-1973,33,Sparta Rotterdam,FC Twente,1,2,2,0,3,3,-1,9.0,15.0
3939,1972-1973,34,AFC Ajax,AZ '67 Alkmaar,3,0,1,3,0,3,3,12.0,2.0
3940,1972-1973,34,Feijenoord,PSV,2,0,1,3,0,2,2,13.0,7.0
3941,1972-1973,34,NEC Nijmegen,FC Utrecht,3,0,1,3,0,3,3,8.0,5.0
3942,1972-1973,34,FC Den Bosch '67,Sparta Rotterdam,0,5,2,0,3,5,-5,6.0,9.0
3943,1972-1973,34,FC Den Haag-ADO,SBV Excelsior,1,1,3,1,1,2,0,2.0,7.0
3944,1972-1973,34,FC Groningen,Go Ahead Eagles,1,1,3,1,1,2,0,8.0,5.0
3945,1972-1973,34,FC Twente,MVV Maastricht,0,0,3,1,1,0,0,13.0,10.0
3946,1972-1973,34,NAC Breda,FC Amsterdam,1,0,1,3,0,1,1,6.0,1.0
3947,1972-1973,34,Telstar,HFC Haarlem,2,3,2,0,3,5,-1,4.0,7.0
3948,1973-1974,1,FC Amsterdam,PSV,2,1,1,3,0,3,1,4.0,4.0
3949,1973-1974,1,FC Den Haag-ADO,De Graafschap,1,1,3,1,1,2,0,3.0,
3950,1973-1974,1,FC Groningen,AFC Ajax,0,4,2,0,3,4,-4,8.0,12.0
3951,1973-1974,1,FC Twente,HFC Haarlem,2,1,1,3,0,3,1,13.0,7.0
3952,1973-1974,1,Feyenoord,Go Ahead Eagles,1,0,1,3,0,1,1,,5.0
3953,1973-1974,1,NAC Breda,AZ '67 Alkmaar,0,0,3,1,1,0,0,7.0,3.0
3954,1973-1974,1,NEC Nijmegen,FC Utrecht,0,1,2,0,3,1,-1,5.0,5.0
3955,1973-1974,1,Roda JC Kerkrade,MVV Maastricht,1,2,2,0,3,3,-1,,10.0
3956,1973-1974,1,Telstar,Sparta Rotterdam,2,2,3,1,1,4,0,5.0,7.0
3957,1973-1974,2,Sparta Rotterdam,FC Den Haag-ADO,1,0,1,3,0,1,1,7.0,3.0
3958,1973-1974,2,AFC Ajax,FC Amsterdam,6,1,1,3,0,7,5,12.0,3.0
3959,1973-1974,2,AZ '67 Alkmaar,Feyenoord,1,2,2,0,3,3,-1,2.0,
3960,1973-1974,2,De Graafschap,Roda JC Kerkrade,1,1,3,1,1,2,0,,
3961,1973-1974,2,FC Utrecht,FC Twente,3,2,1,3,0,5,1,8.0,10.0
3962,1973-1974,2,Go Ahead Eagles,Telstar,4,3,1,3,0,7,1,5.0,5.0
3963,1973-1974,2,HFC Haarlem,NAC Breda,3,1,1,3,0,4,2,9.0,7.0
3964,1973-1974,2,MVV Maastricht,FC Groningen,2,5,2,0,3,7,-3,7.0,10.0
3965,1973-1974,2,PSV,NEC Nijmegen,2,1,1,3,0,3,1,7.0,4.0
3966,1973-1974,3,AZ '67 Alkmaar,Go Ahead Eagles,0,0,3,1,1,0,0,3.0,5.0
3967,1973-1974,3,FC Amsterdam,MVV Maastricht,2,2,3,1,1,4,0,4.0,8.0
3968,1973-1974,3,FC Den Haag-ADO,Telstar,2,0,1,3,0,2,2,6.0,2.0
3969,1973-1974,3,FC Groningen,De Graafschap,2,2,3,1,1,4,0,8.0,
3970,1973-1974,3,FC Twente,PSV,1,1,3,1,1,2,0,8.0,7.0
3971,1973-1974,3,Feyenoord,HFC Haarlem,4,1,1,3,0,5,3,,9.0
3972,1973-1974,3,NAC Breda,FC Utrecht,2,4,2,0,3,6,-2,4.0,10.0
3973,1973-1974,3,NEC Nijmegen,AFC Ajax,1,1,3,1,1,2,0,4.0,10.0
3974,1973-1974,3,Roda JC Kerkrade,Sparta Rotterdam,0,0,3,1,1,0,0,,8.0
3975,1973-1974,4,AFC Ajax,FC Twente,1,1,3,1,1,2,0,11.0,6.0
3976,1973-1974,4,FC Utrecht,Feyenoord,0,4,2,0,3,4,-4,9.0,
3977,1973-1974,4,Go Ahead Eagles,FC Den Haag-ADO,2,0,1,3,0,2,2,8.0,5.0
3978,1973-1974,4,MVV Maastricht,NEC Nijmegen,0,1,2,0,3,1,-1,5.0,7.0
3979,1973-1974,4,PSV,NAC Breda,7,1,1,3,0,8,6,7.0,4.0
3980,1973-1974,4,De Graafschap,FC Amsterdam,0,2,2,0,3,2,-2,,7.0
3981,1973-1974,4,HFC Haarlem,AZ '67 Alkmaar,1,1,3,1,1,2,0,7.0,3.0
3982,1973-1974,4,Sparta Rotterdam,FC Groningen,0,0,3,1,1,0,0,9.0,6.0
3983,1973-1974,4,Telstar,Roda JC Kerkrade,2,2,3,1,1,4,0,2.0,
3984,1973-1974,5,FC Twente,MVV Maastricht,3,0,1,3,0,3,3,8.0,4.0
3985,1973-1974,5,AZ '67 Alkmaar,FC Utrecht,2,0,1,3,0,2,2,6.0,9.0
3986,1973-1974,5,FC Amsterdam,Sparta Rotterdam,3,1,1,3,0,4,2,10.0,6.0
3987,1973-1974,5,FC Groningen,Telstar,1,2,2,0,3,3,-1,5.0,5.0
3988,1973-1974,5,Feyenoord,PSV,1,1,3,1,1,2,0,13.0,8.0
3989,1973-1974,5,HFC Haarlem,Go Ahead Eagles,2,1,1,3,0,3,1,7.0,7.0
3990,1973-1974,5,NAC Breda,AFC Ajax,2,3,2,0,3,5,-1,1.0,11.0
3991,1973-1974,5,NEC Nijmegen,De Graafschap,1,2,2,0,3,3,-1,4.0,6.0
3992,1973-1974,5,Roda JC Kerkrade,FC Den Haag-ADO,0,1,2,0,3,1,-1,3.0,7.0
3993,1973-1974,6,Sparta Rotterdam,NEC Nijmegen,2,0,1,3,0,2,2,8.0,4.0
3994,1973-1974,6,AFC Ajax,Feyenoord,2,1,1,3,0,3,1,11.0,10.0
3995,1973-1974,6,De Graafschap,FC Twente,0,0,3,1,1,0,0,6.0,6.0
3996,1973-1974,6,FC Den Haag-ADO,FC Groningen,1,0,1,3,0,1,1,9.0,5.0
3997,1973-1974,6,FC Utrecht,HFC Haarlem,2,0,1,3,0,2,2,9.0,7.0
3998,1973-1974,6,Go Ahead Eagles,Roda JC Kerkrade,3,1,1,3,0,4,2,10.0,3.0
3999,1973-1974,6,MVV Maastricht,NAC Breda,1,0,1,3,0,1,1,4.0,0.0
4000,1973-1974,6,PSV,AZ '67 Alkmaar,5,1,1,3,0,6,4,11.0,5.0
4001,1973-1974,6,Telstar,FC Amsterdam,0,0,3,1,1,0,0,5.0,8.0
4002,1973-1974,7,FC Twente,Sparta Rotterdam,3,0,1,3,0,3,3,9.0,5.0
4003,1973-1974,7,FC Utrecht,Go Ahead Eagles,2,0,1,3,0,2,2,9.0,7.0
4004,1973-1974,7,AZ '67 Alkmaar,AFC Ajax,1,1,3,1,1,2,0,6.0,9.0
4005,1973-1974,7,FC Amsterdam,FC Den Haag-ADO,3,0,1,3,0,3,3,11.0,9.0
4006,1973-1974,7,FC Groningen,Roda JC Kerkrade,1,3,2,0,3,4,-2,2.0,5.0
4007,1973-1974,7,Feyenoord,MVV Maastricht,3,1,1,3,0,4,2,10.0,4.0
4008,1973-1974,7,HFC Haarlem,PSV,2,0,1,3,0,2,2,7.0,8.0
4009,1973-1974,7,NAC Breda,De Graafschap,4,0,1,3,0,4,4,3.0,5.0
4010,1973-1974,7,NEC Nijmegen,Telstar,1,1,3,1,1,2,0,5.0,6.0
4011,1973-1974,8,AFC Ajax,HFC Haarlem,5,0,1,3,0,5,5,11.0,7.0
4012,1973-1974,8,De Graafschap,Feyenoord,5,7,2,0,3,12,-2,4.0,10.0
4013,1973-1974,8,FC Den Haag-ADO,NEC Nijmegen,1,0,1,3,0,1,1,9.0,4.0
4014,1973-1974,8,Go Ahead Eagles,FC Groningen,5,0,1,3,0,5,5,9.0,1.0
4015,1973-1974,8,MVV Maastricht,AZ '67 Alkmaar,1,1,3,1,1,2,0,4.0,6.0
4016,1973-1974,8,PSV,FC Utrecht,5,0,1,3,0,5,5,10.0,6.0
4017,1973-1974,8,Roda JC Kerkrade,FC Amsterdam,0,0,3,1,1,0,0,5.0,11.0
4018,1973-1974,8,Sparta Rotterdam,NAC Breda,2,2,3,1,1,4,0,5.0,4.0
4019,1973-1974,8,Telstar,FC Twente,0,0,3,1,1,0,0,7.0,9.0
4020,1973-1974,9,PSV,Go Ahead Eagles,10,0,1,3,0,10,10,10.0,6.0
4021,1973-1974,9,AZ '67 Alkmaar,De Graafschap,4,0,1,3,0,4,4,8.0,4.0
4022,1973-1974,9,FC Amsterdam,FC Groningen,2,0,1,3,0,2,2,11.0,0.0
4023,1973-1974,9,FC Twente,FC Den Haag-ADO,2,0,1,3,0,2,2,11.0,9.0
4024,1973-1974,9,FC Utrecht,AFC Ajax,2,3,2,0,3,5,-1,6.0,13.0
4025,1973-1974,9,Feyenoord,Sparta Rotterdam,4,0,1,3,0,4,4,10.0,4.0
4026,1973-1974,9,HFC Haarlem,MVV Maastricht,2,2,3,1,1,4,0,7.0,5.0
4027,1973-1974,9,NAC Breda,Telstar,1,1,3,1,1,2,0,5.0,7.0
4028,1973-1974,9,NEC Nijmegen,Roda JC Kerkrade,4,0,1,3,0,4,4,4.0,4.0
4029,1973-1974,10,AFC Ajax,PSV,1,1,3,1,1,2,0,11.0,10.0
4030,1973-1974,10,De Graafschap,HFC Haarlem,1,1,3,1,1,2,0,2.0,5.0
4031,1973-1974,10,FC Den Haag-ADO,NAC Breda,8,3,1,3,0,11,5,9.0,5.0
4032,1973-1974,10,FC Groningen,NEC Nijmegen,2,0,1,3,0,2,2,3.0,4.0
4033,1973-1974,10,Go Ahead Eagles,FC Amsterdam,2,2,3,1,1,4,0,7.0,9.0
4034,1973-1974,10,MVV Maastricht,FC Utrecht,1,0,1,3,0,1,1,8.0,6.0
4035,1973-1974,10,Roda JC Kerkrade,FC Twente,0,2,2,0,3,2,-2,4.0,11.0
4036,1973-1974,10,Telstar,Feyenoord,3,2,1,3,0,5,1,7.0,9.0
4037,1973-1974,10,Sparta Rotterdam,AZ '67 Alkmaar,1,1,3,1,1,2,0,5.0,6.0
4038,1973-1974,11,AFC Ajax,Go Ahead Eagles,5,1,1,3,0,6,4,11.0,4.0
4039,1973-1974,11,AZ '67 Alkmaar,Telstar,2,1,1,3,0,3,1,9.0,6.0
4040,1973-1974,11,FC Twente,FC Groningen,3,2,1,3,0,5,1,13.0,3.0
4041,1973-1974,11,FC Utrecht,De Graafschap,3,1,1,3,0,4,2,6.0,1.0
4042,1973-1974,11,Feyenoord,FC Den Haag-ADO,3,3,3,1,1,6,0,10.0,7.0
4043,1973-1974,11,HFC Haarlem,Sparta Rotterdam,0,1,2,0,3,1,-1,5.0,5.0
4044,1973-1974,11,NAC Breda,Roda JC Kerkrade,2,0,1,3,0,2,2,8.0,4.0
4045,1973-1974,11,NEC Nijmegen,FC Amsterdam,0,0,3,1,1,0,0,5.0,9.0
4046,1973-1974,11,PSV,MVV Maastricht,4,2,1,3,0,6,2,10.0,5.0
4047,1973-1974,12,FC Amsterdam,FC Twente,2,3,2,0,3,5,-1,6.0,13.0
4048,1973-1974,12,FC Groningen,NAC Breda,4,2,1,3,0,6,2,6.0,5.0
4049,1973-1974,12,Go Ahead Eagles,NEC Nijmegen,1,1,3,1,1,2,0,5.0,5.0
4050,1973-1974,12,Sparta Rotterdam,FC Utrecht,2,1,1,3,0,3,1,8.0,3.0
4051,1973-1974,12,De Graafschap,PSV,0,3,2,0,3,3,-3,1.0,13.0
4052,1973-1974,12,FC Den Haag-ADO,AZ '67 Alkmaar,0,1,2,0,3,1,-1,7.0,11.0
4053,1973-1974,12,MVV Maastricht,AFC Ajax,0,4,2,0,3,4,-4,5.0,13.0
4054,1973-1974,12,Roda JC Kerkrade,Feyenoord,0,3,2,0,3,3,-3,1.0,10.0
4055,1973-1974,12,Telstar,HFC Haarlem,1,0,1,3,0,1,1,8.0,2.0
4056,1973-1974,13,FC Twente,NEC Nijmegen,2,0,1,3,0,2,2,15.0,5.0
4057,1973-1974,13,AFC Ajax,De Graafschap,4,0,1,3,0,4,4,13.0,1.0
4058,1973-1974,13,AZ '67 Alkmaar,Roda JC Kerkrade,1,1,3,1,1,2,0,11.0,1.0
4059,1973-1974,13,Feyenoord,FC Groningen,7,0,1,3,0,7,7,10.0,6.0
4060,1973-1974,13,PSV,Sparta Rotterdam,3,1,1,3,0,4,2,13.0,7.0
4061,1973-1974,13,FC Utrecht,Telstar,1,2,2,0,3,3,-1,3.0,10.0
4062,1973-1974,13,HFC Haarlem,FC Den Haag-ADO,0,1,2,0,3,1,-1,2.0,7.0
4063,1973-1974,13,MVV Maastricht,Go Ahead Eagles,1,0,1,3,0,1,1,7.0,2.0
4064,1973-1974,13,NAC Breda,FC Amsterdam,0,1,2,0,3,1,-1,4.0,8.0
4065,1973-1974,14,Feyenoord,NEC Nijmegen,6,1,1,3,0,7,5,10.0,2.0
4066,1973-1974,14,PSV,FC Den Haag-ADO,6,0,1,3,0,6,6,13.0,7.0
4067,1973-1974,14,AFC Ajax,Telstar,7,2,1,3,0,9,5,13.0,9.0
4068,1973-1974,14,AZ '67 Alkmaar,FC Amsterdam,0,2,2,0,3,2,-2,8.0,8.0
4069,1973-1974,14,De Graafschap,Go Ahead Eagles,3,0,1,3,0,3,3,4.0,2.0
4070,1973-1974,14,FC Utrecht,Roda JC Kerkrade,1,0,1,3,0,1,1,6.0,1.0
4071,1973-1974,14,HFC Haarlem,FC Groningen,0,2,2,0,3,2,-2,1.0,9.0
4072,1973-1974,14,MVV Maastricht,Sparta Rotterdam,0,3,2,0,3,3,-3,6.0,10.0
4073,1973-1974,14,NAC Breda,FC Twente,0,2,2,0,3,2,-2,3.0,15.0
4074,1973-1974,15,FC Groningen,FC Utrecht,2,2,3,1,1,4,0,7.0,7.0
4075,1973-1974,15,NAC Breda,Go Ahead Eagles,1,2,2,0,3,3,-1,3.0,4.0
4076,1973-1974,15,NEC Nijmegen,AZ '67 Alkmaar,0,1,2,0,3,1,-1,2.0,10.0
4077,1973-1974,15,Sparta Rotterdam,De Graafschap,2,1,1,3,0,3,1,12.0,3.0
4078,1973-1974,15,Telstar,MVV Maastricht,0,0,3,1,1,0,0,7.0,4.0
4079,1973-1974,15,FC Amsterdam,HFC Haarlem,0,1,2,0,3,1,-1,7.0,3.0
4080,1973-1974,15,FC Den Haag-ADO,AFC Ajax,0,1,2,0,3,1,-1,4.0,15.0
4081,1973-1974,15,FC Twente,Feyenoord,1,1,3,1,1,2,0,13.0,11.0
4082,1973-1974,15,Roda JC Kerkrade,PSV,1,3,2,0,3,4,-2,1.0,15.0
4083,1973-1974,16,AZ '67 Alkmaar,FC Twente,0,1,2,0,3,1,-1,7.0,13.0
4084,1973-1974,16,PSV,FC Groningen,4,0,1,3,0,4,4,15.0,7.0
4085,1973-1974,16,AFC Ajax,Roda JC Kerkrade,3,0,1,3,0,3,3,15.0,1.0
4086,1973-1974,16,De Graafschap,Telstar,1,1,3,1,1,2,0,4.0,8.0
4087,1973-1974,16,FC Utrecht,FC Amsterdam,1,1,3,1,1,2,0,5.0,7.0
4088,1973-1974,16,Feyenoord,NAC Breda,3,0,1,3,0,3,3,13.0,0.0
4089,1973-1974,16,Go Ahead Eagles,Sparta Rotterdam,1,0,1,3,0,1,1,7.0,9.0
4090,1973-1974,16,HFC Haarlem,NEC Nijmegen,2,1,1,3,0,3,1,6.0,1.0
4091,1973-1974,16,MVV Maastricht,FC Den Haag-ADO,0,0,3,1,1,0,0,5.0,4.0
4092,1973-1974,17,De Graafschap,MVV Maastricht,1,1,3,1,1,2,0,5.0,6.0
4093,1973-1974,17,FC Amsterdam,Feyenoord,1,1,3,1,1,2,0,8.0,11.0
4094,1973-1974,17,FC Den Haag-ADO,FC Utrecht,2,0,1,3,0,2,2,7.0,5.0
4095,1973-1974,17,FC Groningen,AZ '67 Alkmaar,0,2,2,0,3,2,-2,4.0,7.0
4096,1973-1974,17,Go Ahead Eagles,FC Twente,0,1,2,0,3,1,-1,6.0,13.0
4097,1973-1974,17,NEC Nijmegen,NAC Breda,1,2,2,0,3,3,-1,0.0,3.0
4098,1973-1974,17,Roda JC Kerkrade,HFC Haarlem,0,0,3,1,1,0,0,2.0,7.0
4099,1973-1974,17,Sparta Rotterdam,AFC Ajax,1,2,2,0,3,3,-1,6.0,15.0
4100,1973-1974,17,Telstar,PSV,1,1,3,1,1,2,0,6.0,13.0
4101,1973-1974,18,PSV,FC Amsterdam,2,1,1,3,0,3,1,13.0,5.0
4102,1973-1974,18,AFC Ajax,FC Groningen,9,0,1,3,0,9,9,15.0,4.0
4103,1973-1974,18,AZ '67 Alkmaar,NAC Breda,0,0,3,1,1,0,0,7.0,4.0
4104,1973-1974,18,De Graafschap,FC Den Haag-ADO,2,0,1,3,0,2,2,8.0,4.0
4105,1973-1974,18,FC Utrecht,NEC Nijmegen,2,1,1,3,0,3,1,8.0,0.0
4106,1973-1974,18,Go Ahead Eagles,Feyenoord,1,3,2,0,3,4,-2,6.0,11.0
4107,1973-1974,18,HFC Haarlem,FC Twente,1,2,2,0,3,3,-1,7.0,13.0
4108,1973-1974,18,MVV Maastricht,Roda JC Kerkrade,4,1,1,3,0,5,3,6.0,1.0
4109,1973-1974,18,Sparta Rotterdam,Telstar,1,2,2,0,3,3,-1,6.0,6.0
4110,1973-1974,19,FC Amsterdam,AFC Ajax,1,0,1,3,0,1,1,5.0,12.0
4111,1973-1974,19,FC Den Haag-ADO,Sparta Rotterdam,0,2,2,0,3,2,-2,4.0,6.0
4112,1973-1974,19,FC Groningen,MVV Maastricht,1,1,3,1,1,2,0,2.0,7.0
4113,1973-1974,19,FC Twente,FC Utrecht,2,0,1,3,0,2,2,13.0,5.0
4114,1973-1974,19,Feyenoord,AZ '67 Alkmaar,4,0,1,3,0,4,4,11.0,7.0
4115,1973-1974,19,NAC Breda,HFC Haarlem,0,3,2,0,3,3,-3,4.0,10.0
4116,1973-1974,19,NEC Nijmegen,PSV,1,2,2,0,3,3,-1,0.0,13.0
4117,1973-1974,19,Roda JC Kerkrade,De Graafschap,4,0,1,3,0,4,4,4.0,5.0
4118,1973-1974,19,Telstar,Go Ahead Eagles,0,1,2,0,3,1,-1,6.0,9.0
4119,1973-1974,20,AFC Ajax,NEC Nijmegen,2,1,1,3,0,3,1,12.0,0.0
4120,1973-1974,20,De Graafschap,FC Groningen,3,3,3,1,1,6,0,6.0,2.0
4121,1973-1974,20,FC Utrecht,NAC Breda,3,2,1,3,0,5,1,7.0,4.0
4122,1973-1974,20,Go Ahead Eagles,AZ '67 Alkmaar,1,1,3,1,1,2,0,7.0,5.0
4123,1973-1974,20,HFC Haarlem,Feyenoord,0,1,2,0,3,1,-1,7.0,13.0
4124,1973-1974,20,MVV Maastricht,FC Amsterdam,0,0,3,1,1,0,0,7.0,6.0
4125,1973-1974,20,PSV,FC Twente,1,1,3,1,1,2,0,11.0,13.0
4126,1973-1974,20,Sparta Rotterdam,Roda JC Kerkrade,2,1,1,3,0,3,1,6.0,4.0
4127,1973-1974,20,Telstar,FC Den Haag-ADO,3,0,1,3,0,3,3,8.0,4.0
4128,1973-1974,21,AZ '67 Alkmaar,HFC Haarlem,2,0,1,3,0,2,2,8.0,4.0
4129,1973-1974,21,FC Amsterdam,De Graafschap,2,1,1,3,0,3,1,8.0,5.0
4130,1973-1974,21,FC Den Haag-ADO,Go Ahead Eagles,1,1,3,1,1,2,0,4.0,5.0
4131,1973-1974,21,FC Groningen,Sparta Rotterdam,2,2,3,1,1,4,0,3.0,7.0
4132,1973-1974,21,FC Twente,AFC Ajax,0,0,3,1,1,0,0,11.0,10.0
4133,1973-1974,21,Feyenoord,FC Utrecht,2,1,1,3,0,3,1,13.0,6.0
4134,1973-1974,21,NAC Breda,PSV,2,4,2,0,3,6,-2,4.0,11.0
4135,1973-1974,21,NEC Nijmegen,MVV Maastricht,2,2,3,1,1,4,0,1.0,7.0
4136,1973-1974,21,Roda JC Kerkrade,Telstar,2,1,1,3,0,3,1,7.0,7.0
4137,1973-1974,22,PSV,Feyenoord,0,2,2,0,3,2,-2,10.0,15.0
4138,1973-1974,22,AFC Ajax,NAC Breda,3,0,1,3,0,3,3,10.0,1.0
4139,1973-1974,22,De Graafschap,NEC Nijmegen,1,0,1,3,0,1,1,7.0,1.0
4140,1973-1974,22,FC Den Haag-ADO,Roda JC Kerkrade,0,5,2,0,3,5,-5,1.0,9.0
4141,1973-1974,22,FC Utrecht,AZ '67 Alkmaar,2,1,1,3,0,3,1,9.0,5.0
4142,1973-1974,22,Go Ahead Eagles,HFC Haarlem,1,0,1,3,0,1,1,8.0,3.0
4143,1973-1974,22,MVV Maastricht,FC Twente,0,1,2,0,3,1,-1,6.0,11.0
4144,1973-1974,22,Sparta Rotterdam,FC Amsterdam,1,0,1,3,0,1,1,10.0,7.0
4145,1973-1974,22,Telstar,FC Groningen,3,0,1,3,0,3,3,9.0,3.0
4146,1973-1974,23,AZ '67 Alkmaar,PSV,2,2,3,1,1,4,0,5.0,8.0
4147,1973-1974,23,FC Amsterdam,Telstar,3,1,1,3,0,4,2,10.0,6.0
4148,1973-1974,23,FC Groningen,FC Den Haag-ADO,2,2,3,1,1,4,0,4.0,2.0
4149,1973-1974,23,FC Twente,De Graafschap,7,0,1,3,0,7,7,11.0,4.0
4150,1973-1974,23,Feyenoord,AFC Ajax,2,2,3,1,1,4,0,13.0,8.0
4151,1973-1974,23,HFC Haarlem,FC Utrecht,0,2,2,0,3,2,-2,3.0,9.0
4152,1973-1974,23,NAC Breda,MVV Maastricht,3,0,1,3,0,3,3,3.0,3.0
4153,1973-1974,23,NEC Nijmegen,Sparta Rotterdam,2,1,1,3,0,3,1,4.0,10.0
4154,1973-1974,23,Roda JC Kerkrade,Go Ahead Eagles,1,2,2,0,3,3,-1,9.0,11.0
4155,1973-1974,24,Go Ahead Eagles,FC Utrecht,2,1,1,3,0,3,1,11.0,9.0
4156,1973-1974,24,PSV,HFC Haarlem,1,1,3,1,1,2,0,6.0,1.0
4157,1973-1974,24,AFC Ajax,AZ '67 Alkmaar,2,0,1,3,0,2,2,11.0,5.0
4158,1973-1974,24,De Graafschap,NAC Breda,2,0,1,3,0,2,2,7.0,3.0
4159,1973-1974,24,FC Den Haag-ADO,FC Amsterdam,0,1,2,0,3,1,-1,2.0,10.0
4160,1973-1974,24,MVV Maastricht,Feyenoord,0,0,3,1,1,0,0,3.0,11.0
4161,1973-1974,24,Roda JC Kerkrade,FC Groningen,1,0,1,3,0,1,1,9.0,3.0
4162,1973-1974,24,Sparta Rotterdam,FC Twente,1,2,2,0,3,3,-1,7.0,11.0
4163,1973-1974,24,Telstar,NEC Nijmegen,2,1,1,3,0,3,1,9.0,4.0
4164,1973-1974,25,FC Groningen,Go Ahead Eagles,1,0,1,3,0,1,1,5.0,10.0
4165,1973-1974,25,AZ '67 Alkmaar,MVV Maastricht,1,2,2,0,3,3,-1,4.0,5.0
4166,1973-1974,25,FC Amsterdam,Roda JC Kerkrade,2,0,1,3,0,2,2,12.0,9.0
4167,1973-1974,25,FC Twente,Telstar,3,1,1,3,0,4,2,13.0,6.0
4168,1973-1974,25,FC Utrecht,PSV,4,3,1,3,0,7,1,9.0,5.0
4169,1973-1974,25,Feyenoord,De Graafschap,2,0,1,3,0,2,2,11.0,6.0
4170,1973-1974,25,HFC Haarlem,AFC Ajax,0,1,2,0,3,1,-1,1.0,11.0
4171,1973-1974,25,NAC Breda,Sparta Rotterdam,0,0,3,1,1,0,0,4.0,5.0
4172,1973-1974,25,NEC Nijmegen,FC Den Haag-ADO,0,0,3,1,1,0,0,5.0,3.0
4173,1973-1974,26,Go Ahead Eagles,PSV,3,5,2,0,3,8,-2,9.0,5.0
4174,1973-1974,26,AFC Ajax,FC Utrecht,5,2,1,3,0,7,3,13.0,9.0
4175,1973-1974,26,De Graafschap,AZ '67 Alkmaar,2,0,1,3,0,2,2,9.0,1.0
4176,1973-1974,26,FC Den Haag-ADO,FC Twente,0,0,3,1,1,0,0,3.0,13.0
4177,1973-1974,26,FC Groningen,FC Amsterdam,1,2,2,0,3,3,-1,4.0,12.0
4178,1973-1974,26,MVV Maastricht,HFC Haarlem,0,0,3,1,1,0,0,5.0,2.0
4179,1973-1974,26,Roda JC Kerkrade,NEC Nijmegen,1,1,3,1,1,2,0,7.0,5.0
4180,1973-1974,26,Sparta Rotterdam,Feyenoord,1,3,2,0,3,4,-2,4.0,11.0
4181,1973-1974,26,Telstar,NAC Breda,2,2,3,1,1,4,0,7.0,5.0
4182,1973-1974,27,PSV,AFC Ajax,3,1,1,3,0,4,2,8.0,10.0
4183,1973-1974,27,AZ '67 Alkmaar,Sparta Rotterdam,2,0,1,3,0,2,2,4.0,1.0
4184,1973-1974,27,FC Amsterdam,Go Ahead Eagles,3,0,1,3,0,3,3,15.0,6.0
4185,1973-1974,27,FC Twente,Roda JC Kerkrade,1,0,1,3,0,1,1,13.0,4.0
4186,1973-1974,27,FC Utrecht,MVV Maastricht,1,0,1,3,0,1,1,9.0,5.0
4187,1973-1974,27,Feyenoord,Telstar,1,0,1,3,0,1,1,11.0,4.0
4188,1973-1974,27,HFC Haarlem,De Graafschap,6,3,1,3,0,9,3,5.0,6.0
4189,1973-1974,27,NAC Breda,FC Den Haag-ADO,1,1,3,1,1,2,0,6.0,4.0
4190,1973-1974,27,NEC Nijmegen,FC Groningen,3,0,1,3,0,3,3,8.0,4.0
4191,1973-1974,28,FC Groningen,FC Twente,1,2,2,0,3,3,-1,3.0,13.0
4192,1973-1974,28,De Graafschap,FC Utrecht,3,0,1,3,0,3,3,9.0,6.0
4193,1973-1974,28,FC Amsterdam,NEC Nijmegen,5,0,1,3,0,5,5,15.0,5.0
4194,1973-1974,28,FC Den Haag-ADO,Feyenoord,0,2,2,0,3,2,-2,3.0,13.0
4195,1973-1974,28,Go Ahead Eagles,AFC Ajax,2,2,3,1,1,4,0,4.0,10.0
4196,1973-1974,28,MVV Maastricht,PSV,4,3,1,3,0,7,1,8.0,7.0
4197,1973-1974,28,Roda JC Kerkrade,NAC Breda,0,0,3,1,1,0,0,5.0,4.0
4198,1973-1974,28,Sparta Rotterdam,HFC Haarlem,1,0,1,3,0,1,1,4.0,5.0
4199,1973-1974,28,Telstar,AZ '67 Alkmaar,3,0,1,3,0,3,3,7.0,3.0
4200,1973-1974,29,AFC Ajax,MVV Maastricht,4,1,1,3,0,5,3,10.0,7.0
4201,1973-1974,29,AZ '67 Alkmaar,FC Den Haag-ADO,1,1,3,1,1,2,0,4.0,4.0
4202,1973-1974,29,FC Twente,FC Amsterdam,2,0,1,3,0,2,2,13.0,12.0
4203,1973-1974,29,FC Utrecht,Sparta Rotterdam,2,2,3,1,1,4,0,7.0,5.0
4204,1973-1974,29,Feyenoord,Roda JC Kerkrade,8,0,1,3,0,8,8,15.0,2.0
4205,1973-1974,29,HFC Haarlem,Telstar,2,1,1,3,0,3,1,7.0,4.0
4206,1973-1974,29,NAC Breda,FC Groningen,4,1,1,3,0,5,3,7.0,3.0
4207,1973-1974,29,NEC Nijmegen,Go Ahead Eagles,2,2,3,1,1,4,0,6.0,2.0
4208,1973-1974,29,PSV,De Graafschap,3,0,1,3,0,3,3,9.0,6.0
4209,1973-1974,30,Go Ahead Eagles,MVV Maastricht,0,0,3,1,1,0,0,3.0,5.0
4210,1973-1974,30,Sparta Rotterdam,PSV,1,1,3,1,1,2,0,5.0,10.0
4211,1973-1974,30,De Graafschap,AFC Ajax,1,0,1,3,0,1,1,9.0,7.0
4212,1973-1974,30,FC Amsterdam,NAC Breda,2,2,3,1,1,4,0,10.0,7.0
4213,1973-1974,30,FC Den Haag-ADO,HFC Haarlem,1,0,1,3,0,1,1,6.0,7.0
4214,1973-1974,30,FC Groningen,Feyenoord,0,3,2,0,3,3,-3,0.0,15.0
4215,1973-1974,30,NEC Nijmegen,FC Twente,0,2,2,0,3,2,-2,5.0,13.0
4216,1973-1974,30,Roda JC Kerkrade,AZ '67 Alkmaar,0,0,3,1,1,0,0,3.0,5.0
4217,1973-1974,30,Telstar,FC Utrecht,2,2,3,1,1,4,0,5.0,5.0
4218,1973-1974,31,AFC Ajax,Sparta Rotterdam,0,0,3,1,1,0,0,5.0,6.0
4219,1973-1974,31,Feyenoord,FC Amsterdam,5,0,1,3,0,5,5,15.0,7.0
4220,1973-1974,31,AZ '67 Alkmaar,FC Groningen,3,1,1,3,0,4,2,8.0,0.0
4221,1973-1974,31,FC Twente,Go Ahead Eagles,2,1,1,3,0,3,1,15.0,3.0
4222,1973-1974,31,FC Utrecht,FC Den Haag-ADO,3,1,1,3,0,4,2,8.0,5.0
4223,1973-1974,31,HFC Haarlem,Roda JC Kerkrade,1,0,1,3,0,1,1,9.0,2.0
4224,1973-1974,31,MVV Maastricht,De Graafschap,4,1,1,3,0,5,3,7.0,6.0
4225,1973-1974,31,NAC Breda,NEC Nijmegen,1,3,2,0,3,4,-2,6.0,7.0
4226,1973-1974,31,PSV,Telstar,1,1,3,1,1,2,0,8.0,5.0
4227,1973-1974,32,FC Amsterdam,AZ '67 Alkmaar,1,0,1,3,0,1,1,7.0,5.0
4228,1973-1974,32,FC Groningen,HFC Haarlem,2,1,1,3,0,3,1,3.0,6.0
4229,1973-1974,32,FC Den Haag-ADO,PSV,0,3,2,0,3,3,-3,4.0,8.0
4230,1973-1974,32,FC Twente,NAC Breda,5,2,1,3,0,7,3,15.0,5.0
4231,1973-1974,32,Go Ahead Eagles,De Graafschap,1,1,3,1,1,2,0,4.0,7.0
4232,1973-1974,32,NEC Nijmegen,Feyenoord,0,2,2,0,3,2,-2,4.0,15.0
4233,1973-1974,32,Roda JC Kerkrade,FC Utrecht,5,2,1,3,0,7,3,5.0,5.0
4234,1973-1974,32,Sparta Rotterdam,MVV Maastricht,1,1,3,1,1,2,0,7.0,8.0
4235,1973-1974,32,Telstar,AFC Ajax,2,1,1,3,0,3,1,8.0,5.0
4236,1973-1974,33,AFC Ajax,FC Den Haag-ADO,3,1,1,3,0,4,2,7.0,4.0
4237,1973-1974,33,AZ '67 Alkmaar,NEC Nijmegen,0,0,3,1,1,0,0,6.0,5.0
4238,1973-1974,33,De Graafschap,Sparta Rotterdam,1,1,3,1,1,2,0,5.0,5.0
4239,1973-1974,33,FC Utrecht,FC Groningen,2,3,2,0,3,5,-1,5.0,6.0
4240,1973-1974,33,Feyenoord,FC Twente,3,2,1,3,0,5,1,15.0,12.0
4241,1973-1974,33,Go Ahead Eagles,NAC Breda,1,1,3,1,1,2,0,4.0,5.0
4242,1973-1974,33,HFC Haarlem,FC Amsterdam,2,0,1,3,0,2,2,9.0,4.0
4243,1973-1974,33,MVV Maastricht,Telstar,0,2,2,0,3,2,-2,5.0,8.0
4244,1973-1974,33,PSV,Roda JC Kerkrade,3,0,1,3,0,3,3,11.0,4.0
4245,1973-1974,34,FC Amsterdam,FC Utrecht,2,1,1,3,0,3,1,7.0,4.0
4246,1973-1974,34,Sparta Rotterdam,Go Ahead Eagles,1,3,2,0,3,4,-2,4.0,6.0
4247,1973-1974,34,FC Den Haag-ADO,MVV Maastricht,1,1,3,1,1,2,0,4.0,6.0
4248,1973-1974,34,FC Groningen,PSV,1,2,2,0,3,3,-1,6.0,11.0
4249,1973-1974,34,FC Twente,AZ '67 Alkmaar,2,5,2,0,3,7,-3,9.0,8.0
4250,1973-1974,34,NAC Breda,Feyenoord,1,0,1,3,0,1,1,5.0,12.0
4251,1973-1974,34,NEC Nijmegen,HFC Haarlem,3,0,1,3,0,3,3,7.0,6.0
4252,1973-1974,34,Roda JC Kerkrade,AFC Ajax,0,0,3,1,1,0,0,5.0,5.0
4253,1973-1974,34,Telstar,De Graafschap,5,3,1,3,0,8,2,11.0,5.0
4254,1974-1975,1,AFC Ajax,SBV Excelsior,2,0,1,3,0,2,2,8.0,4.0
4255,1974-1975,1,AZ '67 Alkmaar,WVV Wageningen,1,0,1,3,0,1,1,10.0,
4256,1974-1975,1,De Graafschap,NAC Breda,1,0,1,3,0,1,1,5.0,4.0
4257,1974-1975,1,FC Den Haag-ADO,Sparta Rotterdam,0,0,3,1,1,0,0,2.0,4.0
4258,1974-1975,1,FC Utrecht,FC Twente,0,0,3,1,1,0,0,4.0,7.0
4259,1974-1975,1,Feyenoord,Roda JC Kerkrade,4,0,1,3,0,4,4,12.0,4.0
4260,1974-1975,1,Go Ahead Eagles,FC Amsterdam,1,1,3,1,1,2,0,6.0,7.0
4261,1974-1975,1,HFC Haarlem,Telstar,1,1,3,1,1,2,0,7.0,11.0
4262,1974-1975,1,MVV Maastricht,PSV,1,3,2,0,3,4,-2,5.0,13.0
4263,1974-1975,2,SBV Excelsior,FC Den Haag-ADO,0,0,3,1,1,0,0,5.0,3.0
4264,1974-1975,2,FC Amsterdam,FC Utrecht,1,1,3,1,1,2,0,8.0,2.0
4265,1974-1975,2,FC Twente,HFC Haarlem,4,0,1,3,0,4,4,7.0,4.0
4266,1974-1975,2,WVV Wageningen,De Graafschap,1,1,3,1,1,2,0,,6.0
4267,1974-1975,2,NAC Breda,AFC Ajax,1,4,2,0,3,5,-3,4.0,10.0
4268,1974-1975,2,PSV,Feyenoord,3,2,1,3,0,5,1,15.0,9.0
4269,1974-1975,2,Roda JC Kerkrade,Go Ahead Eagles,2,1,1,3,0,3,1,7.0,6.0
4270,1974-1975,2,Telstar,AZ '67 Alkmaar,1,0,1,3,0,1,1,13.0,7.0
4271,1974-1975,2,Sparta Rotterdam,MVV Maastricht,2,2,3,1,1,4,0,4.0,3.0
4272,1974-1975,3,AFC Ajax,WVV Wageningen,3,1,1,3,0,4,2,13.0,
4273,1974-1975,3,Sparta Rotterdam,PSV,1,2,2,0,3,3,-1,3.0,15.0
4274,1974-1975,3,AZ '67 Alkmaar,FC Twente,1,1,3,1,1,2,0,8.0,5.0
4275,1974-1975,3,De Graafschap,Telstar,1,1,3,1,1,2,0,6.0,11.0
4276,1974-1975,3,FC Den Haag-ADO,NAC Breda,4,1,1,3,0,5,3,6.0,4.0
4277,1974-1975,3,FC Utrecht,Roda JC Kerkrade,1,3,2,0,3,4,-2,2.0,7.0
4278,1974-1975,3,Go Ahead Eagles,Feyenoord,0,6,2,0,3,6,-6,5.0,9.0
4279,1974-1975,3,HFC Haarlem,FC Amsterdam,1,3,2,0,3,4,-2,4.0,8.0
4280,1974-1975,3,MVV Maastricht,SBV Excelsior,0,1,2,0,3,1,-1,2.0,8.0
4281,1974-1975,4,SBV Excelsior,Sparta Rotterdam,2,2,3,1,1,4,0,6.0,3.0
4282,1974-1975,4,PSV,Go Ahead Eagles,5,1,1,3,0,6,4,15.0,4.0
4283,1974-1975,4,FC Twente,De Graafschap,2,0,1,3,0,2,2,8.0,5.0
4284,1974-1975,4,WVV Wageningen,FC Den Haag-ADO,1,1,3,1,1,2,0,,7.0
4285,1974-1975,4,Feyenoord,FC Utrecht,5,0,1,3,0,5,5,9.0,2.0
4286,1974-1975,4,NAC Breda,MVV Maastricht,1,1,3,1,1,2,0,4.0,3.0
4287,1974-1975,4,Roda JC Kerkrade,HFC Haarlem,4,2,1,3,0,6,2,10.0,1.0
4288,1974-1975,4,Telstar,AFC Ajax,1,4,2,0,3,5,-3,8.0,13.0
4289,1974-1975,4,FC Amsterdam,AZ '67 Alkmaar,0,0,3,1,1,0,0,9.0,8.0
4290,1974-1975,5,AFC Ajax,FC Twente,1,0,1,3,0,1,1,15.0,8.0
4291,1974-1975,5,Sparta Rotterdam,NAC Breda,4,2,1,3,0,6,2,6.0,1.0
4292,1974-1975,5,AZ '67 Alkmaar,Roda JC Kerkrade,0,0,3,1,1,0,0,6.0,10.0
4293,1974-1975,5,De Graafschap,FC Amsterdam,2,1,1,3,0,3,1,8.0,6.0
4294,1974-1975,5,SBV Excelsior,PSV,1,3,2,0,3,4,-2,5.0,15.0
4295,1974-1975,5,FC Den Haag-ADO,Telstar,2,0,1,3,0,2,2,9.0,5.0
4296,1974-1975,5,FC Utrecht,Go Ahead Eagles,3,0,1,3,0,3,3,5.0,1.0
4297,1974-1975,5,HFC Haarlem,Feyenoord,0,3,2,0,3,3,-3,1.0,12.0
4298,1974-1975,5,MVV Maastricht,WVV Wageningen,2,1,1,3,0,3,1,5.0,2.0
4299,1974-1975,6,Go Ahead Eagles,HFC Haarlem,2,0,1,3,0,2,2,3.0,0.0
4300,1974-1975,6,PSV,FC Utrecht,6,0,1,3,0,6,6,15.0,4.0
4301,1974-1975,6,FC Amsterdam,AFC Ajax,1,2,2,0,3,3,-1,5.0,15.0
4302,1974-1975,6,FC Twente,FC Den Haag-ADO,3,0,1,3,0,3,3,10.0,8.0
4303,1974-1975,6,WVV Wageningen,Sparta Rotterdam,1,0,1,3,0,1,1,5.0,5.0
4304,1974-1975,6,Feyenoord,AZ '67 Alkmaar,2,1,1,3,0,3,1,12.0,3.0
4305,1974-1975,6,NAC Breda,SBV Excelsior,1,1,3,1,1,2,0,2.0,6.0
4306,1974-1975,6,Roda JC Kerkrade,De Graafschap,2,0,1,3,0,2,2,13.0,5.0
4307,1974-1975,6,Telstar,MVV Maastricht,2,0,1,3,0,2,2,7.0,5.0
4308,1974-1975,7,AFC Ajax,Roda JC Kerkrade,6,1,1,3,0,7,5,15.0,10.0
4309,1974-1975,7,AZ '67 Alkmaar,Go Ahead Eagles,1,0,1,3,0,1,1,6.0,3.0
4310,1974-1975,7,De Graafschap,Feyenoord,1,6,2,0,3,7,-5,4.0,15.0
4311,1974-1975,7,SBV Excelsior,WVV Wageningen,1,0,1,3,0,1,1,8.0,4.0
4312,1974-1975,7,FC Den Haag-ADO,FC Amsterdam,2,1,1,3,0,3,1,10.0,4.0
4313,1974-1975,7,HFC Haarlem,FC Utrecht,1,0,1,3,0,1,1,3.0,3.0
4314,1974-1975,7,MVV Maastricht,FC Twente,2,4,2,0,3,6,-2,4.0,10.0
4315,1974-1975,7,NAC Breda,PSV,0,4,2,0,3,4,-4,2.0,15.0
4316,1974-1975,7,Sparta Rotterdam,Telstar,4,1,1,3,0,5,3,7.0,4.0
4317,1974-1975,8,Go Ahead Eagles,De Graafschap,2,0,1,3,0,2,2,6.0,3.0
4318,1974-1975,8,FC Amsterdam,MVV Maastricht,0,0,3,1,1,0,0,2.0,5.0
4319,1974-1975,8,FC Twente,Sparta Rotterdam,1,0,1,3,0,1,1,12.0,7.0
4320,1974-1975,8,FC Utrecht,AZ '67 Alkmaar,2,1,1,3,0,3,1,6.0,5.0
4321,1974-1975,8,WVV Wageningen,NAC Breda,1,1,3,1,1,2,0,5.0,3.0
4322,1974-1975,8,Feyenoord,AFC Ajax,2,1,1,3,0,3,1,15.0,12.0
4323,1974-1975,8,PSV,HFC Haarlem,3,2,1,3,0,5,1,15.0,3.0
4324,1974-1975,8,Roda JC Kerkrade,FC Den Haag-ADO,3,1,1,3,0,4,2,10.0,7.0
4325,1974-1975,8,Telstar,SBV Excelsior,1,1,3,1,1,2,0,4.0,6.0
4326,1974-1975,9,FC Den Haag-ADO,Feyenoord,3,3,3,1,1,6,0,7.0,13.0
4327,1974-1975,9,AFC Ajax,Go Ahead Eagles,3,0,1,3,0,3,3,12.0,6.0
4328,1974-1975,9,AZ '67 Alkmaar,HFC Haarlem,2,0,1,3,0,2,2,7.0,3.0
4329,1974-1975,9,De Graafschap,FC Utrecht,2,1,1,3,0,3,1,6.0,6.0
4330,1974-1975,9,SBV Excelsior,FC Twente,3,1,1,3,0,4,2,8.0,9.0
4331,1974-1975,9,WVV Wageningen,PSV,1,1,3,1,1,2,0,5.0,13.0
4332,1974-1975,9,MVV Maastricht,Roda JC Kerkrade,3,2,1,3,0,5,1,7.0,7.0
4333,1974-1975,9,NAC Breda,Telstar,1,1,3,1,1,2,0,3.0,5.0
4334,1974-1975,9,Sparta Rotterdam,FC Amsterdam,2,1,1,3,0,3,1,9.0,1.0
4335,1974-1975,10,FC Amsterdam,SBV Excelsior,1,1,3,1,1,2,0,2.0,9.0
4336,1974-1975,10,FC Twente,NAC Breda,2,0,1,3,0,2,2,12.0,3.0
4337,1974-1975,10,FC Utrecht,AFC Ajax,1,1,3,1,1,2,0,4.0,10.0
4338,1974-1975,10,Feyenoord,MVV Maastricht,2,1,1,3,0,3,1,13.0,4.0
4339,1974-1975,10,Go Ahead Eagles,FC Den Haag-ADO,3,1,1,3,0,4,2,9.0,4.0
4340,1974-1975,10,HFC Haarlem,De Graafschap,0,4,2,0,3,4,-4,3.0,6.0
4341,1974-1975,10,PSV,AZ '67 Alkmaar,4,0,1,3,0,4,4,13.0,6.0
4342,1974-1975,10,Roda JC Kerkrade,Sparta Rotterdam,1,1,3,1,1,2,0,7.0,7.0
4343,1974-1975,10,Telstar,WVV Wageningen,3,1,1,3,0,4,2,8.0,5.0
4344,1974-1975,11,AFC Ajax,HFC Haarlem,4,0,1,3,0,4,4,10.0,3.0
4345,1974-1975,11,De Graafschap,AZ '67 Alkmaar,0,5,2,0,3,5,-5,6.0,9.0
4346,1974-1975,11,SBV Excelsior,Roda JC Kerkrade,2,1,1,3,0,3,1,11.0,4.0
4347,1974-1975,11,FC Den Haag-ADO,FC Utrecht,1,2,2,0,3,3,-1,4.0,7.0
4348,1974-1975,11,WVV Wageningen,FC Twente,2,1,1,3,0,3,1,5.0,9.0
4349,1974-1975,11,MVV Maastricht,Go Ahead Eagles,1,0,1,3,0,1,1,7.0,6.0
4350,1974-1975,11,NAC Breda,FC Amsterdam,3,0,1,3,0,3,3,5.0,2.0
4351,1974-1975,11,Sparta Rotterdam,Feyenoord,0,0,3,1,1,0,0,8.0,11.0
4352,1974-1975,11,Telstar,PSV,2,2,3,1,1,4,0,6.0,11.0
4353,1974-1975,12,AZ '67 Alkmaar,AFC Ajax,3,0,1,3,0,3,3,9.0,7.0
4354,1974-1975,12,FC Amsterdam,WVV Wageningen,1,1,3,1,1,2,0,3.0,6.0
4355,1974-1975,12,FC Twente,Telstar,1,1,3,1,1,2,0,7.0,7.0
4356,1974-1975,12,FC Utrecht,MVV Maastricht,4,2,1,3,0,6,2,10.0,7.0
4357,1974-1975,12,Feyenoord,SBV Excelsior,2,1,1,3,0,3,1,11.0,8.0
4358,1974-1975,12,Go Ahead Eagles,Sparta Rotterdam,1,1,3,1,1,2,0,7.0,6.0
4359,1974-1975,12,HFC Haarlem,FC Den Haag-ADO,1,1,3,1,1,2,0,1.0,2.0
4360,1974-1975,12,PSV,De Graafschap,3,0,1,3,0,3,3,11.0,6.0
4361,1974-1975,12,Roda JC Kerkrade,NAC Breda,1,0,1,3,0,1,1,7.0,5.0
4362,1974-1975,13,SBV Excelsior,Go Ahead Eagles,1,2,2,0,3,3,-1,7.0,7.0
4363,1974-1975,13,FC Den Haag-ADO,AZ '67 Alkmaar,0,0,3,1,1,0,0,3.0,10.0
4364,1974-1975,13,WVV Wageningen,Roda JC Kerkrade,2,2,3,1,1,4,0,6.0,5.0
4365,1974-1975,13,MVV Maastricht,HFC Haarlem,2,2,3,1,1,4,0,7.0,2.0
4366,1974-1975,13,NAC Breda,Feyenoord,1,5,2,0,3,6,-4,4.0,11.0
4367,1974-1975,13,Sparta Rotterdam,FC Utrecht,1,0,1,3,0,1,1,9.0,7.0
4368,1974-1975,13,Telstar,FC Amsterdam,0,2,2,0,3,2,-2,6.0,5.0
4369,1974-1975,13,FC Twente,PSV,2,1,1,3,0,3,1,7.0,8.0
4370,1974-1975,13,AFC Ajax,De Graafschap,3,1,1,3,0,4,2,10.0,6.0
4371,1974-1975,14,AZ '67 Alkmaar,MVV Maastricht,2,0,1,3,0,2,2,10.0,4.0
4372,1974-1975,14,De Graafschap,FC Den Haag-ADO,1,0,1,3,0,1,1,6.0,2.0
4373,1974-1975,14,FC Amsterdam,FC Twente,0,3,2,0,3,3,-3,5.0,10.0
4374,1974-1975,14,FC Utrecht,SBV Excelsior,3,1,1,3,0,4,2,10.0,4.0
4375,1974-1975,14,Feyenoord,WVV Wageningen,8,2,1,3,0,10,6,13.0,5.0
4376,1974-1975,14,Go Ahead Eagles,NAC Breda,2,0,1,3,0,2,2,10.0,3.0
4377,1974-1975,14,HFC Haarlem,Sparta Rotterdam,1,3,2,0,3,4,-2,2.0,9.0
4378,1974-1975,14,PSV,AFC Ajax,1,1,3,1,1,2,0,8.0,8.0
4379,1974-1975,14,Roda JC Kerkrade,Telstar,0,1,2,0,3,1,-1,5.0,8.0
4380,1974-1975,15,SBV Excelsior,HFC Haarlem,1,1,3,1,1,2,0,4.0,3.0
4381,1974-1975,15,FC Amsterdam,PSV,1,2,2,0,3,3,-1,4.0,8.0
4382,1974-1975,15,FC Den Haag-ADO,AFC Ajax,1,0,1,3,0,1,1,5.0,7.0
4383,1974-1975,15,FC Twente,Roda JC Kerkrade,3,0,1,3,0,3,3,10.0,4.0
4384,1974-1975,15,WVV Wageningen,Go Ahead Eagles,1,0,1,3,0,1,1,8.0,7.0
4385,1974-1975,15,MVV Maastricht,De Graafschap,1,0,1,3,0,1,1,7.0,3.0
4386,1974-1975,15,NAC Breda,FC Utrecht,3,1,1,3,0,4,2,6.0,9.0
4387,1974-1975,15,Sparta Rotterdam,AZ '67 Alkmaar,0,0,3,1,1,0,0,9.0,11.0
4388,1974-1975,15,Telstar,Feyenoord,0,4,2,0,3,4,-4,5.0,13.0
4389,1974-1975,16,AFC Ajax,MVV Maastricht,4,2,1,3,0,6,2,7.0,4.0
4390,1974-1975,16,AZ '67 Alkmaar,SBV Excelsior,1,1,3,1,1,2,0,9.0,2.0
4391,1974-1975,16,De Graafschap,Sparta Rotterdam,0,0,3,1,1,0,0,4.0,9.0
4392,1974-1975,16,FC Den Haag-ADO,PSV,1,1,3,1,1,2,0,6.0,8.0
4393,1974-1975,16,FC Utrecht,WVV Wageningen,7,1,1,3,0,8,6,9.0,5.0
4394,1974-1975,16,Feyenoord,FC Twente,4,0,1,3,0,4,4,15.0,10.0
4395,1974-1975,16,Go Ahead Eagles,Telstar,0,0,3,1,1,0,0,8.0,5.0
4396,1974-1975,16,HFC Haarlem,NAC Breda,1,1,3,1,1,2,0,4.0,4.0
4397,1974-1975,16,Roda JC Kerkrade,FC Amsterdam,1,1,3,1,1,2,0,5.0,5.0
4398,1974-1975,17,SBV Excelsior,AFC Ajax,1,2,2,0,3,3,-1,2.0,10.0
4399,1974-1975,17,FC Amsterdam,Go Ahead Eagles,2,0,1,3,0,2,2,7.0,7.0
4400,1974-1975,17,FC Twente,FC Utrecht,4,1,1,3,0,5,3,12.0,6.0
4401,1974-1975,17,WVV Wageningen,AZ '67 Alkmaar,2,6,2,0,3,8,-4,4.0,9.0
4402,1974-1975,17,NAC Breda,De Graafschap,1,1,3,1,1,2,0,5.0,5.0
4403,1974-1975,17,PSV,MVV Maastricht,1,1,3,1,1,2,0,6.0,5.0
4404,1974-1975,17,Roda JC Kerkrade,Feyenoord,1,0,1,3,0,1,1,5.0,12.0
4405,1974-1975,17,Sparta Rotterdam,FC Den Haag-ADO,0,0,3,1,1,0,0,9.0,6.0
4406,1974-1975,17,Telstar,HFC Haarlem,2,2,3,1,1,4,0,5.0,4.0
4407,1974-1975,18,AFC Ajax,NAC Breda,5,1,1,3,0,6,4,10.0,5.0
4408,1974-1975,18,AZ '67 Alkmaar,Telstar,2,1,1,3,0,3,1,11.0,5.0
4409,1974-1975,18,De Graafschap,WVV Wageningen,1,0,1,3,0,1,1,8.0,3.0
4410,1974-1975,18,FC Den Haag-ADO,SBV Excelsior,1,0,1,3,0,1,1,8.0,2.0
4411,1974-1975,18,FC Utrecht,FC Amsterdam,2,2,3,1,1,4,0,7.0,5.0
4412,1974-1975,18,Feyenoord,PSV,2,3,2,0,3,5,-1,9.0,9.0
4413,1974-1975,18,Go Ahead Eagles,Roda JC Kerkrade,2,2,3,1,1,4,0,5.0,5.0
4414,1974-1975,18,HFC Haarlem,FC Twente,1,0,1,3,0,1,1,6.0,9.0
4415,1974-1975,18,MVV Maastricht,Sparta Rotterdam,1,1,3,1,1,2,0,5.0,7.0
4416,1974-1975,19,FC Twente,AZ '67 Alkmaar,1,1,3,1,1,2,0,7.0,9.0
4417,1974-1975,19,PSV,Sparta Rotterdam,1,0,1,3,0,1,1,11.0,4.0
4418,1974-1975,19,SBV Excelsior,MVV Maastricht,0,0,3,1,1,0,0,3.0,6.0
4419,1974-1975,19,FC Amsterdam,HFC Haarlem,2,1,1,3,0,3,1,8.0,6.0
4420,1974-1975,19,WVV Wageningen,AFC Ajax,0,2,2,0,3,2,-2,3.0,12.0
4421,1974-1975,19,Feyenoord,Go Ahead Eagles,3,1,1,3,0,4,2,9.0,2.0
4422,1974-1975,19,NAC Breda,FC Den Haag-ADO,2,2,3,1,1,4,0,6.0,9.0
4423,1974-1975,19,Roda JC Kerkrade,FC Utrecht,3,0,1,3,0,3,3,8.0,4.0
4424,1974-1975,19,Telstar,De Graafschap,2,1,1,3,0,3,1,5.0,5.0
4425,1974-1975,20,AFC Ajax,Telstar,1,1,3,1,1,2,0,13.0,6.0
4426,1974-1975,20,AZ '67 Alkmaar,FC Amsterdam,2,0,1,3,0,2,2,11.0,8.0
4427,1974-1975,20,De Graafschap,FC Twente,0,1,2,0,3,1,-1,5.0,7.0
4428,1974-1975,20,FC Den Haag-ADO,WVV Wageningen,2,0,1,3,0,2,2,9.0,0.0
4429,1974-1975,20,FC Utrecht,Feyenoord,0,0,3,1,1,0,0,5.0,7.0
4430,1974-1975,20,Go Ahead Eagles,PSV,0,0,3,1,1,0,0,3.0,9.0
4431,1974-1975,20,HFC Haarlem,Roda JC Kerkrade,4,2,1,3,0,6,2,8.0,8.0
4432,1974-1975,20,MVV Maastricht,NAC Breda,0,1,2,0,3,1,-1,3.0,6.0
4433,1974-1975,20,Sparta Rotterdam,SBV Excelsior,3,1,1,3,0,4,2,6.0,2.0
4434,1974-1975,21,PSV,SBV Excelsior,7,0,1,3,0,7,7,11.0,1.0
4435,1974-1975,21,FC Amsterdam,De Graafschap,6,0,1,3,0,6,6,10.0,4.0
4436,1974-1975,21,FC Twente,AFC Ajax,1,3,2,0,3,4,-2,7.0,13.0
4437,1974-1975,21,WVV Wageningen,MVV Maastricht,2,0,1,3,0,2,2,3.0,3.0
4438,1974-1975,21,Feyenoord,HFC Haarlem,4,0,1,3,0,4,4,7.0,7.0
4439,1974-1975,21,Go Ahead Eagles,FC Utrecht,1,1,3,1,1,2,0,3.0,3.0
4440,1974-1975,21,NAC Breda,Sparta Rotterdam,0,2,2,0,3,2,-2,5.0,8.0
4441,1974-1975,21,Roda JC Kerkrade,AZ '67 Alkmaar,2,2,3,1,1,4,0,8.0,11.0
4442,1974-1975,21,Telstar,FC Den Haag-ADO,1,0,1,3,0,1,1,8.0,8.0
4443,1974-1975,22,AFC Ajax,FC Amsterdam,2,4,2,0,3,6,-2,10.0,10.0
4444,1974-1975,22,AZ '67 Alkmaar,Feyenoord,1,1,3,1,1,2,0,9.0,8.0
4445,1974-1975,22,De Graafschap,Roda JC Kerkrade,1,1,3,1,1,2,0,4.0,6.0
4446,1974-1975,22,SBV Excelsior,NAC Breda,3,0,1,3,0,3,3,4.0,4.0
4447,1974-1975,22,FC Den Haag-ADO,FC Twente,1,3,2,0,3,4,-2,7.0,7.0
4448,1974-1975,22,FC Utrecht,PSV,0,0,3,1,1,0,0,4.0,11.0
4449,1974-1975,22,HFC Haarlem,Go Ahead Eagles,2,0,1,3,0,2,2,9.0,3.0
4450,1974-1975,22,MVV Maastricht,Telstar,2,2,3,1,1,4,0,3.0,8.0
4451,1974-1975,22,Sparta Rotterdam,WVV Wageningen,3,3,3,1,1,6,0,8.0,4.0
4452,1974-1975,23,FC Twente,MVV Maastricht,2,2,3,1,1,4,0,8.0,3.0
4453,1974-1975,23,PSV,NAC Breda,1,0,1,3,0,1,1,11.0,4.0
4454,1974-1975,23,FC Amsterdam,FC Den Haag-ADO,1,1,3,1,1,2,0,10.0,5.0
4455,1974-1975,23,FC Utrecht,HFC Haarlem,3,0,1,3,0,3,3,6.0,6.0
4456,1974-1975,23,WVV Wageningen,SBV Excelsior,2,2,3,1,1,4,0,5.0,5.0
4457,1974-1975,23,Feyenoord,De Graafschap,2,0,1,3,0,2,2,11.0,1.0
4458,1974-1975,23,Go Ahead Eagles,AZ '67 Alkmaar,1,0,1,3,0,1,1,5.0,6.0
4459,1974-1975,23,Roda JC Kerkrade,AFC Ajax,0,1,2,0,3,1,-1,5.0,10.0
4460,1974-1975,23,Telstar,Sparta Rotterdam,1,1,3,1,1,2,0,9.0,8.0
4461,1974-1975,24,AFC Ajax,Feyenoord,0,1,2,0,3,1,-1,7.0,11.0
4462,1974-1975,24,AZ '67 Alkmaar,FC Utrecht,5,0,1,3,0,5,5,8.0,6.0
4463,1974-1975,24,De Graafschap,Go Ahead Eagles,3,0,1,3,0,3,3,4.0,5.0
4464,1974-1975,24,SBV Excelsior,Telstar,0,0,3,1,1,0,0,5.0,7.0
4465,1974-1975,24,FC Den Haag-ADO,Roda JC Kerkrade,1,1,3,1,1,2,0,5.0,3.0
4466,1974-1975,24,HFC Haarlem,PSV,1,1,3,1,1,2,0,7.0,9.0
4467,1974-1975,24,MVV Maastricht,FC Amsterdam,3,1,1,3,0,4,2,5.0,7.0
4468,1974-1975,24,NAC Breda,WVV Wageningen,0,0,3,1,1,0,0,4.0,6.0
4469,1974-1975,24,Sparta Rotterdam,FC Twente,1,1,3,1,1,2,0,9.0,8.0
4470,1974-1975,25,FC Twente,SBV Excelsior,2,0,1,3,0,2,2,8.0,5.0
4471,1974-1975,25,Go Ahead Eagles,AFC Ajax,2,2,3,1,1,4,0,5.0,7.0
4472,1974-1975,25,PSV,WVV Wageningen,2,0,1,3,0,2,2,11.0,6.0
4473,1974-1975,25,FC Amsterdam,Sparta Rotterdam,5,2,1,3,0,7,3,10.0,6.0
4474,1974-1975,25,FC Utrecht,De Graafschap,3,2,1,3,0,5,1,8.0,4.0
4475,1974-1975,25,Feyenoord,FC Den Haag-ADO,3,0,1,3,0,3,3,13.0,2.0
4476,1974-1975,25,HFC Haarlem,AZ '67 Alkmaar,0,2,2,0,3,2,-2,4.0,8.0
4477,1974-1975,25,Roda JC Kerkrade,MVV Maastricht,0,3,2,0,3,3,-3,3.0,8.0
4478,1974-1975,25,Telstar,NAC Breda,0,0,3,1,1,0,0,7.0,2.0
4479,1974-1975,26,AFC Ajax,FC Utrecht,3,0,1,3,0,3,3,7.0,7.0
4480,1974-1975,26,AZ '67 Alkmaar,PSV,2,1,1,3,0,3,1,10.0,8.0
4481,1974-1975,26,De Graafschap,HFC Haarlem,2,2,3,1,1,4,0,5.0,5.0
4482,1974-1975,26,SBV Excelsior,FC Amsterdam,1,0,1,3,0,1,1,8.0,7.0
4483,1974-1975,26,FC Den Haag-ADO,Go Ahead Eagles,0,0,3,1,1,0,0,3.0,5.0
4484,1974-1975,26,WVV Wageningen,Telstar,4,2,1,3,0,6,2,6.0,4.0
4485,1974-1975,26,MVV Maastricht,Feyenoord,2,2,3,1,1,4,0,9.0,11.0
4486,1974-1975,26,NAC Breda,FC Twente,1,2,2,0,3,3,-1,2.0,11.0
4487,1974-1975,26,Sparta Rotterdam,Roda JC Kerkrade,1,1,3,1,1,2,0,4.0,3.0
4488,1974-1975,27,Sparta Rotterdam,AFC Ajax,1,1,3,1,1,2,0,4.0,8.0
4489,1974-1975,27,SBV Excelsior,De Graafschap,1,0,1,3,0,1,1,8.0,4.0
4490,1974-1975,27,FC Amsterdam,Feyenoord,0,3,2,0,3,3,-3,4.0,13.0
4491,1974-1975,27,FC Twente,Go Ahead Eagles,3,0,1,3,0,3,3,11.0,5.0
4492,1974-1975,27,WVV Wageningen,HFC Haarlem,2,0,1,3,0,2,2,8.0,2.0
4493,1974-1975,27,MVV Maastricht,FC Den Haag-ADO,1,1,3,1,1,2,0,9.0,4.0
4494,1974-1975,27,NAC Breda,AZ '67 Alkmaar,1,2,2,0,3,3,-1,2.0,12.0
4495,1974-1975,27,PSV,Roda JC Kerkrade,2,0,1,3,0,2,2,10.0,2.0
4496,1974-1975,27,Telstar,FC Utrecht,4,0,1,3,0,4,4,6.0,6.0
4497,1974-1975,28,AFC Ajax,Sparta Rotterdam,2,0,1,3,0,2,2,8.0,3.0
4498,1974-1975,28,AZ '67 Alkmaar,NAC Breda,2,4,2,0,3,6,-2,12.0,5.0
4499,1974-1975,28,De Graafschap,SBV Excelsior,2,0,1,3,0,2,2,7.0,7.0
4500,1974-1975,28,FC Den Haag-ADO,MVV Maastricht,2,1,1,3,0,3,1,6.0,8.0
4501,1974-1975,28,FC Utrecht,Telstar,0,2,2,0,3,2,-2,3.0,8.0
4502,1974-1975,28,Feyenoord,FC Amsterdam,1,2,2,0,3,3,-1,10.0,6.0
4503,1974-1975,28,Go Ahead Eagles,FC Twente,1,1,3,1,1,2,0,3.0,11.0
4504,1974-1975,28,HFC Haarlem,WVV Wageningen,3,2,1,3,0,5,1,5.0,7.0
4505,1974-1975,28,Roda JC Kerkrade,PSV,0,4,2,0,3,4,-4,2.0,10.0
4506,1974-1975,29,FC Twente,WVV Wageningen,3,0,1,3,0,3,3,13.0,6.0
4507,1974-1975,29,Go Ahead Eagles,MVV Maastricht,2,2,3,1,1,4,0,4.0,6.0
4508,1974-1975,29,AZ '67 Alkmaar,De Graafschap,3,0,1,3,0,3,3,12.0,4.0
4509,1974-1975,29,FC Amsterdam,NAC Breda,3,0,1,3,0,3,3,9.0,4.0
4510,1974-1975,29,FC Utrecht,FC Den Haag-ADO,1,1,3,1,1,2,0,4.0,6.0
4511,1974-1975,29,Feyenoord,Sparta Rotterdam,1,1,3,1,1,2,0,8.0,3.0
4512,1974-1975,29,HFC Haarlem,AFC Ajax,1,4,2,0,3,5,-3,4.0,11.0
4513,1974-1975,29,PSV,Telstar,1,0,1,3,0,1,1,12.0,7.0
4514,1974-1975,29,Roda JC Kerkrade,SBV Excelsior,4,2,1,3,0,6,2,4.0,6.0
4515,1974-1975,30,AFC Ajax,AZ '67 Alkmaar,4,0,1,3,0,4,4,13.0,9.0
4516,1974-1975,30,De Graafschap,PSV,1,1,3,1,1,2,0,5.0,10.0
4517,1974-1975,30,SBV Excelsior,Feyenoord,0,1,2,0,3,1,-1,6.0,8.0
4518,1974-1975,30,FC Den Haag-ADO,HFC Haarlem,1,1,3,1,1,2,0,7.0,5.0
4519,1974-1975,30,WVV Wageningen,FC Amsterdam,1,3,2,0,3,4,-2,6.0,9.0
4520,1974-1975,30,MVV Maastricht,FC Utrecht,1,1,3,1,1,2,0,4.0,2.0
4521,1974-1975,30,NAC Breda,Roda JC Kerkrade,2,1,1,3,0,3,1,6.0,4.0
4522,1974-1975,30,Sparta Rotterdam,Go Ahead Eagles,1,4,2,0,3,5,-3,3.0,6.0
4523,1974-1975,30,Telstar,FC Twente,1,0,1,3,0,1,1,9.0,10.0
4524,1974-1975,31,Go Ahead Eagles,SBV Excelsior,4,0,1,3,0,4,4,8.0,3.0
4525,1974-1975,31,PSV,FC Twente,3,0,1,3,0,3,3,13.0,7.0
4526,1974-1975,31,AZ '67 Alkmaar,FC Den Haag-ADO,0,0,3,1,1,0,0,7.0,7.0
4527,1974-1975,31,De Graafschap,AFC Ajax,0,0,3,1,1,0,0,5.0,11.0
4528,1974-1975,31,FC Amsterdam,Telstar,0,0,3,1,1,0,0,10.0,10.0
4529,1974-1975,31,FC Utrecht,Sparta Rotterdam,0,1,2,0,3,1,-1,2.0,5.0
4530,1974-1975,31,Feyenoord,NAC Breda,3,1,1,3,0,4,2,10.0,6.0
4531,1974-1975,31,HFC Haarlem,MVV Maastricht,3,1,1,3,0,4,2,7.0,3.0
4532,1974-1975,31,Roda JC Kerkrade,WVV Wageningen,3,1,1,3,0,4,2,6.0,3.0
4533,1974-1975,32,AFC Ajax,PSV,2,4,2,0,3,6,-2,10.0,13.0
4534,1974-1975,32,SBV Excelsior,FC Utrecht,2,2,3,1,1,4,0,1.0,3.0
4535,1974-1975,32,FC Den Haag-ADO,De Graafschap,0,1,2,0,3,1,-1,6.0,8.0
4536,1974-1975,32,FC Twente,FC Amsterdam,2,1,1,3,0,3,1,7.0,10.0
4537,1974-1975,32,WVV Wageningen,Feyenoord,1,4,2,0,3,5,-3,0.0,10.0
4538,1974-1975,32,MVV Maastricht,AZ '67 Alkmaar,2,1,1,3,0,3,1,5.0,4.0
4539,1974-1975,32,NAC Breda,Go Ahead Eagles,4,1,1,3,0,5,3,9.0,8.0
4540,1974-1975,32,Sparta Rotterdam,HFC Haarlem,0,0,3,1,1,0,0,5.0,8.0
4541,1974-1975,32,Telstar,Roda JC Kerkrade,4,2,1,3,0,6,2,10.0,6.0
4542,1974-1975,33,AFC Ajax,FC Den Haag-ADO,3,1,1,3,0,4,2,10.0,3.0
4543,1974-1975,33,AZ '67 Alkmaar,Sparta Rotterdam,0,0,3,1,1,0,0,5.0,6.0
4544,1974-1975,33,De Graafschap,MVV Maastricht,3,1,1,3,0,4,2,8.0,5.0
4545,1974-1975,33,FC Utrecht,NAC Breda,0,1,2,0,3,1,-1,3.0,9.0
4546,1974-1975,33,Feyenoord,Telstar,4,1,1,3,0,5,3,13.0,7.0
4547,1974-1975,33,Go Ahead Eagles,WVV Wageningen,5,1,1,3,0,6,4,10.0,0.0
4548,1974-1975,33,HFC Haarlem,SBV Excelsior,1,0,1,3,0,1,1,8.0,1.0
4549,1974-1975,33,PSV,FC Amsterdam,3,0,1,3,0,3,3,13.0,7.0
4550,1974-1975,33,Roda JC Kerkrade,FC Twente,2,1,1,3,0,3,1,9.0,6.0
4551,1974-1975,34,SBV Excelsior,AZ '67 Alkmaar,1,1,3,1,1,2,0,2.0,3.0
4552,1974-1975,34,FC Amsterdam,Roda JC Kerkrade,2,2,3,1,1,4,0,5.0,7.0
4553,1974-1975,34,FC Twente,Feyenoord,1,1,3,1,1,2,0,4.0,13.0
4554,1974-1975,34,WVV Wageningen,FC Utrecht,1,0,1,3,0,1,1,3.0,2.0
4555,1974-1975,34,MVV Maastricht,AFC Ajax,0,0,3,1,1,0,0,5.0,8.0
4556,1974-1975,34,NAC Breda,HFC Haarlem,3,1,1,3,0,4,2,12.0,8.0
4557,1974-1975,34,PSV,FC Den Haag-ADO,3,1,1,3,0,4,2,13.0,2.0
4558,1974-1975,34,Sparta Rotterdam,De Graafschap,4,0,1,3,0,4,4,8.0,8.0
4559,1974-1975,34,Telstar,Go Ahead Eagles,2,1,1,3,0,3,1,10.0,9.0
4560,1975-1976,1,PSV,MVV Maastricht,5,1,1,3,0,6,4,15.0,4.0
4561,1975-1976,1,Sparta Rotterdam,AFC Ajax,1,1,3,1,1,2,0,9.0,6.0
4562,1975-1976,1,AZ '67 Alkmaar,Go Ahead Eagles,0,0,3,1,1,0,0,4.0,7.0
4563,1975-1976,1,De Graafschap,NEC Nijmegen,2,1,1,3,0,3,1,10.0,7.0
4564,1975-1976,1,SBV Excelsior,Telstar,1,5,2,0,3,6,-4,2.0,10.0
4565,1975-1976,1,FC Amsterdam,NAC Breda,2,1,1,3,0,3,1,5.0,9.0
4566,1975-1976,1,FC Den Haag-ADO,FC Twente,0,1,2,0,3,1,-1,1.0,7.0
4567,1975-1976,1,FC Utrecht,Feyenoord,1,2,2,0,3,3,-1,1.0,13.0
4568,1975-1976,1,Roda JC Kerkrade,SC Eindhoven,1,2,2,0,3,3,-1,7.0,
4569,1975-1976,2,Go Ahead Eagles,FC Utrecht,2,2,3,1,1,4,0,5.0,2.0
4570,1975-1976,2,NEC Nijmegen,AZ '67 Alkmaar,1,0,1,3,0,1,1,7.0,3.0
4571,1975-1976,2,AFC Ajax,SBV Excelsior,2,0,1,3,0,2,2,8.0,2.0
4572,1975-1976,2,SC Eindhoven,PSV,1,5,2,0,3,6,-4,,15.0
4573,1975-1976,2,FC Twente,Roda JC Kerkrade,3,2,1,3,0,5,1,10.0,4.0
4574,1975-1976,2,Feyenoord,FC Amsterdam,4,0,1,3,0,4,4,13.0,4.0
4575,1975-1976,2,MVV Maastricht,De Graafschap,2,2,3,1,1,4,0,5.0,10.0
4576,1975-1976,2,Telstar,FC Den Haag-ADO,2,2,3,1,1,4,0,10.0,1.0
4577,1975-1976,2,NAC Breda,Sparta Rotterdam,1,1,3,1,1,2,0,10.0,7.0
4578,1975-1976,3,FC Utrecht,NEC Nijmegen,0,3,2,0,3,3,-3,1.0,10.0
4579,1975-1976,3,PSV,FC Twente,3,0,1,3,0,3,3,15.0,7.0
4580,1975-1976,3,Roda JC Kerkrade,Telstar,2,2,3,1,1,4,0,5.0,8.0
4581,1975-1976,3,AZ '67 Alkmaar,MVV Maastricht,2,0,1,3,0,2,2,6.0,2.0
4582,1975-1976,3,De Graafschap,SC Eindhoven,1,1,3,1,1,2,0,8.0,
4583,1975-1976,3,SBV Excelsior,Sparta Rotterdam,0,2,2,0,3,2,-2,1.0,9.0
4584,1975-1976,3,FC Amsterdam,Go Ahead Eagles,6,2,1,3,0,8,4,7.0,5.0
4585,1975-1976,3,FC Den Haag-ADO,AFC Ajax,1,3,2,0,3,4,-2,1.0,11.0
4586,1975-1976,3,Feyenoord,NAC Breda,4,0,1,3,0,4,4,13.0,7.0
4587,1975-1976,4,AFC Ajax,Roda JC Kerkrade,2,1,1,3,0,3,1,11.0,2.0
4588,1975-1976,4,Go Ahead Eagles,Feyenoord,0,1,2,0,3,1,-1,2.0,13.0
4589,1975-1976,4,NEC Nijmegen,FC Amsterdam,1,1,3,1,1,2,0,10.0,8.0
4590,1975-1976,4,Sparta Rotterdam,FC Den Haag-ADO,2,2,3,1,1,4,0,9.0,2.0
4591,1975-1976,4,SC Eindhoven,AZ '67 Alkmaar,1,3,2,0,3,4,-2,,8.0
4592,1975-1976,4,FC Twente,De Graafschap,8,0,1,3,0,8,8,10.0,5.0
4593,1975-1976,4,MVV Maastricht,FC Utrecht,3,1,1,3,0,4,2,5.0,1.0
4594,1975-1976,4,NAC Breda,SBV Excelsior,0,0,3,1,1,0,0,5.0,2.0
4595,1975-1976,4,Telstar,PSV,0,0,3,1,1,0,0,9.0,13.0
4596,1975-1976,5,De Graafschap,Telstar,5,3,1,3,0,8,2,8.0,6.0
4597,1975-1976,5,FC Amsterdam,MVV Maastricht,0,0,3,1,1,0,0,8.0,5.0
4598,1975-1976,5,FC Utrecht,SC Eindhoven,2,2,3,1,1,4,0,2.0,5.0
4599,1975-1976,5,Go Ahead Eagles,NAC Breda,0,0,3,1,1,0,0,3.0,3.0
4600,1975-1976,5,PSV,AFC Ajax,6,2,1,3,0,8,4,13.0,10.0
4601,1975-1976,5,Roda JC Kerkrade,Sparta Rotterdam,1,0,1,3,0,1,1,4.0,6.0
4602,1975-1976,5,AZ '67 Alkmaar,FC Twente,1,2,2,0,3,3,-1,7.0,12.0
4603,1975-1976,5,FC Den Haag-ADO,SBV Excelsior,1,0,1,3,0,1,1,5.0,1.0
4604,1975-1976,5,Feyenoord,NEC Nijmegen,3,3,3,1,1,6,0,13.0,8.0
4605,1975-1976,6,AFC Ajax,De Graafschap,3,0,1,3,0,3,3,12.0,5.0
4606,1975-1976,6,NEC Nijmegen,Go Ahead Eagles,3,3,3,1,1,6,0,9.0,3.0
4607,1975-1976,6,Sparta Rotterdam,PSV,1,0,1,3,0,1,1,8.0,10.0
4608,1975-1976,6,SC Eindhoven,FC Amsterdam,2,1,1,3,0,3,1,5.0,5.0
4609,1975-1976,6,SBV Excelsior,Roda JC Kerkrade,1,2,2,0,3,3,-1,1.0,7.0
4610,1975-1976,6,FC Twente,FC Utrecht,2,0,1,3,0,2,2,12.0,2.0
4611,1975-1976,6,MVV Maastricht,Feyenoord,1,1,3,1,1,2,0,6.0,11.0
4612,1975-1976,6,NAC Breda,FC Den Haag-ADO,2,0,1,3,0,2,2,6.0,5.0
4613,1975-1976,6,Telstar,AZ '67 Alkmaar,1,1,3,1,1,2,0,4.0,7.0
4614,1975-1976,7,Go Ahead Eagles,MVV Maastricht,2,3,2,0,3,5,-1,2.0,8.0
4615,1975-1976,7,PSV,SBV Excelsior,6,0,1,3,0,6,6,10.0,1.0
4616,1975-1976,7,AZ '67 Alkmaar,AFC Ajax,1,1,3,1,1,2,0,8.0,10.0
4617,1975-1976,7,De Graafschap,Sparta Rotterdam,2,2,3,1,1,4,0,5.0,8.0
4618,1975-1976,7,FC Amsterdam,FC Twente,1,1,3,1,1,2,0,6.0,10.0
4619,1975-1976,7,FC Utrecht,Telstar,2,4,2,0,3,6,-2,1.0,6.0
4620,1975-1976,7,Feyenoord,SC Eindhoven,5,0,1,3,0,5,5,11.0,5.0
4621,1975-1976,7,NEC Nijmegen,NAC Breda,0,0,3,1,1,0,0,7.0,6.0
4622,1975-1976,7,Roda JC Kerkrade,FC Den Haag-ADO,1,0,1,3,0,1,1,10.0,4.0
4623,1975-1976,8,AFC Ajax,FC Utrecht,5,1,1,3,0,6,4,10.0,1.0
4624,1975-1976,8,FC Den Haag-ADO,PSV,4,1,1,3,0,5,3,7.0,7.0
4625,1975-1976,8,SC Eindhoven,Go Ahead Eagles,4,2,1,3,0,6,2,7.0,2.0
4626,1975-1976,8,SBV Excelsior,De Graafschap,3,0,1,3,0,3,3,4.0,4.0
4627,1975-1976,8,FC Twente,Feyenoord,2,0,1,3,0,2,2,13.0,8.0
4628,1975-1976,8,MVV Maastricht,NEC Nijmegen,2,3,2,0,3,5,-1,8.0,7.0
4629,1975-1976,8,NAC Breda,Roda JC Kerkrade,0,3,2,0,3,3,-3,6.0,12.0
4630,1975-1976,8,Sparta Rotterdam,AZ '67 Alkmaar,1,1,3,1,1,2,0,6.0,6.0
4631,1975-1976,8,Telstar,FC Amsterdam,0,3,2,0,3,3,-3,5.0,6.0
4632,1975-1976,9,PSV,Roda JC Kerkrade,0,0,3,1,1,0,0,7.0,13.0
4633,1975-1976,9,AZ '67 Alkmaar,SBV Excelsior,2,0,1,3,0,2,2,6.0,3.0
4634,1975-1976,9,De Graafschap,FC Den Haag-ADO,2,2,3,1,1,4,0,5.0,7.0
4635,1975-1976,9,FC Amsterdam,AFC Ajax,0,2,2,0,3,2,-2,5.0,10.0
4636,1975-1976,9,FC Utrecht,Sparta Rotterdam,4,2,1,3,0,6,2,4.0,5.0
4637,1975-1976,9,Feyenoord,Telstar,3,1,1,3,0,4,2,8.0,4.0
4638,1975-1976,9,MVV Maastricht,NAC Breda,2,0,1,3,0,2,2,8.0,5.0
4639,1975-1976,9,NEC Nijmegen,SC Eindhoven,0,0,3,1,1,0,0,7.0,8.0
4640,1975-1976,9,Go Ahead Eagles,FC Twente,1,0,1,3,0,1,1,5.0,10.0
4641,1975-1976,10,AFC Ajax,Feyenoord,6,0,1,3,0,6,6,13.0,7.0
4642,1975-1976,10,Roda JC Kerkrade,De Graafschap,3,3,3,1,1,6,0,11.0,3.0
4643,1975-1976,10,SC Eindhoven,MVV Maastricht,1,0,1,3,0,1,1,10.0,7.0
4644,1975-1976,10,SBV Excelsior,FC Utrecht,0,1,2,0,3,1,-1,3.0,6.0
4645,1975-1976,10,FC Den Haag-ADO,AZ '67 Alkmaar,3,0,1,3,0,3,3,7.0,6.0
4646,1975-1976,10,FC Twente,NEC Nijmegen,0,0,3,1,1,0,0,8.0,7.0
4647,1975-1976,10,NAC Breda,PSV,1,1,3,1,1,2,0,5.0,5.0
4648,1975-1976,10,Sparta Rotterdam,FC Amsterdam,2,1,1,3,0,3,1,8.0,4.0
4649,1975-1976,10,Telstar,Go Ahead Eagles,1,1,3,1,1,2,0,5.0,5.0
4650,1975-1976,11,MVV Maastricht,FC Twente,2,1,1,3,0,3,1,9.0,5.0
4651,1975-1976,11,AZ '67 Alkmaar,Roda JC Kerkrade,3,0,1,3,0,3,3,8.0,8.0
4652,1975-1976,11,De Graafschap,PSV,2,4,2,0,3,6,-2,3.0,8.0
4653,1975-1976,11,SC Eindhoven,NAC Breda,2,3,2,0,3,5,-1,7.0,5.0
4654,1975-1976,11,FC Amsterdam,SBV Excelsior,0,0,3,1,1,0,0,5.0,4.0
4655,1975-1976,11,FC Utrecht,FC Den Haag-ADO,2,3,2,0,3,5,-1,6.0,10.0
4656,1975-1976,11,Feyenoord,Sparta Rotterdam,1,1,3,1,1,2,0,7.0,6.0
4657,1975-1976,11,Go Ahead Eagles,AFC Ajax,1,2,2,0,3,3,-1,4.0,13.0
4658,1975-1976,11,NEC Nijmegen,Telstar,3,1,1,3,0,4,2,9.0,4.0
4659,1975-1976,12,PSV,AZ '67 Alkmaar,6,1,1,3,0,7,5,8.0,7.0
4660,1975-1976,12,AFC Ajax,NEC Nijmegen,6,3,1,3,0,9,3,15.0,8.0
4661,1975-1976,12,SBV Excelsior,Feyenoord,1,4,2,0,3,5,-3,4.0,7.0
4662,1975-1976,12,FC Den Haag-ADO,FC Amsterdam,5,1,1,3,0,6,4,13.0,4.0
4663,1975-1976,12,FC Twente,SC Eindhoven,3,1,1,3,0,4,2,7.0,7.0
4664,1975-1976,12,NAC Breda,De Graafschap,1,0,1,3,0,1,1,7.0,2.0
4665,1975-1976,12,Roda JC Kerkrade,FC Utrecht,0,0,3,1,1,0,0,6.0,7.0
4666,1975-1976,12,Sparta Rotterdam,Go Ahead Eagles,1,1,3,1,1,2,0,6.0,5.0
4667,1975-1976,12,Telstar,MVV Maastricht,4,0,1,3,0,4,4,4.0,6.0
4668,1975-1976,13,AZ '67 Alkmaar,De Graafschap,5,1,1,3,0,6,4,9.0,2.0
4669,1975-1976,13,SC Eindhoven,Telstar,0,0,3,1,1,0,0,5.0,5.0
4670,1975-1976,13,FC Amsterdam,Roda JC Kerkrade,0,1,2,0,3,1,-1,1.0,6.0
4671,1975-1976,13,FC Twente,NAC Breda,3,0,1,3,0,3,3,7.0,7.0
4672,1975-1976,13,FC Utrecht,PSV,1,3,2,0,3,4,-2,7.0,11.0
4673,1975-1976,13,Feyenoord,FC Den Haag-ADO,4,1,1,3,0,5,3,10.0,10.0
4674,1975-1976,13,Go Ahead Eagles,SBV Excelsior,0,2,2,0,3,2,-2,5.0,4.0
4675,1975-1976,13,MVV Maastricht,AFC Ajax,1,1,3,1,1,2,0,7.0,13.0
4676,1975-1976,13,NEC Nijmegen,Sparta Rotterdam,0,0,3,1,1,0,0,6.0,6.0
4677,1975-1976,14,AFC Ajax,SC Eindhoven,2,0,1,3,0,2,2,13.0,4.0
4678,1975-1976,14,De Graafschap,FC Utrecht,4,1,1,3,0,5,3,4.0,4.0
4679,1975-1976,14,SBV Excelsior,NEC Nijmegen,0,0,3,1,1,0,0,5.0,6.0
4680,1975-1976,14,FC Den Haag-ADO,Go Ahead Eagles,5,1,1,3,0,6,4,12.0,2.0
4681,1975-1976,14,NAC Breda,AZ '67 Alkmaar,0,2,2,0,3,2,-2,7.0,9.0
4682,1975-1976,14,PSV,FC Amsterdam,3,1,1,3,0,4,2,13.0,1.0
4683,1975-1976,14,Roda JC Kerkrade,Feyenoord,4,2,1,3,0,6,2,8.0,7.0
4684,1975-1976,14,Sparta Rotterdam,MVV Maastricht,2,1,1,3,0,3,1,9.0,4.0
4685,1975-1976,14,Telstar,FC Twente,1,2,2,0,3,3,-1,5.0,10.0
4686,1975-1976,15,SC Eindhoven,Sparta Rotterdam,1,1,3,1,1,2,0,2.0,7.0
4687,1975-1976,15,FC Amsterdam,De Graafschap,1,0,1,3,0,1,1,4.0,3.0
4688,1975-1976,15,Feyenoord,PSV,1,0,1,3,0,1,1,10.0,12.0
4689,1975-1976,15,MVV Maastricht,SBV Excelsior,1,0,1,3,0,1,1,7.0,5.0
4690,1975-1976,15,NEC Nijmegen,FC Den Haag-ADO,2,1,1,3,0,3,1,8.0,9.0
4691,1975-1976,15,Telstar,NAC Breda,2,0,1,3,0,2,2,7.0,6.0
4692,1975-1976,15,FC Utrecht,AZ '67 Alkmaar,1,0,1,3,0,1,1,4.0,9.0
4693,1975-1976,15,FC Twente,AFC Ajax,3,0,1,3,0,3,3,12.0,10.0
4694,1975-1976,15,Go Ahead Eagles,Roda JC Kerkrade,1,1,3,1,1,2,0,2.0,8.0
4695,1975-1976,16,AFC Ajax,Telstar,2,1,1,3,0,3,1,10.0,7.0
4696,1975-1976,16,AZ '67 Alkmaar,FC Amsterdam,2,1,1,3,0,3,1,9.0,3.0
4697,1975-1976,16,De Graafschap,Feyenoord,0,1,2,0,3,1,-1,3.0,12.0
4698,1975-1976,16,SBV Excelsior,SC Eindhoven,2,1,1,3,0,3,1,7.0,2.0
4699,1975-1976,16,FC Den Haag-ADO,MVV Maastricht,1,0,1,3,0,1,1,9.0,4.0
4700,1975-1976,16,FC Utrecht,NAC Breda,1,1,3,1,1,2,0,5.0,4.0
4701,1975-1976,16,PSV,Go Ahead Eagles,2,1,1,3,0,3,1,12.0,2.0
4702,1975-1976,16,Roda JC Kerkrade,NEC Nijmegen,2,3,2,0,3,5,-1,8.0,8.0
4703,1975-1976,16,Sparta Rotterdam,FC Twente,1,1,3,1,1,2,0,7.0,13.0
4704,1975-1976,17,AFC Ajax,Sparta Rotterdam,2,0,1,3,0,2,2,10.0,6.0
4705,1975-1976,17,SC Eindhoven,Roda JC Kerkrade,0,1,2,0,3,1,-1,2.0,10.0
4706,1975-1976,17,FC Twente,FC Den Haag-ADO,2,0,1,3,0,2,2,13.0,6.0
4707,1975-1976,17,Feyenoord,FC Utrecht,3,1,1,3,0,4,2,12.0,4.0
4708,1975-1976,17,Go Ahead Eagles,AZ '67 Alkmaar,1,1,3,1,1,2,0,2.0,10.0
4709,1975-1976,17,MVV Maastricht,PSV,1,6,2,0,3,7,-5,4.0,12.0
4710,1975-1976,17,NAC Breda,FC Amsterdam,1,3,2,0,3,4,-2,1.0,6.0
4711,1975-1976,17,NEC Nijmegen,De Graafschap,0,0,3,1,1,0,0,9.0,4.0
4712,1975-1976,17,Telstar,SBV Excelsior,2,0,1,3,0,2,2,7.0,7.0
4713,1975-1976,18,AZ '67 Alkmaar,NEC Nijmegen,0,1,2,0,3,1,-1,7.0,11.0
4714,1975-1976,18,De Graafschap,MVV Maastricht,5,1,1,3,0,6,4,7.0,3.0
4715,1975-1976,18,SBV Excelsior,AFC Ajax,0,2,2,0,3,2,-2,4.0,12.0
4716,1975-1976,18,FC Amsterdam,Feyenoord,1,2,2,0,3,3,-1,6.0,12.0
4717,1975-1976,18,FC Den Haag-ADO,Telstar,0,0,3,1,1,0,0,7.0,7.0
4718,1975-1976,18,FC Utrecht,Go Ahead Eagles,1,4,2,0,3,5,-3,4.0,5.0
4719,1975-1976,18,PSV,SC Eindhoven,2,1,1,3,0,3,1,12.0,1.0
4720,1975-1976,18,Roda JC Kerkrade,FC Twente,0,0,3,1,1,0,0,8.0,11.0
4721,1975-1976,18,Sparta Rotterdam,NAC Breda,2,1,1,3,0,3,1,8.0,1.0
4722,1975-1976,19,AFC Ajax,FC Den Haag-ADO,0,0,3,1,1,0,0,10.0,5.0
4723,1975-1976,19,SC Eindhoven,De Graafschap,1,1,3,1,1,2,0,2.0,5.0
4724,1975-1976,19,FC Twente,PSV,2,0,1,3,0,2,2,11.0,9.0
4725,1975-1976,19,Go Ahead Eagles,FC Amsterdam,1,1,3,1,1,2,0,6.0,7.0
4726,1975-1976,19,MVV Maastricht,AZ '67 Alkmaar,3,0,1,3,0,3,3,6.0,4.0
4727,1975-1976,19,NAC Breda,Feyenoord,2,2,3,1,1,4,0,2.0,13.0
4728,1975-1976,19,NEC Nijmegen,FC Utrecht,0,0,3,1,1,0,0,11.0,5.0
4729,1975-1976,19,Sparta Rotterdam,SBV Excelsior,0,1,2,0,3,1,-1,5.0,6.0
4730,1975-1976,19,Telstar,Roda JC Kerkrade,0,0,3,1,1,0,0,8.0,6.0
4731,1975-1976,20,PSV,Sparta Rotterdam,3,0,1,3,0,3,3,12.0,4.0
4732,1975-1976,20,AZ '67 Alkmaar,Telstar,1,1,3,1,1,2,0,5.0,6.0
4733,1975-1976,20,De Graafschap,AFC Ajax,2,1,1,3,0,3,1,8.0,10.0
4734,1975-1976,20,FC Amsterdam,SC Eindhoven,3,4,2,0,3,7,-1,4.0,4.0
4735,1975-1976,20,FC Den Haag-ADO,NAC Breda,5,0,1,3,0,5,5,8.0,2.0
4736,1975-1976,20,FC Utrecht,FC Twente,0,1,2,0,3,1,-1,2.0,11.0
4737,1975-1976,20,Feyenoord,MVV Maastricht,2,0,1,3,0,2,2,13.0,3.0
4738,1975-1976,20,Go Ahead Eagles,NEC Nijmegen,0,1,2,0,3,1,-1,5.0,11.0
4739,1975-1976,20,Roda JC Kerkrade,SBV Excelsior,0,1,2,0,3,1,-1,5.0,9.0
4740,1975-1976,21,NAC Breda,NEC Nijmegen,0,2,2,0,3,2,-2,1.0,11.0
4741,1975-1976,21,AFC Ajax,AZ '67 Alkmaar,2,0,1,3,0,2,2,10.0,2.0
4742,1975-1976,21,SC Eindhoven,Feyenoord,0,0,3,1,1,0,0,5.0,11.0
4743,1975-1976,21,SBV Excelsior,PSV,0,2,2,0,3,2,-2,6.0,12.0
4744,1975-1976,21,FC Den Haag-ADO,Roda JC Kerkrade,2,1,1,3,0,3,1,8.0,5.0
4745,1975-1976,21,FC Twente,FC Amsterdam,3,1,1,3,0,4,2,13.0,4.0
4746,1975-1976,21,MVV Maastricht,Go Ahead Eagles,1,2,2,0,3,3,-1,3.0,8.0
4747,1975-1976,21,Sparta Rotterdam,De Graafschap,0,1,2,0,3,1,-1,3.0,11.0
4748,1975-1976,21,Telstar,FC Utrecht,0,1,2,0,3,1,-1,6.0,4.0
4749,1975-1976,22,Go Ahead Eagles,SC Eindhoven,2,1,1,3,0,3,1,10.0,5.0
4750,1975-1976,22,NEC Nijmegen,MVV Maastricht,1,0,1,3,0,1,1,13.0,3.0
4751,1975-1976,22,Roda JC Kerkrade,NAC Breda,3,0,1,3,0,3,3,5.0,1.0
4752,1975-1976,22,AZ '67 Alkmaar,Sparta Rotterdam,2,0,1,3,0,2,2,4.0,3.0
4753,1975-1976,22,De Graafschap,SBV Excelsior,1,0,1,3,0,1,1,13.0,6.0
4754,1975-1976,22,FC Amsterdam,Telstar,0,0,3,1,1,0,0,2.0,4.0
4755,1975-1976,22,FC Utrecht,AFC Ajax,1,1,3,1,1,2,0,5.0,8.0
4756,1975-1976,22,Feyenoord,FC Twente,3,0,1,3,0,3,3,11.0,10.0
4757,1975-1976,22,PSV,FC Den Haag-ADO,2,0,1,3,0,2,2,12.0,8.0
4758,1975-1976,23,FC Den Haag-ADO,De Graafschap,6,1,1,3,0,7,5,10.0,10.0
4759,1975-1976,23,NAC Breda,MVV Maastricht,2,1,1,3,0,3,1,4.0,3.0
4760,1975-1976,23,AFC Ajax,FC Amsterdam,2,0,1,3,0,2,2,8.0,2.0
4761,1975-1976,23,SC Eindhoven,NEC Nijmegen,1,0,1,3,0,1,1,8.0,10.0
4762,1975-1976,23,SBV Excelsior,AZ '67 Alkmaar,0,1,2,0,3,1,-1,6.0,7.0
4763,1975-1976,23,FC Twente,Go Ahead Eagles,4,1,1,3,0,5,3,12.0,7.0
4764,1975-1976,23,Roda JC Kerkrade,PSV,0,1,2,0,3,1,-1,4.0,12.0
4765,1975-1976,23,Sparta Rotterdam,FC Utrecht,0,0,3,1,1,0,0,1.0,6.0
4766,1975-1976,23,Telstar,Feyenoord,1,2,2,0,3,3,-1,3.0,11.0
4767,1975-1976,24,PSV,Telstar,6,1,1,3,0,7,5,15.0,2.0
4768,1975-1976,24,AZ '67 Alkmaar,SC Eindhoven,2,0,1,3,0,2,2,10.0,7.0
4769,1975-1976,24,De Graafschap,FC Twente,1,1,3,1,1,2,0,10.0,10.0
4770,1975-1976,24,SBV Excelsior,NAC Breda,0,2,2,0,3,2,-2,3.0,6.0
4771,1975-1976,24,FC Amsterdam,NEC Nijmegen,1,1,3,1,1,2,0,2.0,10.0
4772,1975-1976,24,FC Den Haag-ADO,Sparta Rotterdam,1,0,1,3,0,1,1,12.0,1.0
4773,1975-1976,24,FC Utrecht,MVV Maastricht,2,1,1,3,0,3,1,8.0,0.0
4774,1975-1976,24,Feyenoord,Go Ahead Eagles,4,2,1,3,0,6,2,13.0,6.0
4775,1975-1976,24,Roda JC Kerkrade,AFC Ajax,0,0,3,1,1,0,0,4.0,8.0
4776,1975-1976,25,AFC Ajax,PSV,1,3,2,0,3,4,-2,8.0,15.0
4777,1975-1976,25,MVV Maastricht,FC Amsterdam,2,1,1,3,0,3,1,3.0,2.0
4778,1975-1976,25,NAC Breda,Go Ahead Eagles,3,1,1,3,0,4,2,9.0,6.0
4779,1975-1976,25,SC Eindhoven,FC Utrecht,3,3,3,1,1,6,0,5.0,9.0
4780,1975-1976,25,SBV Excelsior,FC Den Haag-ADO,0,1,2,0,3,1,-1,0.0,12.0
4781,1975-1976,25,FC Twente,AZ '67 Alkmaar,2,2,3,1,1,4,0,8.0,10.0
4782,1975-1976,25,NEC Nijmegen,Feyenoord,1,1,3,1,1,2,0,8.0,11.0
4783,1975-1976,25,Sparta Rotterdam,Roda JC Kerkrade,1,1,3,1,1,2,0,2.0,5.0
4784,1975-1976,25,Telstar,De Graafschap,2,1,1,3,0,3,1,4.0,7.0
4785,1975-1976,26,Go Ahead Eagles,Telstar,0,0,3,1,1,0,0,4.0,5.0
4786,1975-1976,26,MVV Maastricht,SC Eindhoven,1,1,3,1,1,2,0,4.0,5.0
4787,1975-1976,26,NEC Nijmegen,FC Twente,0,0,3,1,1,0,0,6.0,6.0
4788,1975-1976,26,PSV,NAC Breda,4,0,1,3,0,4,4,15.0,9.0
4789,1975-1976,26,AZ '67 Alkmaar,FC Den Haag-ADO,4,3,1,3,0,7,1,13.0,9.0
4790,1975-1976,26,De Graafschap,Roda JC Kerkrade,0,0,3,1,1,0,0,5.0,6.0
4791,1975-1976,26,FC Amsterdam,Sparta Rotterdam,0,1,2,0,3,1,-1,2.0,5.0
4792,1975-1976,26,FC Utrecht,SBV Excelsior,2,1,1,3,0,3,1,9.0,0.0
4793,1975-1976,26,Feyenoord,AFC Ajax,4,1,1,3,0,5,3,13.0,5.0
4794,1975-1976,27,NAC Breda,SC Eindhoven,2,0,1,3,0,2,2,12.0,5.0
4795,1975-1976,27,PSV,De Graafschap,0,0,3,1,1,0,0,13.0,3.0
4796,1975-1976,27,AFC Ajax,Go Ahead Eagles,4,1,1,3,0,5,3,7.0,1.0
4797,1975-1976,27,SBV Excelsior,FC Amsterdam,1,1,3,1,1,2,0,1.0,2.0
4798,1975-1976,27,FC Den Haag-ADO,FC Utrecht,0,0,3,1,1,0,0,10.0,9.0
4799,1975-1976,27,FC Twente,MVV Maastricht,5,0,1,3,0,5,5,9.0,4.0
4800,1975-1976,27,Roda JC Kerkrade,AZ '67 Alkmaar,1,0,1,3,0,1,1,6.0,10.0
4801,1975-1976,27,Sparta Rotterdam,Feyenoord,0,2,2,0,3,2,-2,5.0,13.0
4802,1975-1976,27,Telstar,NEC Nijmegen,1,1,3,1,1,2,0,5.0,4.0
4803,1975-1976,28,FC Twente,SBV Excelsior,4,0,1,3,0,4,4,9.0,1.0
4804,1975-1976,28,SC Eindhoven,FC Den Haag-ADO,2,4,2,0,3,6,-2,2.0,10.0
4805,1975-1976,28,FC Amsterdam,FC Utrecht,2,0,1,3,0,2,2,5.0,8.0
4806,1975-1976,28,Feyenoord,AZ '67 Alkmaar,3,2,1,3,0,5,1,13.0,7.0
4807,1975-1976,28,Go Ahead Eagles,De Graafschap,0,0,3,1,1,0,0,2.0,4.0
4808,1975-1976,28,MVV Maastricht,Roda JC Kerkrade,0,2,2,0,3,2,-2,4.0,9.0
4809,1975-1976,28,NAC Breda,AFC Ajax,0,0,3,1,1,0,0,10.0,5.0
4810,1975-1976,28,NEC Nijmegen,PSV,1,4,2,0,3,5,-3,4.0,13.0
4811,1975-1976,28,Telstar,Sparta Rotterdam,2,2,3,1,1,4,0,6.0,5.0
4812,1975-1976,29,AFC Ajax,NAC Breda,5,0,1,3,0,5,5,7.0,7.0
4813,1975-1976,29,AZ '67 Alkmaar,Feyenoord,1,0,1,3,0,1,1,7.0,10.0
4814,1975-1976,29,De Graafschap,Go Ahead Eagles,0,0,3,1,1,0,0,4.0,3.0
4815,1975-1976,29,SBV Excelsior,FC Twente,4,2,1,3,0,6,2,4.0,8.0
4816,1975-1976,29,FC Den Haag-ADO,SC Eindhoven,6,0,1,3,0,6,6,10.0,2.0
4817,1975-1976,29,FC Utrecht,FC Amsterdam,1,0,1,3,0,1,1,8.0,4.0
4818,1975-1976,29,PSV,NEC Nijmegen,1,0,1,3,0,1,1,13.0,3.0
4819,1975-1976,29,Roda JC Kerkrade,MVV Maastricht,2,0,1,3,0,2,2,11.0,4.0
4820,1975-1976,29,Sparta Rotterdam,Telstar,1,2,2,0,3,3,-1,5.0,9.0
4821,1975-1976,30,Go Ahead Eagles,Sparta Rotterdam,2,2,3,1,1,4,0,4.0,5.0
4822,1975-1976,30,MVV Maastricht,Telstar,1,1,3,1,1,2,0,2.0,7.0
4823,1975-1976,30,AZ '67 Alkmaar,PSV,1,0,1,3,0,1,1,9.0,10.0
4824,1975-1976,30,De Graafschap,NAC Breda,0,0,3,1,1,0,0,5.0,5.0
4825,1975-1976,30,SC Eindhoven,FC Twente,0,1,2,0,3,1,-1,1.0,10.0
4826,1975-1976,30,FC Amsterdam,FC Den Haag-ADO,3,1,1,3,0,4,2,7.0,7.0
4827,1975-1976,30,FC Utrecht,Roda JC Kerkrade,0,1,2,0,3,1,-1,7.0,13.0
4828,1975-1976,30,Feyenoord,SBV Excelsior,4,2,1,3,0,6,2,12.0,4.0
4829,1975-1976,30,NEC Nijmegen,AFC Ajax,1,2,2,0,3,3,-1,2.0,10.0
4830,1975-1976,31,NAC Breda,FC Twente,1,0,1,3,0,1,1,8.0,9.0
4831,1975-1976,31,PSV,FC Utrecht,3,0,1,3,0,3,3,10.0,4.0
4832,1975-1976,31,Sparta Rotterdam,NEC Nijmegen,2,1,1,3,0,3,1,5.0,1.0
4833,1975-1976,31,AFC Ajax,MVV Maastricht,2,0,1,3,0,2,2,13.0,1.0
4834,1975-1976,31,De Graafschap,AZ '67 Alkmaar,2,3,2,0,3,5,-1,4.0,9.0
4835,1975-1976,31,SBV Excelsior,Go Ahead Eagles,0,5,2,0,3,5,-5,4.0,6.0
4836,1975-1976,31,FC Den Haag-ADO,Feyenoord,1,8,2,0,3,9,-7,7.0,12.0
4837,1975-1976,31,Roda JC Kerkrade,FC Amsterdam,2,1,1,3,0,3,1,15.0,7.0
4838,1975-1976,31,Telstar,SC Eindhoven,0,2,2,0,3,2,-2,6.0,3.0
4839,1975-1976,32,FC Twente,Telstar,1,0,1,3,0,1,1,9.0,5.0
4840,1975-1976,32,FC Utrecht,De Graafschap,3,0,1,3,0,3,3,6.0,3.0
4841,1975-1976,32,Go Ahead Eagles,FC Den Haag-ADO,1,0,1,3,0,1,1,9.0,6.0
4842,1975-1976,32,MVV Maastricht,Sparta Rotterdam,1,0,1,3,0,1,1,4.0,5.0
4843,1975-1976,32,NEC Nijmegen,SBV Excelsior,1,1,3,1,1,2,0,1.0,4.0
4844,1975-1976,32,AZ '67 Alkmaar,NAC Breda,1,1,3,1,1,2,0,10.0,6.0
4845,1975-1976,32,SC Eindhoven,AFC Ajax,2,3,2,0,3,5,-1,3.0,13.0
4846,1975-1976,32,FC Amsterdam,PSV,0,2,2,0,3,2,-2,6.0,12.0
4847,1975-1976,32,Feyenoord,Roda JC Kerkrade,3,0,1,3,0,3,3,12.0,12.0
4848,1975-1976,33,FC Den Haag-ADO,NEC Nijmegen,2,1,1,3,0,3,1,6.0,1.0
4849,1975-1976,33,AFC Ajax,FC Twente,5,3,1,3,0,8,2,15.0,6.0
4850,1975-1976,33,AZ '67 Alkmaar,FC Utrecht,1,0,1,3,0,1,1,13.0,6.0
4851,1975-1976,33,De Graafschap,FC Amsterdam,2,2,3,1,1,4,0,3.0,4.0
4852,1975-1976,33,SBV Excelsior,MVV Maastricht,2,0,1,3,0,2,2,7.0,4.0
4853,1975-1976,33,NAC Breda,Telstar,1,0,1,3,0,1,1,8.0,4.0
4854,1975-1976,33,PSV,Feyenoord,4,1,1,3,0,5,3,12.0,9.0
4855,1975-1976,33,Roda JC Kerkrade,Go Ahead Eagles,1,1,3,1,1,2,0,10.0,9.0
4856,1975-1976,33,Sparta Rotterdam,SC Eindhoven,0,1,2,0,3,1,-1,4.0,6.0
4857,1975-1976,34,NEC Nijmegen,Roda JC Kerkrade,4,1,1,3,0,5,3,4.0,7.0
4858,1975-1976,34,SC Eindhoven,SBV Excelsior,2,1,1,3,0,3,1,9.0,4.0
4859,1975-1976,34,FC Amsterdam,AZ '67 Alkmaar,0,0,3,1,1,0,0,5.0,11.0
4860,1975-1976,34,FC Twente,Sparta Rotterdam,1,1,3,1,1,2,0,7.0,5.0
4861,1975-1976,34,Feyenoord,De Graafschap,8,0,1,3,0,8,8,12.0,2.0
4862,1975-1976,34,Go Ahead Eagles,PSV,1,1,3,1,1,2,0,9.0,10.0
4863,1975-1976,34,MVV Maastricht,FC Den Haag-ADO,2,2,3,1,1,4,0,5.0,4.0
4864,1975-1976,34,NAC Breda,FC Utrecht,0,1,2,0,3,1,-1,8.0,6.0
4865,1975-1976,34,Telstar,AFC Ajax,1,1,3,1,1,2,0,2.0,13.0
4866,1976-1977,1,NAC Breda,NEC Nijmegen,1,0,1,3,0,1,1,10.0,4.0
4867,1976-1977,1,Sparta Rotterdam,AZ '67 Alkmaar,1,1,3,1,1,2,0,5.0,9.0
4868,1976-1977,1,AFC Ajax,De Graafschap,1,0,1,3,0,1,1,13.0,1.0
4869,1976-1977,1,SC Eindhoven,PSV,2,2,3,1,1,4,0,10.0,11.0
4870,1976-1977,1,FC Den Haag,HFC Haarlem,2,1,1,3,0,3,1,,7.0
4871,1976-1977,1,FC Twente,FC Amsterdam,4,0,1,3,0,4,4,7.0,2.0
4872,1976-1977,1,FC Utrecht,Feyenoord,0,2,2,0,3,2,-2,6.0,12.0
4873,1976-1977,1,VVV-Venlo,Roda JC Kerkrade,1,2,2,0,3,3,-1,9.0,7.0
4874,1976-1977,1,Telstar,Go Ahead Eagles,0,1,2,0,3,1,-1,1.0,11.0
4875,1976-1977,2,AZ '67 Alkmaar,AFC Ajax,0,3,2,0,3,3,-3,6.0,13.0
4876,1976-1977,2,De Graafschap,NAC Breda,3,1,1,3,0,4,2,4.0,7.0
4877,1976-1977,2,FC Amsterdam,FC Utrecht,2,2,3,1,1,4,0,3.0,7.0
4878,1976-1977,2,Feyenoord,Telstar,3,1,1,3,0,4,2,12.0,1.0
4879,1976-1977,2,Go Ahead Eagles,SC Eindhoven,0,0,3,1,1,0,0,9.0,8.0
4880,1976-1977,2,HFC Haarlem,Sparta Rotterdam,4,0,1,3,0,4,4,7.0,2.0
4881,1976-1977,2,NEC Nijmegen,VVV-Venlo,7,1,1,3,0,8,6,7.0,6.0
4882,1976-1977,2,PSV,FC Den Haag,1,1,3,1,1,2,0,9.0,
4883,1976-1977,2,Roda JC Kerkrade,FC Twente,1,0,1,3,0,1,1,7.0,7.0
4884,1976-1977,3,AZ '67 Alkmaar,NAC Breda,4,1,1,3,0,5,3,8.0,6.0
4885,1976-1977,3,PSV,Sparta Rotterdam,2,0,1,3,0,2,2,9.0,2.0
4886,1976-1977,3,De Graafschap,VVV-Venlo,0,1,2,0,3,1,-1,4.0,6.0
4887,1976-1977,3,FC Amsterdam,Telstar,1,1,3,1,1,2,0,4.0,2.0
4888,1976-1977,3,FC Den Haag,SC Eindhoven,1,1,3,1,1,2,0,,9.0
4889,1976-1977,3,Feyenoord,Go Ahead Eagles,3,1,1,3,0,4,2,12.0,6.0
4890,1976-1977,3,HFC Haarlem,AFC Ajax,2,0,1,3,0,2,2,9.0,10.0
4891,1976-1977,3,NEC Nijmegen,FC Twente,4,0,1,3,0,4,4,9.0,4.0
4892,1976-1977,3,Roda JC Kerkrade,FC Utrecht,1,1,3,1,1,2,0,8.0,5.0
4893,1976-1977,4,AFC Ajax,PSV,1,0,1,3,0,1,1,10.0,6.0
4894,1976-1977,4,SC Eindhoven,Feyenoord,0,4,2,0,3,4,-4,6.0,15.0
4895,1976-1977,4,FC Twente,De Graafschap,0,0,3,1,1,0,0,5.0,4.0
4896,1976-1977,4,FC Utrecht,NEC Nijmegen,2,1,1,3,0,3,1,8.0,9.0
4897,1976-1977,4,VVV-Venlo,AZ '67 Alkmaar,1,0,1,3,0,1,1,9.0,5.0
4898,1976-1977,4,Go Ahead Eagles,FC Amsterdam,1,1,3,1,1,2,0,6.0,4.0
4899,1976-1977,4,NAC Breda,HFC Haarlem,2,0,1,3,0,2,2,6.0,6.0
4900,1976-1977,4,Sparta Rotterdam,FC Den Haag,1,0,1,3,0,1,1,5.0,
4901,1976-1977,4,Telstar,Roda JC Kerkrade,0,2,2,0,3,2,-2,2.0,10.0
4902,1976-1977,5,NEC Nijmegen,Telstar,2,2,3,1,1,4,0,7.0,2.0
4903,1976-1977,5,PSV,NAC Breda,5,1,1,3,0,6,4,8.0,6.0
4904,1976-1977,5,Sparta Rotterdam,SC Eindhoven,3,0,1,3,0,3,3,7.0,3.0
4905,1976-1977,5,AZ '67 Alkmaar,FC Twente,3,0,1,3,0,3,3,7.0,4.0
4906,1976-1977,5,De Graafschap,FC Utrecht,2,1,1,3,0,3,1,7.0,5.0
4907,1976-1977,5,FC Amsterdam,Feyenoord,1,2,2,0,3,3,-1,3.0,15.0
4908,1976-1977,5,FC Den Haag,AFC Ajax,1,2,2,0,3,3,-1,5.0,12.0
4909,1976-1977,5,HFC Haarlem,VVV-Venlo,1,1,3,1,1,2,0,7.0,7.0
4910,1976-1977,5,Roda JC Kerkrade,Go Ahead Eagles,4,1,1,3,0,5,3,13.0,5.0
4911,1976-1977,6,AFC Ajax,Sparta Rotterdam,1,3,2,0,3,4,-2,9.0,9.0
4912,1976-1977,6,Go Ahead Eagles,NEC Nijmegen,3,1,1,3,0,4,2,5.0,7.0
4913,1976-1977,6,NAC Breda,FC Den Haag,1,0,1,3,0,1,1,6.0,2.0
4914,1976-1977,6,SC Eindhoven,FC Amsterdam,3,0,1,3,0,3,3,5.0,3.0
4915,1976-1977,6,FC Twente,HFC Haarlem,0,1,2,0,3,1,-1,1.0,10.0
4916,1976-1977,6,FC Utrecht,AZ '67 Alkmaar,3,2,1,3,0,5,1,8.0,6.0
4917,1976-1977,6,VVV-Venlo,PSV,2,0,1,3,0,2,2,10.0,7.0
4918,1976-1977,6,Feyenoord,Roda JC Kerkrade,0,2,2,0,3,2,-2,12.0,13.0
4919,1976-1977,6,Telstar,De Graafschap,2,1,1,3,0,3,1,5.0,7.0
4920,1976-1977,7,PSV,FC Twente,3,0,1,3,0,3,3,9.0,1.0
4921,1976-1977,7,Sparta Rotterdam,NAC Breda,3,3,3,1,1,6,0,10.0,7.0
4922,1976-1977,7,AFC Ajax,SC Eindhoven,3,2,1,3,0,5,1,9.0,4.0
4923,1976-1977,7,AZ '67 Alkmaar,Telstar,5,1,1,3,0,6,4,9.0,5.0
4924,1976-1977,7,De Graafschap,Go Ahead Eagles,1,2,2,0,3,3,-1,4.0,7.0
4925,1976-1977,7,FC Den Haag,VVV-Venlo,3,1,1,3,0,4,2,4.0,10.0
4926,1976-1977,7,HFC Haarlem,FC Utrecht,3,0,1,3,0,3,3,10.0,7.0
4927,1976-1977,7,NEC Nijmegen,Feyenoord,1,3,2,0,3,4,-2,4.0,12.0
4928,1976-1977,7,Roda JC Kerkrade,FC Amsterdam,3,0,1,3,0,3,3,13.0,2.0
4929,1976-1977,8,Feyenoord,De Graafschap,5,0,1,3,0,5,5,12.0,4.0
4930,1976-1977,8,Go Ahead Eagles,AZ '67 Alkmaar,1,1,3,1,1,2,0,8.0,7.0
4931,1976-1977,8,NAC Breda,AFC Ajax,0,1,2,0,3,1,-1,7.0,12.0
4932,1976-1977,8,SC Eindhoven,Roda JC Kerkrade,0,0,3,1,1,0,0,4.0,13.0
4933,1976-1977,8,FC Amsterdam,NEC Nijmegen,2,2,3,1,1,4,0,2.0,2.0
4934,1976-1977,8,FC Twente,FC Den Haag,1,1,3,1,1,2,0,2.0,4.0
4935,1976-1977,8,FC Utrecht,PSV,1,0,1,3,0,1,1,9.0,6.0
4936,1976-1977,8,VVV-Venlo,Sparta Rotterdam,1,2,2,0,3,3,-1,7.0,13.0
4937,1976-1977,8,Telstar,HFC Haarlem,0,1,2,0,3,1,-1,4.0,10.0
4938,1976-1977,9,NAC Breda,SC Eindhoven,4,1,1,3,0,5,3,7.0,4.0
4939,1976-1977,9,PSV,Telstar,5,2,1,3,0,7,3,9.0,4.0
4940,1976-1977,9,Sparta Rotterdam,FC Twente,1,1,3,1,1,2,0,11.0,2.0
4941,1976-1977,9,AFC Ajax,VVV-Venlo,1,0,1,3,0,1,1,12.0,4.0
4942,1976-1977,9,AZ '67 Alkmaar,Feyenoord,1,1,3,1,1,2,0,8.0,10.0
4943,1976-1977,9,De Graafschap,FC Amsterdam,1,5,2,0,3,6,-4,3.0,4.0
4944,1976-1977,9,FC Den Haag,FC Utrecht,0,3,2,0,3,3,-3,4.0,9.0
4945,1976-1977,9,HFC Haarlem,Go Ahead Eagles,0,0,3,1,1,0,0,11.0,8.0
4946,1976-1977,9,NEC Nijmegen,Roda JC Kerkrade,0,0,3,1,1,0,0,3.0,11.0
4947,1976-1977,10,Go Ahead Eagles,PSV,2,5,2,0,3,7,-3,8.0,9.0
4948,1976-1977,10,Roda JC Kerkrade,De Graafschap,3,0,1,3,0,3,3,11.0,0.0
4949,1976-1977,10,SC Eindhoven,NEC Nijmegen,3,1,1,3,0,4,2,7.0,2.0
4950,1976-1977,10,FC Amsterdam,AZ '67 Alkmaar,2,6,2,0,3,8,-4,4.0,8.0
4951,1976-1977,10,FC Twente,AFC Ajax,1,2,2,0,3,3,-1,2.0,12.0
4952,1976-1977,10,FC Utrecht,Sparta Rotterdam,1,0,1,3,0,1,1,12.0,8.0
4953,1976-1977,10,VVV-Venlo,NAC Breda,1,1,3,1,1,2,0,4.0,8.0
4954,1976-1977,10,Feyenoord,HFC Haarlem,7,0,1,3,0,7,7,10.0,10.0
4955,1976-1977,10,Telstar,FC Den Haag,3,1,1,3,0,4,2,6.0,4.0
4956,1976-1977,11,NAC Breda,FC Twente,3,1,1,3,0,4,2,8.0,2.0
4957,1976-1977,11,AFC Ajax,FC Utrecht,7,0,1,3,0,7,7,15.0,9.0
4958,1976-1977,11,AZ '67 Alkmaar,Roda JC Kerkrade,2,1,1,3,0,3,1,11.0,8.0
4959,1976-1977,11,De Graafschap,NEC Nijmegen,3,0,1,3,0,3,3,3.0,2.0
4960,1976-1977,11,FC Den Haag,Go Ahead Eagles,8,2,1,3,0,10,6,7.0,5.0
4961,1976-1977,11,VVV-Venlo,SC Eindhoven,0,0,3,1,1,0,0,2.0,5.0
4962,1976-1977,11,HFC Haarlem,FC Amsterdam,3,1,1,3,0,4,2,10.0,4.0
4963,1976-1977,11,PSV,Feyenoord,2,3,2,0,3,5,-1,9.0,13.0
4964,1976-1977,11,Sparta Rotterdam,Telstar,3,1,1,3,0,4,2,8.0,3.0
4965,1976-1977,12,Go Ahead Eagles,Sparta Rotterdam,3,3,3,1,1,6,0,3.0,8.0
4966,1976-1977,12,Roda JC Kerkrade,HFC Haarlem,1,1,3,1,1,2,0,6.0,8.0
4967,1976-1977,12,SC Eindhoven,De Graafschap,1,0,1,3,0,1,1,8.0,3.0
4968,1976-1977,12,FC Amsterdam,PSV,0,0,3,1,1,0,0,5.0,7.0
4969,1976-1977,12,FC Twente,VVV-Venlo,3,1,1,3,0,4,2,5.0,2.0
4970,1976-1977,12,FC Utrecht,NAC Breda,3,1,1,3,0,4,2,12.0,7.0
4971,1976-1977,12,Feyenoord,FC Den Haag,3,2,1,3,0,5,1,13.0,4.0
4972,1976-1977,12,NEC Nijmegen,AZ '67 Alkmaar,1,1,3,1,1,2,0,3.0,9.0
4973,1976-1977,12,Telstar,AFC Ajax,0,0,3,1,1,0,0,4.0,13.0
4974,1976-1977,13,NAC Breda,Telstar,3,1,1,3,0,4,2,10.0,4.0
4975,1976-1977,13,PSV,Roda JC Kerkrade,2,1,1,3,0,3,1,10.0,5.0
4976,1976-1977,13,AFC Ajax,Go Ahead Eagles,4,0,1,3,0,4,4,13.0,2.0
4977,1976-1977,13,AZ '67 Alkmaar,De Graafschap,4,1,1,3,0,5,3,11.0,3.0
4978,1976-1977,13,FC Den Haag,FC Amsterdam,3,0,1,3,0,3,3,6.0,4.0
4979,1976-1977,13,FC Twente,SC Eindhoven,4,0,1,3,0,4,4,7.0,7.0
4980,1976-1977,13,VVV-Venlo,FC Utrecht,1,5,2,0,3,6,-4,2.0,12.0
4981,1976-1977,13,HFC Haarlem,NEC Nijmegen,1,1,3,1,1,2,0,6.0,3.0
4982,1976-1977,13,Sparta Rotterdam,Feyenoord,1,3,2,0,3,4,-2,5.0,13.0
4983,1976-1977,14,Go Ahead Eagles,NAC Breda,2,2,3,1,1,4,0,2.0,8.0
4984,1976-1977,14,De Graafschap,HFC Haarlem,2,2,3,1,1,4,0,4.0,6.0
4985,1976-1977,14,SC Eindhoven,AZ '67 Alkmaar,0,7,2,0,3,7,-7,7.0,13.0
4986,1976-1977,14,FC Amsterdam,Sparta Rotterdam,2,2,3,1,1,4,0,2.0,5.0
4987,1976-1977,14,FC Utrecht,FC Twente,1,0,1,3,0,1,1,12.0,6.0
4988,1976-1977,14,Feyenoord,AFC Ajax,1,1,3,1,1,2,0,13.0,11.0
4989,1976-1977,14,NEC Nijmegen,PSV,0,1,2,0,3,1,-1,2.0,10.0
4990,1976-1977,14,Roda JC Kerkrade,FC Den Haag,2,2,3,1,1,4,0,5.0,7.0
4991,1976-1977,14,Telstar,VVV-Venlo,3,1,1,3,0,4,2,7.0,2.0
4992,1976-1977,15,PSV,De Graafschap,1,1,3,1,1,2,0,8.0,5.0
4993,1976-1977,15,AFC Ajax,FC Amsterdam,1,0,1,3,0,1,1,11.0,2.0
4994,1976-1977,15,FC Den Haag,NEC Nijmegen,2,1,1,3,0,3,1,10.0,2.0
4995,1976-1977,15,FC Twente,Telstar,3,0,1,3,0,3,3,9.0,4.0
4996,1976-1977,15,FC Utrecht,SC Eindhoven,6,1,1,3,0,7,5,12.0,4.0
4997,1976-1977,15,VVV-Venlo,Go Ahead Eagles,2,0,1,3,0,2,2,4.0,2.0
4998,1976-1977,15,HFC Haarlem,AZ '67 Alkmaar,2,1,1,3,0,3,1,9.0,10.0
4999,1976-1977,15,NAC Breda,Feyenoord,2,2,3,1,1,4,0,8.0,11.0
5000,1976-1977,15,Sparta Rotterdam,Roda JC Kerkrade,3,1,1,3,0,4,2,8.0,2.0
5001,1976-1977,16,De Graafschap,FC Den Haag,0,3,2,0,3,3,-3,2.0,10.0
5002,1976-1977,16,SC Eindhoven,HFC Haarlem,2,1,1,3,0,3,1,6.0,6.0
5003,1976-1977,16,FC Amsterdam,NAC Breda,1,0,1,3,0,1,1,5.0,5.0
5004,1976-1977,16,Go Ahead Eagles,FC Twente,1,1,3,1,1,2,0,3.0,10.0
5005,1976-1977,16,NEC Nijmegen,Sparta Rotterdam,3,0,1,3,0,3,3,5.0,5.0
5006,1976-1977,16,Roda JC Kerkrade,AFC Ajax,2,3,2,0,3,5,-1,2.0,11.0
5007,1976-1977,16,Telstar,FC Utrecht,1,1,3,1,1,2,0,5.0,13.0
5008,1976-1977,16,AZ '67 Alkmaar,PSV,4,0,1,3,0,4,4,10.0,8.0
5009,1976-1977,16,Feyenoord,VVV-Venlo,1,1,3,1,1,2,0,9.0,4.0
5010,1976-1977,17,NAC Breda,Roda JC Kerkrade,1,0,1,3,0,1,1,8.0,1.0
5011,1976-1977,17,PSV,HFC Haarlem,4,0,1,3,0,4,4,10.0,5.0
5012,1976-1977,17,AFC Ajax,NEC Nijmegen,2,1,1,3,0,3,1,13.0,4.0
5013,1976-1977,17,FC Den Haag,AZ '67 Alkmaar,2,1,1,3,0,3,1,13.0,9.0
5014,1976-1977,17,FC Utrecht,Go Ahead Eagles,3,0,1,3,0,3,3,13.0,2.0
5015,1976-1977,17,VVV-Venlo,FC Amsterdam,3,1,1,3,0,4,2,7.0,4.0
5016,1976-1977,17,Sparta Rotterdam,De Graafschap,3,0,1,3,0,3,3,7.0,2.0
5017,1976-1977,17,Telstar,SC Eindhoven,3,1,1,3,0,4,2,7.0,3.0
5018,1976-1977,17,FC Twente,Feyenoord,0,1,2,0,3,1,-1,7.0,9.0
5019,1976-1977,18,PSV,SC Eindhoven,3,0,1,3,0,3,3,10.0,3.0
5020,1976-1977,18,AZ '67 Alkmaar,Sparta Rotterdam,4,0,1,3,0,4,4,9.0,7.0
5021,1976-1977,18,De Graafschap,AFC Ajax,0,0,3,1,1,0,0,3.0,11.0
5022,1976-1977,18,FC Amsterdam,FC Twente,0,1,2,0,3,1,-1,4.0,7.0
5023,1976-1977,18,Feyenoord,FC Utrecht,5,2,1,3,0,7,3,9.0,10.0
5024,1976-1977,18,Go Ahead Eagles,Telstar,3,1,1,3,0,4,2,5.0,7.0
5025,1976-1977,18,HFC Haarlem,FC Den Haag,0,0,3,1,1,0,0,5.0,11.0
5026,1976-1977,18,NEC Nijmegen,NAC Breda,2,2,3,1,1,4,0,4.0,6.0
5027,1976-1977,18,Roda JC Kerkrade,VVV-Venlo,1,0,1,3,0,1,1,4.0,7.0
5028,1976-1977,19,NAC Breda,De Graafschap,1,0,1,3,0,1,1,8.0,2.0
5029,1976-1977,19,AFC Ajax,AZ '67 Alkmaar,1,0,1,3,0,1,1,13.0,6.0
5030,1976-1977,19,SC Eindhoven,Go Ahead Eagles,2,2,3,1,1,4,0,4.0,5.0
5031,1976-1977,19,FC Den Haag,PSV,0,0,3,1,1,0,0,11.0,8.0
5032,1976-1977,19,FC Twente,Roda JC Kerkrade,1,0,1,3,0,1,1,10.0,3.0
5033,1976-1977,19,FC Utrecht,FC Amsterdam,2,2,3,1,1,4,0,8.0,4.0
5034,1976-1977,19,VVV-Venlo,NEC Nijmegen,1,1,3,1,1,2,0,8.0,5.0
5035,1976-1977,19,Sparta Rotterdam,HFC Haarlem,3,1,1,3,0,4,2,9.0,4.0
5036,1976-1977,19,Telstar,Feyenoord,1,0,1,3,0,1,1,7.0,8.0
5037,1976-1977,20,NAC Breda,AZ '67 Alkmaar,0,0,3,1,1,0,0,8.0,7.0
5038,1976-1977,20,AFC Ajax,HFC Haarlem,2,0,1,3,0,2,2,13.0,1.0
5039,1976-1977,20,SC Eindhoven,FC Den Haag,1,0,1,3,0,1,1,7.0,8.0
5040,1976-1977,20,FC Twente,NEC Nijmegen,2,3,2,0,3,5,-1,7.0,8.0
5041,1976-1977,20,FC Utrecht,Roda JC Kerkrade,2,6,2,0,3,8,-4,5.0,6.0
5042,1976-1977,20,VVV-Venlo,De Graafschap,1,1,3,1,1,2,0,6.0,2.0
5043,1976-1977,20,Go Ahead Eagles,Feyenoord,0,0,3,1,1,0,0,6.0,8.0
5044,1976-1977,20,Sparta Rotterdam,PSV,0,2,2,0,3,2,-2,6.0,10.0
5045,1976-1977,20,Telstar,FC Amsterdam,0,2,2,0,3,2,-2,7.0,7.0
5046,1976-1977,21,PSV,AFC Ajax,3,1,1,3,0,4,2,13.0,10.0
5047,1976-1977,21,AZ '67 Alkmaar,VVV-Venlo,6,0,1,3,0,6,6,7.0,5.0
5048,1976-1977,21,De Graafschap,FC Twente,0,2,2,0,3,2,-2,2.0,9.0
5049,1976-1977,21,FC Amsterdam,Go Ahead Eagles,1,2,2,0,3,3,-1,4.0,8.0
5050,1976-1977,21,FC Den Haag,Sparta Rotterdam,1,1,3,1,1,2,0,6.0,7.0
5051,1976-1977,21,Feyenoord,SC Eindhoven,1,1,3,1,1,2,0,8.0,5.0
5052,1976-1977,21,HFC Haarlem,NAC Breda,0,2,2,0,3,2,-2,1.0,11.0
5053,1976-1977,21,NEC Nijmegen,FC Utrecht,0,1,2,0,3,1,-1,5.0,7.0
5054,1976-1977,21,Roda JC Kerkrade,Telstar,2,1,1,3,0,3,1,9.0,6.0
5055,1976-1977,22,NAC Breda,PSV,1,2,2,0,3,3,-1,8.0,13.0
5056,1976-1977,22,AFC Ajax,FC Den Haag,2,1,1,3,0,3,1,10.0,3.0
5057,1976-1977,22,SC Eindhoven,Sparta Rotterdam,0,0,3,1,1,0,0,6.0,5.0
5058,1976-1977,22,FC Twente,AZ '67 Alkmaar,0,2,2,0,3,2,-2,9.0,10.0
5059,1976-1977,22,FC Utrecht,De Graafschap,3,2,1,3,0,5,1,7.0,2.0
5060,1976-1977,22,VVV-Venlo,HFC Haarlem,0,0,3,1,1,0,0,3.0,2.0
5061,1976-1977,22,Feyenoord,FC Amsterdam,0,0,3,1,1,0,0,6.0,5.0
5062,1976-1977,22,Go Ahead Eagles,Roda JC Kerkrade,1,2,2,0,3,3,-1,8.0,12.0
5063,1976-1977,22,Telstar,NEC Nijmegen,1,1,3,1,1,2,0,4.0,6.0
5064,1976-1977,23,De Graafschap,Telstar,0,0,3,1,1,0,0,2.0,5.0
5065,1976-1977,23,FC Den Haag,NAC Breda,4,0,1,3,0,4,4,5.0,7.0
5066,1976-1977,23,NEC Nijmegen,Go Ahead Eagles,2,1,1,3,0,3,1,8.0,5.0
5067,1976-1977,23,PSV,VVV-Venlo,1,0,1,3,0,1,1,13.0,3.0
5068,1976-1977,23,AZ '67 Alkmaar,FC Utrecht,2,1,1,3,0,3,1,10.0,7.0
5069,1976-1977,23,FC Amsterdam,SC Eindhoven,0,0,3,1,1,0,0,6.0,7.0
5070,1976-1977,23,HFC Haarlem,FC Twente,1,2,2,0,3,3,-1,1.0,9.0
5071,1976-1977,23,Roda JC Kerkrade,Feyenoord,1,1,3,1,1,2,0,10.0,4.0
5072,1976-1977,23,Sparta Rotterdam,AFC Ajax,0,3,2,0,3,3,-3,5.0,12.0
5073,1976-1977,24,NAC Breda,Sparta Rotterdam,0,0,3,1,1,0,0,5.0,3.0
5074,1976-1977,24,SC Eindhoven,AFC Ajax,0,1,2,0,3,1,-1,6.0,12.0
5075,1976-1977,24,FC Amsterdam,Roda JC Kerkrade,1,2,2,0,3,3,-1,5.0,13.0
5076,1976-1977,24,FC Twente,PSV,1,1,3,1,1,2,0,7.0,13.0
5077,1976-1977,24,FC Utrecht,HFC Haarlem,1,0,1,3,0,1,1,9.0,1.0
5078,1976-1977,24,VVV-Venlo,FC Den Haag,2,0,1,3,0,2,2,5.0,4.0
5079,1976-1977,24,Feyenoord,NEC Nijmegen,2,0,1,3,0,2,2,7.0,7.0
5080,1976-1977,24,Go Ahead Eagles,De Graafschap,0,1,2,0,3,1,-1,4.0,5.0
5081,1976-1977,24,Telstar,AZ '67 Alkmaar,2,2,3,1,1,4,0,3.0,11.0
5082,1976-1977,25,PSV,FC Utrecht,3,0,1,3,0,3,3,13.0,9.0
5083,1976-1977,25,AFC Ajax,NAC Breda,4,0,1,3,0,4,4,12.0,4.0
5084,1976-1977,25,AZ '67 Alkmaar,Go Ahead Eagles,0,0,3,1,1,0,0,11.0,4.0
5085,1976-1977,25,De Graafschap,Feyenoord,2,2,3,1,1,4,0,5.0,7.0
5086,1976-1977,25,FC Den Haag,FC Twente,1,1,3,1,1,2,0,5.0,8.0
5087,1976-1977,25,HFC Haarlem,Telstar,0,1,2,0,3,1,-1,1.0,6.0
5088,1976-1977,25,NEC Nijmegen,FC Amsterdam,1,1,3,1,1,2,0,5.0,3.0
5089,1976-1977,25,Roda JC Kerkrade,SC Eindhoven,2,0,1,3,0,2,2,13.0,3.0
5090,1976-1977,25,Sparta Rotterdam,VVV-Venlo,3,2,1,3,0,5,1,6.0,4.0
5091,1976-1977,26,SC Eindhoven,NAC Breda,1,1,3,1,1,2,0,3.0,2.0
5092,1976-1977,26,FC Amsterdam,De Graafschap,2,1,1,3,0,3,1,6.0,5.0
5093,1976-1977,26,FC Twente,Sparta Rotterdam,1,1,3,1,1,2,0,6.0,6.0
5094,1976-1977,26,FC Utrecht,FC Den Haag,5,1,1,3,0,6,4,9.0,4.0
5095,1976-1977,26,VVV-Venlo,AFC Ajax,2,2,3,1,1,4,0,5.0,13.0
5096,1976-1977,26,Feyenoord,AZ '67 Alkmaar,0,2,2,0,3,2,-2,6.0,11.0
5097,1976-1977,26,Go Ahead Eagles,HFC Haarlem,2,1,1,3,0,3,1,4.0,1.0
5098,1976-1977,26,Roda JC Kerkrade,NEC Nijmegen,1,0,1,3,0,1,1,13.0,5.0
5099,1976-1977,26,Telstar,PSV,2,2,3,1,1,4,0,7.0,11.0
5100,1976-1977,27,NAC Breda,VVV-Venlo,2,1,1,3,0,3,1,5.0,4.0
5101,1976-1977,27,NEC Nijmegen,SC Eindhoven,2,0,1,3,0,2,2,7.0,2.0
5102,1976-1977,27,PSV,Go Ahead Eagles,2,0,1,3,0,2,2,11.0,4.0
5103,1976-1977,27,Sparta Rotterdam,FC Utrecht,3,0,1,3,0,3,3,8.0,6.0
5104,1976-1977,27,AFC Ajax,FC Twente,1,1,3,1,1,2,0,11.0,7.0
5105,1976-1977,27,AZ '67 Alkmaar,FC Amsterdam,2,0,1,3,0,2,2,11.0,5.0
5106,1976-1977,27,De Graafschap,Roda JC Kerkrade,2,2,3,1,1,4,0,6.0,11.0
5107,1976-1977,27,FC Den Haag,Telstar,1,1,3,1,1,2,0,5.0,7.0
5108,1976-1977,27,HFC Haarlem,Feyenoord,0,3,2,0,3,3,-3,0.0,8.0
5109,1976-1977,28,Go Ahead Eagles,FC Den Haag,1,0,1,3,0,1,1,7.0,2.0
5110,1976-1977,28,NEC Nijmegen,De Graafschap,0,0,3,1,1,0,0,5.0,6.0
5111,1976-1977,28,Roda JC Kerkrade,AZ '67 Alkmaar,0,2,2,0,3,2,-2,10.0,11.0
5112,1976-1977,28,SC Eindhoven,VVV-Venlo,1,1,3,1,1,2,0,2.0,5.0
5113,1976-1977,28,FC Amsterdam,HFC Haarlem,1,0,1,3,0,1,1,7.0,0.0
5114,1976-1977,28,FC Twente,NAC Breda,5,0,1,3,0,5,5,7.0,5.0
5115,1976-1977,28,FC Utrecht,AFC Ajax,0,2,2,0,3,2,-2,6.0,11.0
5116,1976-1977,28,Feyenoord,PSV,3,2,1,3,0,5,1,10.0,8.0
5117,1976-1977,28,Telstar,Sparta Rotterdam,1,1,3,1,1,2,0,7.0,9.0
5118,1976-1977,29,AZ '67 Alkmaar,NEC Nijmegen,4,1,1,3,0,5,3,13.0,5.0
5119,1976-1977,29,NAC Breda,FC Utrecht,1,1,3,1,1,2,0,5.0,4.0
5120,1976-1977,29,PSV,FC Amsterdam,1,0,1,3,0,1,1,10.0,7.0
5121,1976-1977,29,Sparta Rotterdam,Go Ahead Eagles,4,0,1,3,0,4,4,11.0,7.0
5122,1976-1977,29,AFC Ajax,Telstar,4,0,1,3,0,4,4,11.0,6.0
5123,1976-1977,29,De Graafschap,SC Eindhoven,2,0,1,3,0,2,2,6.0,2.0
5124,1976-1977,29,FC Den Haag,Feyenoord,0,0,3,1,1,0,0,3.0,8.0
5125,1976-1977,29,VVV-Venlo,FC Twente,1,0,1,3,0,1,1,5.0,6.0
5126,1976-1977,29,HFC Haarlem,Roda JC Kerkrade,2,0,1,3,0,2,2,3.0,7.0
5127,1976-1977,30,Go Ahead Eagles,AFC Ajax,1,0,1,3,0,1,1,9.0,8.0
5128,1976-1977,30,NEC Nijmegen,HFC Haarlem,1,2,2,0,3,3,-1,4.0,6.0
5129,1976-1977,30,De Graafschap,AZ '67 Alkmaar,0,0,3,1,1,0,0,6.0,13.0
5130,1976-1977,30,SC Eindhoven,FC Twente,1,1,3,1,1,2,0,3.0,6.0
5131,1976-1977,30,FC Amsterdam,FC Den Haag,1,1,3,1,1,2,0,7.0,3.0
5132,1976-1977,30,FC Utrecht,VVV-Venlo,1,1,3,1,1,2,0,5.0,6.0
5133,1976-1977,30,Feyenoord,Sparta Rotterdam,1,1,3,1,1,2,0,8.0,9.0
5134,1976-1977,30,Roda JC Kerkrade,PSV,2,0,1,3,0,2,2,7.0,7.0
5135,1976-1977,30,Telstar,NAC Breda,0,0,3,1,1,0,0,4.0,6.0
5136,1976-1977,31,AZ '67 Alkmaar,SC Eindhoven,3,0,1,3,0,3,3,13.0,2.0
5137,1976-1977,31,FC Den Haag,Roda JC Kerkrade,3,0,1,3,0,3,3,6.0,4.0
5138,1976-1977,31,FC Twente,FC Utrecht,8,0,1,3,0,8,8,8.0,2.0
5139,1976-1977,31,NAC Breda,Go Ahead Eagles,1,1,3,1,1,2,0,6.0,7.0
5140,1976-1977,31,PSV,NEC Nijmegen,3,0,1,3,0,3,3,9.0,4.0
5141,1976-1977,31,Sparta Rotterdam,FC Amsterdam,0,1,2,0,3,1,-1,8.0,7.0
5142,1976-1977,31,AFC Ajax,Feyenoord,2,1,1,3,0,3,1,10.0,8.0
5143,1976-1977,31,VVV-Venlo,Telstar,0,0,3,1,1,0,0,6.0,4.0
5144,1976-1977,31,HFC Haarlem,De Graafschap,2,1,1,3,0,3,1,9.0,6.0
5145,1976-1977,32,AZ '67 Alkmaar,HFC Haarlem,1,0,1,3,0,1,1,13.0,9.0
5146,1976-1977,32,De Graafschap,PSV,0,3,2,0,3,3,-3,5.0,9.0
5147,1976-1977,32,SC Eindhoven,FC Utrecht,1,2,2,0,3,3,-1,2.0,5.0
5148,1976-1977,32,FC Amsterdam,AFC Ajax,2,3,2,0,3,5,-1,7.0,12.0
5149,1976-1977,32,Feyenoord,NAC Breda,1,1,3,1,1,2,0,6.0,4.0
5150,1976-1977,32,Go Ahead Eagles,VVV-Venlo,3,1,1,3,0,4,2,10.0,6.0
5151,1976-1977,32,NEC Nijmegen,FC Den Haag,1,1,3,1,1,2,0,2.0,6.0
5152,1976-1977,32,Roda JC Kerkrade,Sparta Rotterdam,1,1,3,1,1,2,0,4.0,6.0
5153,1976-1977,32,Telstar,FC Twente,2,1,1,3,0,3,1,6.0,7.0
5154,1976-1977,33,AFC Ajax,Roda JC Kerkrade,1,2,2,0,3,3,-1,9.0,7.0
5155,1976-1977,33,FC Den Haag,De Graafschap,3,0,1,3,0,3,3,9.0,4.0
5156,1976-1977,33,FC Twente,Go Ahead Eagles,4,2,1,3,0,6,2,7.0,7.0
5157,1976-1977,33,FC Utrecht,Telstar,3,1,1,3,0,4,2,8.0,5.0
5158,1976-1977,33,VVV-Venlo,Feyenoord,2,0,1,3,0,2,2,8.0,3.0
5159,1976-1977,33,HFC Haarlem,SC Eindhoven,3,2,1,3,0,5,1,12.0,1.0
5160,1976-1977,33,NAC Breda,FC Amsterdam,2,0,1,3,0,2,2,7.0,4.0
5161,1976-1977,33,PSV,AZ '67 Alkmaar,2,0,1,3,0,2,2,12.0,10.0
5162,1976-1977,33,Sparta Rotterdam,NEC Nijmegen,5,0,1,3,0,5,5,8.0,1.0
5163,1976-1977,34,AZ '67 Alkmaar,FC Den Haag,2,1,1,3,0,3,1,10.0,8.0
5164,1976-1977,34,De Graafschap,Sparta Rotterdam,2,0,1,3,0,2,2,4.0,5.0
5165,1976-1977,34,SC Eindhoven,Telstar,1,0,1,3,0,1,1,4.0,5.0
5166,1976-1977,34,FC Amsterdam,VVV-Venlo,8,3,1,3,0,11,5,7.0,5.0
5167,1976-1977,34,Feyenoord,FC Twente,1,2,2,0,3,3,-1,2.0,10.0
5168,1976-1977,34,Go Ahead Eagles,FC Utrecht,4,2,1,3,0,6,2,10.0,7.0
5169,1976-1977,34,HFC Haarlem,PSV,0,1,2,0,3,1,-1,9.0,12.0
5170,1976-1977,34,NEC Nijmegen,AFC Ajax,0,0,3,1,1,0,0,2.0,7.0
5171,1976-1977,34,Roda JC Kerkrade,NAC Breda,3,0,1,3,0,3,3,10.0,6.0
5172,1977-1978,1,AZ '67 Alkmaar,FC Volendam,1,1,3,1,1,2,0,10.0,2.0
5173,1977-1978,1,FC Den Haag,Feyenoord,2,1,1,3,0,3,1,10.0,1.0
5174,1977-1978,1,FC Twente,FC Utrecht,2,0,1,3,0,2,2,12.0,6.0
5175,1977-1978,1,NEC Nijmegen,Roda JC Kerkrade,2,0,1,3,0,2,2,5.0,7.0
5176,1977-1978,1,PSV,Vitesse,4,0,1,3,0,4,4,15.0,3.0
5177,1977-1978,1,Sparta Rotterdam,NAC Breda,1,0,1,3,0,1,1,7.0,5.0
5178,1977-1978,1,FC Amsterdam,Telstar,2,1,1,3,0,3,1,9.0,4.0
5179,1977-1978,1,VVV-Venlo,Go Ahead Eagles,1,1,3,1,1,2,0,5.0,8.0
5180,1977-1978,1,HFC Haarlem,AFC Ajax,0,2,2,0,3,2,-2,6.0,10.0
5181,1977-1978,2,AFC Ajax,AZ '67 Alkmaar,2,1,1,3,0,3,1,10.0,7.0
5182,1977-1978,2,FC Utrecht,HFC Haarlem,3,0,1,3,0,3,3,9.0,3.0
5183,1977-1978,2,FC Volendam,FC Amsterdam,3,0,1,3,0,3,3,5.0,6.0
5184,1977-1978,2,Feyenoord,Sparta Rotterdam,1,1,3,1,1,2,0,2.0,8.0
5185,1977-1978,2,Go Ahead Eagles,NEC Nijmegen,2,3,2,0,3,5,-1,7.0,8.0
5186,1977-1978,2,NAC Breda,PSV,0,2,2,0,3,2,-2,4.0,15.0
5187,1977-1978,2,Roda JC Kerkrade,FC Den Haag,4,2,1,3,0,6,2,10.0,7.0
5188,1977-1978,2,Telstar,VVV-Venlo,1,3,2,0,3,4,-2,3.0,7.0
5189,1977-1978,2,Vitesse,FC Twente,1,1,3,1,1,2,0,4.0,10.0
5190,1977-1978,3,NAC Breda,FC Twente,2,0,1,3,0,2,2,6.0,10.0
5191,1977-1978,3,FC Amsterdam,AZ '67 Alkmaar,2,9,2,0,3,11,-7,6.0,7.0
5192,1977-1978,3,FC Utrecht,AFC Ajax,1,2,2,0,3,3,-1,6.0,10.0
5193,1977-1978,3,FC Volendam,VVV-Venlo,2,0,1,3,0,2,2,8.0,7.0
5194,1977-1978,3,Feyenoord,PSV,1,1,3,1,1,2,0,2.0,13.0
5195,1977-1978,3,Go Ahead Eagles,FC Den Haag,3,2,1,3,0,5,1,7.0,6.0
5196,1977-1978,3,Roda JC Kerkrade,Sparta Rotterdam,1,1,3,1,1,2,0,10.0,8.0
5197,1977-1978,3,Telstar,NEC Nijmegen,0,5,2,0,3,5,-5,0.0,10.0
5198,1977-1978,3,Vitesse,HFC Haarlem,2,0,1,3,0,2,2,4.0,3.0
5199,1977-1978,4,AFC Ajax,Vitesse,3,1,1,3,0,4,2,13.0,4.0
5200,1977-1978,4,AZ '67 Alkmaar,FC Utrecht,4,1,1,3,0,5,3,10.0,3.0
5201,1977-1978,4,FC Den Haag,Telstar,3,0,1,3,0,3,3,6.0,0.0
5202,1977-1978,4,FC Twente,Feyenoord,1,1,3,1,1,2,0,8.0,3.0
5203,1977-1978,4,VVV-Venlo,FC Amsterdam,3,0,1,3,0,3,3,7.0,6.0
5204,1977-1978,4,HFC Haarlem,NAC Breda,0,0,3,1,1,0,0,1.0,4.0
5205,1977-1978,4,NEC Nijmegen,FC Volendam,2,1,1,3,0,3,1,13.0,7.0
5206,1977-1978,4,PSV,Roda JC Kerkrade,4,0,1,3,0,4,4,13.0,7.0
5207,1977-1978,4,Sparta Rotterdam,Go Ahead Eagles,4,0,1,3,0,4,4,8.0,7.0
5208,1977-1978,5,Go Ahead Eagles,PSV,1,4,2,0,3,5,-3,4.0,13.0
5209,1977-1978,5,NAC Breda,AFC Ajax,0,0,3,1,1,0,0,5.0,13.0
5210,1977-1978,5,FC Amsterdam,NEC Nijmegen,0,3,2,0,3,3,-3,3.0,15.0
5211,1977-1978,5,FC Volendam,FC Den Haag,1,3,2,0,3,4,-2,7.0,9.0
5212,1977-1978,5,VVV-Venlo,AZ '67 Alkmaar,2,2,3,1,1,4,0,8.0,8.0
5213,1977-1978,5,Feyenoord,HFC Haarlem,4,0,1,3,0,4,4,6.0,1.0
5214,1977-1978,5,Roda JC Kerkrade,FC Twente,1,0,1,3,0,1,1,7.0,5.0
5215,1977-1978,5,Telstar,Sparta Rotterdam,0,2,2,0,3,2,-2,0.0,11.0
5216,1977-1978,5,Vitesse,FC Utrecht,1,0,1,3,0,1,1,7.0,3.0
5217,1977-1978,6,FC Den Haag,FC Amsterdam,3,1,1,3,0,4,2,9.0,0.0
5218,1977-1978,6,NEC Nijmegen,VVV-Venlo,1,0,1,3,0,1,1,15.0,7.0
5219,1977-1978,6,PSV,Telstar,1,0,1,3,0,1,1,13.0,0.0
5220,1977-1978,6,Sparta Rotterdam,FC Volendam,1,0,1,3,0,1,1,11.0,6.0
5221,1977-1978,6,AFC Ajax,Feyenoord,2,2,3,1,1,4,0,11.0,7.0
5222,1977-1978,6,AZ '67 Alkmaar,Vitesse,4,0,1,3,0,4,4,10.0,7.0
5223,1977-1978,6,FC Twente,Go Ahead Eagles,3,1,1,3,0,4,2,5.0,3.0
5224,1977-1978,6,FC Utrecht,NAC Breda,3,1,1,3,0,4,2,6.0,5.0
5225,1977-1978,6,HFC Haarlem,Roda JC Kerkrade,0,0,3,1,1,0,0,2.0,8.0
5226,1977-1978,7,VVV-Venlo,FC Den Haag,5,1,1,3,0,6,4,7.0,9.0
5227,1977-1978,7,Go Ahead Eagles,HFC Haarlem,1,2,2,0,3,3,-1,3.0,5.0
5228,1977-1978,7,NEC Nijmegen,AZ '67 Alkmaar,0,3,2,0,3,3,-3,12.0,13.0
5229,1977-1978,7,FC Amsterdam,Sparta Rotterdam,2,1,1,3,0,3,1,3.0,10.0
5230,1977-1978,7,FC Volendam,PSV,0,4,2,0,3,4,-4,3.0,13.0
5231,1977-1978,7,Feyenoord,FC Utrecht,1,0,1,3,0,1,1,9.0,3.0
5232,1977-1978,7,NAC Breda,Vitesse,1,1,3,1,1,2,0,6.0,7.0
5233,1977-1978,7,Roda JC Kerkrade,AFC Ajax,4,1,1,3,0,5,3,8.0,8.0
5234,1977-1978,7,Telstar,FC Twente,0,5,2,0,3,5,-5,0.0,7.0
5235,1977-1978,8,AFC Ajax,Go Ahead Eagles,2,0,1,3,0,2,2,8.0,0.0
5236,1977-1978,8,AZ '67 Alkmaar,NAC Breda,1,0,1,3,0,1,1,13.0,3.0
5237,1977-1978,8,FC Den Haag,NEC Nijmegen,1,2,2,0,3,3,-1,9.0,12.0
5238,1977-1978,8,FC Twente,FC Volendam,1,0,1,3,0,1,1,10.0,0.0
5239,1977-1978,8,FC Utrecht,Roda JC Kerkrade,3,0,1,3,0,3,3,6.0,7.0
5240,1977-1978,8,HFC Haarlem,Telstar,1,1,3,1,1,2,0,6.0,1.0
5241,1977-1978,8,PSV,FC Amsterdam,2,0,1,3,0,2,2,15.0,3.0
5242,1977-1978,8,Sparta Rotterdam,VVV-Venlo,2,1,1,3,0,3,1,12.0,7.0
5243,1977-1978,8,Vitesse,Feyenoord,2,2,3,1,1,4,0,5.0,9.0
5244,1977-1978,9,FC Amsterdam,FC Twente,1,3,2,0,3,4,-2,3.0,12.0
5245,1977-1978,9,FC Den Haag,AZ '67 Alkmaar,1,0,1,3,0,1,1,9.0,10.0
5246,1977-1978,9,FC Volendam,HFC Haarlem,1,1,3,1,1,2,0,1.0,6.0
5247,1977-1978,9,VVV-Venlo,PSV,0,4,2,0,3,4,-4,4.0,15.0
5248,1977-1978,9,Feyenoord,NAC Breda,1,1,3,1,1,2,0,9.0,3.0
5249,1977-1978,9,Go Ahead Eagles,FC Utrecht,2,1,1,3,0,3,1,3.0,6.0
5250,1977-1978,9,NEC Nijmegen,Sparta Rotterdam,1,1,3,1,1,2,0,10.0,10.0
5251,1977-1978,9,Roda JC Kerkrade,Vitesse,0,0,3,1,1,0,0,8.0,6.0
5252,1977-1978,9,Telstar,AFC Ajax,0,3,2,0,3,3,-3,1.0,8.0
5253,1977-1978,10,AFC Ajax,FC Volendam,1,2,2,0,3,3,-1,7.0,4.0
5254,1977-1978,10,AZ '67 Alkmaar,Feyenoord,4,2,1,3,0,6,2,12.0,6.0
5255,1977-1978,10,FC Twente,VVV-Venlo,2,0,1,3,0,2,2,15.0,3.0
5256,1977-1978,10,FC Utrecht,Telstar,1,1,3,1,1,2,0,7.0,2.0
5257,1977-1978,10,HFC Haarlem,FC Amsterdam,0,2,2,0,3,2,-2,6.0,6.0
5258,1977-1978,10,NAC Breda,Roda JC Kerkrade,0,1,2,0,3,1,-1,2.0,8.0
5259,1977-1978,10,PSV,NEC Nijmegen,3,0,1,3,0,3,3,15.0,7.0
5260,1977-1978,10,Sparta Rotterdam,FC Den Haag,2,0,1,3,0,2,2,10.0,6.0
5261,1977-1978,10,Vitesse,Go Ahead Eagles,2,1,1,3,0,3,1,6.0,3.0
5262,1977-1978,11,FC Den Haag,PSV,1,3,2,0,3,4,-2,3.0,15.0
5263,1977-1978,11,Sparta Rotterdam,AZ '67 Alkmaar,2,1,1,3,0,3,1,10.0,9.0
5264,1977-1978,11,FC Amsterdam,AFC Ajax,1,3,2,0,3,4,-2,6.0,9.0
5265,1977-1978,11,FC Volendam,FC Utrecht,3,3,3,1,1,6,0,5.0,5.0
5266,1977-1978,11,VVV-Venlo,HFC Haarlem,0,0,3,1,1,0,0,4.0,6.0
5267,1977-1978,11,Go Ahead Eagles,NAC Breda,1,2,2,0,3,3,-1,3.0,5.0
5268,1977-1978,11,NEC Nijmegen,FC Twente,0,2,2,0,3,2,-2,4.0,15.0
5269,1977-1978,11,Roda JC Kerkrade,Feyenoord,0,0,3,1,1,0,0,8.0,6.0
5270,1977-1978,11,Telstar,Vitesse,5,1,1,3,0,6,4,5.0,6.0
5271,1977-1978,12,AFC Ajax,VVV-Venlo,5,0,1,3,0,5,5,12.0,1.0
5272,1977-1978,12,AZ '67 Alkmaar,Roda JC Kerkrade,1,1,3,1,1,2,0,7.0,6.0
5273,1977-1978,12,FC Twente,FC Den Haag,6,1,1,3,0,7,5,15.0,3.0
5274,1977-1978,12,FC Utrecht,FC Amsterdam,2,2,3,1,1,4,0,6.0,4.0
5275,1977-1978,12,NAC Breda,Telstar,2,2,3,1,1,4,0,5.0,6.0
5276,1977-1978,12,PSV,Sparta Rotterdam,1,0,1,3,0,1,1,15.0,10.0
5277,1977-1978,12,Feyenoord,Go Ahead Eagles,2,0,1,3,0,2,2,6.0,3.0
5278,1977-1978,12,HFC Haarlem,NEC Nijmegen,6,0,1,3,0,6,6,6.0,4.0
5279,1977-1978,12,Vitesse,FC Volendam,2,2,3,1,1,4,0,6.0,6.0
5280,1977-1978,13,FC Den Haag,HFC Haarlem,2,1,1,3,0,3,1,6.0,5.0
5281,1977-1978,13,Go Ahead Eagles,Roda JC Kerkrade,1,2,2,0,3,3,-1,3.0,9.0
5282,1977-1978,13,PSV,AZ '67 Alkmaar,0,0,3,1,1,0,0,13.0,5.0
5283,1977-1978,13,FC Amsterdam,Vitesse,1,1,3,1,1,2,0,5.0,6.0
5284,1977-1978,13,FC Volendam,NAC Breda,3,1,1,3,0,4,2,9.0,5.0
5285,1977-1978,13,VVV-Venlo,FC Utrecht,3,0,1,3,0,3,3,4.0,3.0
5286,1977-1978,13,NEC Nijmegen,AFC Ajax,0,1,2,0,3,1,-1,1.0,12.0
5287,1977-1978,13,Sparta Rotterdam,FC Twente,1,2,2,0,3,3,-1,7.0,15.0
5288,1977-1978,13,Telstar,Feyenoord,0,1,2,0,3,1,-1,5.0,8.0
5289,1977-1978,14,AZ '67 Alkmaar,Go Ahead Eagles,2,1,1,3,0,3,1,8.0,0.0
5290,1977-1978,14,NAC Breda,FC Amsterdam,3,2,1,3,0,5,1,7.0,5.0
5291,1977-1978,14,AFC Ajax,FC Den Haag,3,2,1,3,0,5,1,12.0,3.0
5292,1977-1978,14,FC Twente,PSV,1,1,3,1,1,2,0,13.0,11.0
5293,1977-1978,14,FC Utrecht,NEC Nijmegen,3,1,1,3,0,4,2,6.0,0.0
5294,1977-1978,14,Feyenoord,FC Volendam,3,0,1,3,0,3,3,10.0,8.0
5295,1977-1978,14,HFC Haarlem,Sparta Rotterdam,3,2,1,3,0,5,1,7.0,6.0
5296,1977-1978,14,Roda JC Kerkrade,Telstar,2,0,1,3,0,2,2,11.0,5.0
5297,1977-1978,14,Vitesse,VVV-Venlo,4,1,1,3,0,5,3,8.0,4.0
5298,1977-1978,15,FC Den Haag,FC Utrecht,1,1,3,1,1,2,0,4.0,6.0
5299,1977-1978,15,PSV,HFC Haarlem,5,1,1,3,0,6,4,11.0,7.0
5300,1977-1978,15,FC Amsterdam,Feyenoord,1,2,2,0,3,3,-1,2.0,13.0
5301,1977-1978,15,FC Twente,AZ '67 Alkmaar,1,4,2,0,3,5,-3,10.0,8.0
5302,1977-1978,15,FC Volendam,Roda JC Kerkrade,3,0,1,3,0,3,3,8.0,8.0
5303,1977-1978,15,VVV-Venlo,NAC Breda,1,1,3,1,1,2,0,5.0,8.0
5304,1977-1978,15,NEC Nijmegen,Vitesse,0,3,2,0,3,3,-3,0.0,8.0
5305,1977-1978,15,Sparta Rotterdam,AFC Ajax,1,1,3,1,1,2,0,4.0,13.0
5306,1977-1978,15,Telstar,Go Ahead Eagles,0,6,2,0,3,6,-6,4.0,3.0
5307,1977-1978,16,Go Ahead Eagles,FC Volendam,1,0,1,3,0,1,1,6.0,7.0
5308,1977-1978,16,NAC Breda,NEC Nijmegen,2,1,1,3,0,3,1,8.0,0.0
5309,1977-1978,16,AFC Ajax,PSV,1,4,2,0,3,5,-3,10.0,11.0
5310,1977-1978,16,AZ '67 Alkmaar,Telstar,4,0,1,3,0,4,4,11.0,1.0
5311,1977-1978,16,FC Utrecht,Sparta Rotterdam,2,2,3,1,1,4,0,6.0,2.0
5312,1977-1978,16,Feyenoord,VVV-Venlo,6,0,1,3,0,6,6,15.0,4.0
5313,1977-1978,16,HFC Haarlem,FC Twente,1,1,3,1,1,2,0,7.0,8.0
5314,1977-1978,16,Roda JC Kerkrade,FC Amsterdam,3,1,1,3,0,4,2,10.0,2.0
5315,1977-1978,16,Vitesse,FC Den Haag,2,1,1,3,0,3,1,11.0,4.0
5316,1977-1978,17,PSV,FC Utrecht,1,0,1,3,0,1,1,11.0,5.0
5317,1977-1978,17,FC Amsterdam,Go Ahead Eagles,4,4,3,1,1,8,0,2.0,7.0
5318,1977-1978,17,FC Den Haag,NAC Breda,1,2,2,0,3,3,-1,4.0,10.0
5319,1977-1978,17,FC Twente,AFC Ajax,2,2,3,1,1,4,0,6.0,8.0
5320,1977-1978,17,FC Volendam,Telstar,2,0,1,3,0,2,2,9.0,0.0
5321,1977-1978,17,VVV-Venlo,Roda JC Kerkrade,0,5,2,0,3,5,-5,4.0,12.0
5322,1977-1978,17,HFC Haarlem,AZ '67 Alkmaar,0,3,2,0,3,3,-3,4.0,13.0
5323,1977-1978,17,NEC Nijmegen,Feyenoord,3,2,1,3,0,5,1,3.0,12.0
5324,1977-1978,17,Sparta Rotterdam,Vitesse,4,1,1,3,0,5,3,5.0,10.0
5325,1977-1978,18,Go Ahead Eagles,VVV-Venlo,2,1,1,3,0,3,1,10.0,1.0
5326,1977-1978,18,NAC Breda,Sparta Rotterdam,0,0,3,1,1,0,0,11.0,6.0
5327,1977-1978,18,AFC Ajax,HFC Haarlem,1,1,3,1,1,2,0,6.0,5.0
5328,1977-1978,18,FC Utrecht,FC Twente,0,0,3,1,1,0,0,6.0,4.0
5329,1977-1978,18,FC Volendam,AZ '67 Alkmaar,2,1,1,3,0,3,1,9.0,12.0
5330,1977-1978,18,Feyenoord,FC Den Haag,1,3,2,0,3,4,-2,9.0,4.0
5331,1977-1978,18,Roda JC Kerkrade,NEC Nijmegen,0,0,3,1,1,0,0,10.0,4.0
5332,1977-1978,18,Telstar,FC Amsterdam,0,1,2,0,3,1,-1,0.0,4.0
5333,1977-1978,18,Vitesse,PSV,2,2,3,1,1,4,0,10.0,11.0
5334,1977-1978,19,NEC Nijmegen,Go Ahead Eagles,3,1,1,3,0,4,2,7.0,10.0
5335,1977-1978,19,PSV,NAC Breda,2,0,1,3,0,2,2,13.0,8.0
5336,1977-1978,19,AZ '67 Alkmaar,AFC Ajax,1,0,1,3,0,1,1,12.0,3.0
5337,1977-1978,19,FC Amsterdam,FC Volendam,0,1,2,0,3,1,-1,4.0,12.0
5338,1977-1978,19,FC Den Haag,Roda JC Kerkrade,3,1,1,3,0,4,2,7.0,7.0
5339,1977-1978,19,FC Twente,Vitesse,3,1,1,3,0,4,2,6.0,7.0
5340,1977-1978,19,VVV-Venlo,Telstar,3,2,1,3,0,5,1,4.0,0.0
5341,1977-1978,19,HFC Haarlem,FC Utrecht,1,0,1,3,0,1,1,5.0,3.0
5342,1977-1978,19,Sparta Rotterdam,Feyenoord,2,3,2,0,3,5,-1,6.0,9.0
5343,1977-1978,20,PSV,Feyenoord,2,0,1,3,0,2,2,13.0,6.0
5344,1977-1978,20,AFC Ajax,FC Utrecht,6,0,1,3,0,6,6,5.0,2.0
5345,1977-1978,20,AZ '67 Alkmaar,FC Amsterdam,0,0,3,1,1,0,0,10.0,5.0
5346,1977-1978,20,FC Den Haag,Go Ahead Eagles,2,1,1,3,0,3,1,9.0,7.0
5347,1977-1978,20,FC Twente,NAC Breda,6,0,1,3,0,6,6,9.0,7.0
5348,1977-1978,20,VVV-Venlo,FC Volendam,4,2,1,3,0,6,2,6.0,9.0
5349,1977-1978,20,HFC Haarlem,Vitesse,2,2,3,1,1,4,0,6.0,5.0
5350,1977-1978,20,NEC Nijmegen,Telstar,3,0,1,3,0,3,3,10.0,0.0
5351,1977-1978,20,Sparta Rotterdam,Roda JC Kerkrade,1,0,1,3,0,1,1,8.0,7.0
5352,1977-1978,21,Go Ahead Eagles,Sparta Rotterdam,1,2,2,0,3,3,-1,4.0,10.0
5353,1977-1978,21,NAC Breda,HFC Haarlem,2,1,1,3,0,3,1,7.0,5.0
5354,1977-1978,21,FC Amsterdam,VVV-Venlo,3,0,1,3,0,3,3,8.0,6.0
5355,1977-1978,21,FC Utrecht,AZ '67 Alkmaar,0,0,3,1,1,0,0,2.0,8.0
5356,1977-1978,21,FC Volendam,NEC Nijmegen,2,0,1,3,0,2,2,12.0,10.0
5357,1977-1978,21,Feyenoord,FC Twente,0,2,2,0,3,2,-2,3.0,11.0
5358,1977-1978,21,Roda JC Kerkrade,PSV,0,0,3,1,1,0,0,5.0,11.0
5359,1977-1978,21,Telstar,FC Den Haag,0,1,2,0,3,1,-1,0.0,12.0
5360,1977-1978,21,Vitesse,AFC Ajax,2,2,3,1,1,4,0,3.0,6.0
5361,1977-1978,22,PSV,Go Ahead Eagles,1,1,3,1,1,2,0,9.0,4.0
5362,1977-1978,22,AFC Ajax,NAC Breda,3,1,1,3,0,4,2,8.0,4.0
5363,1977-1978,22,AZ '67 Alkmaar,VVV-Venlo,4,1,1,3,0,5,3,8.0,6.0
5364,1977-1978,22,FC Den Haag,FC Volendam,5,2,1,3,0,7,3,15.0,9.0
5365,1977-1978,22,FC Twente,Roda JC Kerkrade,1,0,1,3,0,1,1,13.0,2.0
5366,1977-1978,22,FC Utrecht,Vitesse,1,0,1,3,0,1,1,5.0,3.0
5367,1977-1978,22,HFC Haarlem,Feyenoord,2,0,1,3,0,2,2,8.0,3.0
5368,1977-1978,22,NEC Nijmegen,FC Amsterdam,0,0,3,1,1,0,0,8.0,8.0
5369,1977-1978,22,Sparta Rotterdam,Telstar,2,2,3,1,1,4,0,8.0,1.0
5370,1977-1978,23,VVV-Venlo,NEC Nijmegen,1,1,3,1,1,2,0,7.0,8.0
5371,1977-1978,23,Feyenoord,AFC Ajax,1,1,3,1,1,2,0,4.0,8.0
5372,1977-1978,23,Vitesse,AZ '67 Alkmaar,1,2,2,0,3,3,-1,2.0,11.0
5373,1977-1978,23,Roda JC Kerkrade,HFC Haarlem,2,2,3,1,1,4,0,2.0,8.0
5374,1977-1978,23,FC Volendam,Sparta Rotterdam,0,0,3,1,1,0,0,7.0,8.0
5375,1977-1978,23,Go Ahead Eagles,FC Twente,0,1,2,0,3,1,-1,1.0,15.0
5376,1977-1978,23,NAC Breda,FC Utrecht,4,1,1,3,0,5,3,6.0,4.0
5377,1977-1978,23,Telstar,PSV,1,1,3,1,1,2,0,2.0,9.0
5378,1977-1978,23,FC Amsterdam,FC Den Haag,0,0,3,1,1,0,0,6.0,13.0
5379,1977-1978,24,PSV,FC Volendam,3,1,1,3,0,4,2,9.0,4.0
5380,1977-1978,24,FC Den Haag,VVV-Venlo,1,2,2,0,3,3,-1,10.0,7.0
5381,1977-1978,24,FC Twente,Telstar,3,0,1,3,0,3,3,15.0,2.0
5382,1977-1978,24,AZ '67 Alkmaar,NEC Nijmegen,3,0,1,3,0,3,3,11.0,5.0
5383,1977-1978,24,Vitesse,NAC Breda,0,0,3,1,1,0,0,3.0,7.0
5384,1977-1978,24,FC Utrecht,Feyenoord,1,0,1,3,0,1,1,7.0,1.0
5385,1977-1978,24,HFC Haarlem,Go Ahead Eagles,0,0,3,1,1,0,0,6.0,2.0
5386,1977-1978,24,AFC Ajax,Roda JC Kerkrade,2,0,1,3,0,2,2,11.0,2.0
5387,1977-1978,24,Sparta Rotterdam,FC Amsterdam,6,0,1,3,0,6,6,11.0,6.0
5388,1977-1978,25,Go Ahead Eagles,AFC Ajax,1,0,1,3,0,1,1,5.0,8.0
5389,1977-1978,25,FC Amsterdam,PSV,0,7,2,0,3,7,-7,5.0,9.0
5390,1977-1978,25,FC Volendam,FC Twente,0,5,2,0,3,5,-5,4.0,15.0
5391,1977-1978,25,VVV-Venlo,Sparta Rotterdam,1,1,3,1,1,2,0,5.0,9.0
5392,1977-1978,25,Feyenoord,Vitesse,3,2,1,3,0,5,1,4.0,2.0
5393,1977-1978,25,NAC Breda,AZ '67 Alkmaar,1,2,2,0,3,3,-1,7.0,13.0
5394,1977-1978,25,NEC Nijmegen,FC Den Haag,0,0,3,1,1,0,0,3.0,8.0
5395,1977-1978,25,Roda JC Kerkrade,FC Utrecht,0,0,3,1,1,0,0,3.0,8.0
5396,1977-1978,25,Telstar,HFC Haarlem,2,1,1,3,0,3,1,5.0,5.0
5397,1977-1978,26,NAC Breda,Feyenoord,2,1,1,3,0,3,1,7.0,4.0
5398,1977-1978,26,PSV,VVV-Venlo,1,1,3,1,1,2,0,9.0,6.0
5399,1977-1978,26,AFC Ajax,Telstar,7,0,1,3,0,7,7,10.0,5.0
5400,1977-1978,26,AZ '67 Alkmaar,FC Den Haag,2,0,1,3,0,2,2,15.0,5.0
5401,1977-1978,26,FC Twente,FC Amsterdam,0,2,2,0,3,2,-2,12.0,5.0
5402,1977-1978,26,FC Utrecht,Go Ahead Eagles,2,0,1,3,0,2,2,10.0,5.0
5403,1977-1978,26,HFC Haarlem,FC Volendam,2,3,2,0,3,5,-1,5.0,4.0
5404,1977-1978,26,Sparta Rotterdam,NEC Nijmegen,3,0,1,3,0,3,3,9.0,3.0
5405,1977-1978,26,Vitesse,Roda JC Kerkrade,2,2,3,1,1,4,0,2.0,3.0
5406,1977-1978,27,Go Ahead Eagles,Vitesse,4,0,1,3,0,4,4,7.0,2.0
5407,1977-1978,27,NEC Nijmegen,PSV,2,2,3,1,1,4,0,3.0,9.0
5408,1977-1978,27,FC Amsterdam,HFC Haarlem,3,2,1,3,0,5,1,7.0,2.0
5409,1977-1978,27,FC Den Haag,Sparta Rotterdam,1,1,3,1,1,2,0,3.0,9.0
5410,1977-1978,27,FC Volendam,AFC Ajax,1,6,2,0,3,7,-5,4.0,10.0
5411,1977-1978,27,VVV-Venlo,FC Twente,1,1,3,1,1,2,0,7.0,10.0
5412,1977-1978,27,Feyenoord,AZ '67 Alkmaar,2,2,3,1,1,4,0,5.0,13.0
5413,1977-1978,27,Roda JC Kerkrade,NAC Breda,3,0,1,3,0,3,3,6.0,7.0
5414,1977-1978,27,Telstar,FC Utrecht,0,2,2,0,3,2,-2,4.0,10.0
5415,1977-1978,28,NAC Breda,Go Ahead Eagles,2,1,1,3,0,3,1,7.0,7.0
5416,1977-1978,28,PSV,FC Den Haag,2,1,1,3,0,3,1,11.0,2.0
5417,1977-1978,28,AFC Ajax,FC Amsterdam,5,1,1,3,0,6,4,12.0,6.0
5418,1977-1978,28,AZ '67 Alkmaar,Sparta Rotterdam,1,2,2,0,3,3,-1,10.0,11.0
5419,1977-1978,28,FC Twente,NEC Nijmegen,2,0,1,3,0,2,2,10.0,2.0
5420,1977-1978,28,FC Utrecht,FC Volendam,2,2,3,1,1,4,0,11.0,4.0
5421,1977-1978,28,Feyenoord,Roda JC Kerkrade,1,1,3,1,1,2,0,5.0,6.0
5422,1977-1978,28,HFC Haarlem,VVV-Venlo,2,1,1,3,0,3,1,4.0,6.0
5423,1977-1978,28,Vitesse,Telstar,4,2,1,3,0,6,2,5.0,3.0
5424,1977-1978,29,FC Den Haag,FC Twente,0,0,3,1,1,0,0,3.0,8.0
5425,1977-1978,29,Sparta Rotterdam,PSV,0,0,3,1,1,0,0,9.0,9.0
5426,1977-1978,29,FC Amsterdam,FC Utrecht,1,1,3,1,1,2,0,7.0,9.0
5427,1977-1978,29,FC Volendam,Vitesse,1,1,3,1,1,2,0,5.0,5.0
5428,1977-1978,29,VVV-Venlo,AFC Ajax,2,2,3,1,1,4,0,4.0,10.0
5429,1977-1978,29,Go Ahead Eagles,Feyenoord,2,1,1,3,0,3,1,9.0,5.0
5430,1977-1978,29,NEC Nijmegen,HFC Haarlem,1,1,3,1,1,2,0,3.0,4.0
5431,1977-1978,29,Roda JC Kerkrade,AZ '67 Alkmaar,1,2,2,0,3,3,-1,6.0,10.0
5432,1977-1978,29,Telstar,NAC Breda,1,1,3,1,1,2,0,4.0,7.0
5433,1977-1978,30,FC Utrecht,VVV-Venlo,1,1,3,1,1,2,0,9.0,4.0
5434,1977-1978,30,NAC Breda,FC Volendam,3,3,3,1,1,6,0,8.0,6.0
5435,1977-1978,30,AFC Ajax,NEC Nijmegen,6,1,1,3,0,7,5,13.0,2.0
5436,1977-1978,30,AZ '67 Alkmaar,PSV,1,1,3,1,1,2,0,8.0,7.0
5437,1977-1978,30,FC Twente,Sparta Rotterdam,1,0,1,3,0,1,1,8.0,8.0
5438,1977-1978,30,Feyenoord,Telstar,1,1,3,1,1,2,0,3.0,2.0
5439,1977-1978,30,HFC Haarlem,FC Den Haag,2,0,1,3,0,2,2,7.0,2.0
5440,1977-1978,30,Roda JC Kerkrade,Go Ahead Eagles,0,0,3,1,1,0,0,6.0,7.0
5441,1977-1978,30,Vitesse,FC Amsterdam,0,4,2,0,3,4,-4,5.0,10.0
5442,1977-1978,31,NEC Nijmegen,FC Utrecht,0,1,2,0,3,1,-1,2.0,9.0
5443,1977-1978,31,PSV,FC Twente,3,1,1,3,0,4,2,9.0,8.0
5444,1977-1978,31,FC Amsterdam,NAC Breda,2,0,1,3,0,2,2,10.0,5.0
5445,1977-1978,31,FC Den Haag,AFC Ajax,0,3,2,0,3,3,-3,2.0,13.0
5446,1977-1978,31,FC Volendam,Feyenoord,1,0,1,3,0,1,1,6.0,3.0
5447,1977-1978,31,VVV-Venlo,Vitesse,0,1,2,0,3,1,-1,3.0,7.0
5448,1977-1978,31,Go Ahead Eagles,AZ '67 Alkmaar,2,0,1,3,0,2,2,10.0,5.0
5449,1977-1978,31,Sparta Rotterdam,HFC Haarlem,3,1,1,3,0,4,2,8.0,7.0
5450,1977-1978,31,Telstar,Roda JC Kerkrade,1,2,2,0,3,3,-1,2.0,8.0
5451,1977-1978,32,AFC Ajax,Sparta Rotterdam,0,0,3,1,1,0,0,11.0,8.0
5452,1977-1978,32,AZ '67 Alkmaar,FC Twente,4,1,1,3,0,5,3,7.0,7.0
5453,1977-1978,32,FC Utrecht,FC Den Haag,1,0,1,3,0,1,1,9.0,1.0
5454,1977-1978,32,Feyenoord,FC Amsterdam,1,1,3,1,1,2,0,3.0,8.0
5455,1977-1978,32,Go Ahead Eagles,Telstar,5,1,1,3,0,6,4,10.0,2.0
5456,1977-1978,32,HFC Haarlem,PSV,1,0,1,3,0,1,1,10.0,8.0
5457,1977-1978,32,NAC Breda,VVV-Venlo,0,2,2,0,3,2,-2,5.0,5.0
5458,1977-1978,32,Roda JC Kerkrade,FC Volendam,1,4,2,0,3,5,-3,5.0,9.0
5459,1977-1978,32,Vitesse,NEC Nijmegen,3,2,1,3,0,5,1,10.0,1.0
5460,1977-1978,33,FC Amsterdam,Roda JC Kerkrade,1,2,2,0,3,3,-1,8.0,7.0
5461,1977-1978,33,FC Den Haag,Vitesse,1,1,3,1,1,2,0,2.0,8.0
5462,1977-1978,33,FC Twente,HFC Haarlem,0,0,3,1,1,0,0,5.0,8.0
5463,1977-1978,33,FC Volendam,Go Ahead Eagles,1,0,1,3,0,1,1,11.0,10.0
5464,1977-1978,33,VVV-Venlo,Feyenoord,4,3,1,3,0,7,1,8.0,2.0
5465,1977-1978,33,NEC Nijmegen,NAC Breda,2,2,3,1,1,4,0,2.0,3.0
5466,1977-1978,33,PSV,AFC Ajax,2,3,2,0,3,5,-1,5.0,11.0
5467,1977-1978,33,Sparta Rotterdam,FC Utrecht,2,3,2,0,3,5,-1,5.0,11.0
5468,1977-1978,33,Telstar,AZ '67 Alkmaar,0,0,3,1,1,0,0,3.0,8.0
5469,1977-1978,34,AZ '67 Alkmaar,HFC Haarlem,6,0,1,3,0,6,6,8.0,7.0
5470,1977-1978,34,NAC Breda,FC Den Haag,1,0,1,3,0,1,1,5.0,1.0
5471,1977-1978,34,Vitesse,Sparta Rotterdam,2,1,1,3,0,3,1,10.0,4.0
5472,1977-1978,34,AFC Ajax,FC Twente,4,1,1,3,0,5,3,13.0,4.0
5473,1977-1978,34,FC Utrecht,PSV,0,1,2,0,3,1,-1,10.0,7.0
5474,1977-1978,34,Feyenoord,NEC Nijmegen,2,0,1,3,0,2,2,5.0,1.0
5475,1977-1978,34,Go Ahead Eagles,FC Amsterdam,2,0,1,3,0,2,2,10.0,7.0
5476,1977-1978,34,Roda JC Kerkrade,VVV-Venlo,2,1,1,3,0,3,1,10.0,7.0
5477,1977-1978,34,Telstar,FC Volendam,1,0,1,3,0,1,1,5.0,10.0
5478,1978-1979,1,VVV-Venlo,FC Den Haag,1,0,1,3,0,1,1,9.0,1.0
5479,1978-1979,1,Go Ahead Eagles,HFC Haarlem,2,2,3,1,1,4,0,10.0,5.0
5480,1978-1979,1,NAC Breda,AFC Ajax,1,7,2,0,3,8,-6,4.0,13.0
5481,1978-1979,1,PSV,AZ '67 Alkmaar,3,1,1,3,0,4,2,9.0,7.0
5482,1978-1979,1,FC Twente,PEC Zwolle,1,1,3,1,1,2,0,2.0,
5483,1978-1979,1,FC Volendam,FC Utrecht,0,1,2,0,3,1,-1,9.0,12.0
5484,1978-1979,1,Feyenoord,NEC Nijmegen,0,0,3,1,1,0,0,5.0,2.0
5485,1978-1979,1,Roda JC Kerkrade,MVV Maastricht,3,0,1,3,0,3,3,12.0,4.0
5486,1978-1979,1,Vitesse,Sparta Rotterdam,2,2,3,1,1,4,0,11.0,5.0
5487,1978-1979,2,AFC Ajax,Go Ahead Eagles,3,2,1,3,0,5,1,13.0,7.0
5488,1978-1979,2,AZ '67 Alkmaar,VVV-Venlo,8,1,1,3,0,9,7,10.0,9.0
5489,1978-1979,2,FC Den Haag,Vitesse,2,0,1,3,0,2,2,4.0,8.0
5490,1978-1979,2,FC Utrecht,FC Twente,1,1,3,1,1,2,0,10.0,3.0
5491,1978-1979,2,HFC Haarlem,PSV,0,5,2,0,3,5,-5,5.0,9.0
5492,1978-1979,2,MVV Maastricht,FC Volendam,0,2,2,0,3,2,-2,4.0,9.0
5493,1978-1979,2,NEC Nijmegen,Roda JC Kerkrade,0,0,3,1,1,0,0,3.0,10.0
5494,1978-1979,2,PEC Zwolle,NAC Breda,1,1,3,1,1,2,0,,5.0
5495,1978-1979,2,Sparta Rotterdam,Feyenoord,1,0,1,3,0,1,1,5.0,5.0
5496,1978-1979,3,AZ '67 Alkmaar,Vitesse,0,2,2,0,3,2,-2,7.0,8.0
5497,1978-1979,3,FC Den Haag,Feyenoord,1,1,3,1,1,2,0,5.0,5.0
5498,1978-1979,3,Go Ahead Eagles,PSV,1,1,3,1,1,2,0,5.0,10.0
5499,1978-1979,3,MVV Maastricht,FC Twente,0,0,3,1,1,0,0,2.0,4.0
5500,1978-1979,3,NEC Nijmegen,FC Volendam,4,1,1,3,0,5,3,6.0,6.0
5501,1978-1979,3,Sparta Rotterdam,Roda JC Kerkrade,0,1,2,0,3,1,-1,4.0,13.0
5502,1978-1979,3,AFC Ajax,PEC Zwolle,4,2,1,3,0,6,2,15.0,
5503,1978-1979,3,FC Utrecht,NAC Breda,1,1,3,1,1,2,0,8.0,6.0
5504,1978-1979,3,HFC Haarlem,VVV-Venlo,2,0,1,3,0,2,2,5.0,6.0
5505,1978-1979,4,AFC Ajax,PSV,2,0,1,3,0,2,2,15.0,10.0
5506,1978-1979,4,AZ '67 Alkmaar,Feyenoord,2,2,3,1,1,4,0,7.0,6.0
5507,1978-1979,4,FC Den Haag,Roda JC Kerkrade,0,3,2,0,3,3,-3,4.0,13.0
5508,1978-1979,4,Go Ahead Eagles,VVV-Venlo,2,0,1,3,0,2,2,8.0,3.0
5509,1978-1979,4,MVV Maastricht,NAC Breda,1,1,3,1,1,2,0,3.0,6.0
5510,1978-1979,4,NEC Nijmegen,FC Twente,0,0,3,1,1,0,0,6.0,4.0
5511,1978-1979,4,Sparta Rotterdam,FC Volendam,3,0,1,3,0,3,3,7.0,3.0
5512,1978-1979,4,FC Utrecht,PEC Zwolle,1,1,3,1,1,2,0,6.0,
5513,1978-1979,4,HFC Haarlem,Vitesse,1,1,3,1,1,2,0,5.0,8.0
5514,1978-1979,5,NAC Breda,NEC Nijmegen,2,2,3,1,1,4,0,4.0,7.0
5515,1978-1979,5,PEC Zwolle,MVV Maastricht,0,2,2,0,3,2,-2,3.0,5.0
5516,1978-1979,5,FC Twente,Sparta Rotterdam,2,1,1,3,0,3,1,7.0,7.0
5517,1978-1979,5,FC Utrecht,AFC Ajax,1,4,2,0,3,5,-3,6.0,15.0
5518,1978-1979,5,FC Volendam,FC Den Haag,1,1,3,1,1,2,0,4.0,5.0
5519,1978-1979,5,VVV-Venlo,PSV,0,5,2,0,3,5,-5,3.0,10.0
5520,1978-1979,5,Feyenoord,HFC Haarlem,5,0,1,3,0,5,5,6.0,5.0
5521,1978-1979,5,Roda JC Kerkrade,AZ '67 Alkmaar,3,1,1,3,0,4,2,13.0,4.0
5522,1978-1979,5,Vitesse,Go Ahead Eagles,0,0,3,1,1,0,0,6.0,6.0
5523,1978-1979,6,AFC Ajax,VVV-Venlo,4,0,1,3,0,4,4,15.0,0.0
5524,1978-1979,6,AZ '67 Alkmaar,FC Volendam,4,1,1,3,0,5,3,7.0,4.0
5525,1978-1979,6,Go Ahead Eagles,Feyenoord,2,1,1,3,0,3,1,8.0,5.0
5526,1978-1979,6,MVV Maastricht,FC Utrecht,1,0,1,3,0,1,1,8.0,3.0
5527,1978-1979,6,NEC Nijmegen,PEC Zwolle,0,0,3,1,1,0,0,7.0,3.0
5528,1978-1979,6,PSV,Vitesse,5,0,1,3,0,5,5,10.0,5.0
5529,1978-1979,6,Sparta Rotterdam,NAC Breda,3,2,1,3,0,5,1,9.0,4.0
5530,1978-1979,6,FC Den Haag,FC Twente,0,0,3,1,1,0,0,6.0,7.0
5531,1978-1979,6,HFC Haarlem,Roda JC Kerkrade,1,1,3,1,1,2,0,5.0,11.0
5532,1978-1979,7,MVV Maastricht,AFC Ajax,1,0,1,3,0,1,1,11.0,12.0
5533,1978-1979,7,NAC Breda,FC Den Haag,3,1,1,3,0,4,2,6.0,3.0
5534,1978-1979,7,PEC Zwolle,Sparta Rotterdam,0,0,3,1,1,0,0,3.0,7.0
5535,1978-1979,7,FC Twente,AZ '67 Alkmaar,4,2,1,3,0,6,2,9.0,4.0
5536,1978-1979,7,FC Volendam,HFC Haarlem,4,0,1,3,0,4,4,4.0,5.0
5537,1978-1979,7,Feyenoord,PSV,1,0,1,3,0,1,1,8.0,7.0
5538,1978-1979,7,Roda JC Kerkrade,Go Ahead Eagles,1,1,3,1,1,2,0,11.0,9.0
5539,1978-1979,7,Vitesse,VVV-Venlo,1,1,3,1,1,2,0,6.0,1.0
5540,1978-1979,7,FC Utrecht,NEC Nijmegen,2,4,2,0,3,6,-2,2.0,9.0
5541,1978-1979,8,AZ '67 Alkmaar,NAC Breda,5,1,1,3,0,6,4,7.0,5.0
5542,1978-1979,8,FC Den Haag,PEC Zwolle,0,0,3,1,1,0,0,3.0,4.0
5543,1978-1979,8,Go Ahead Eagles,FC Volendam,2,1,1,3,0,3,1,11.0,4.0
5544,1978-1979,8,NEC Nijmegen,MVV Maastricht,1,1,3,1,1,2,0,7.0,11.0
5545,1978-1979,8,PSV,Roda JC Kerkrade,2,1,1,3,0,3,1,9.0,8.0
5546,1978-1979,8,Sparta Rotterdam,FC Utrecht,2,0,1,3,0,2,2,10.0,1.0
5547,1978-1979,8,AFC Ajax,Vitesse,4,0,1,3,0,4,4,12.0,3.0
5548,1978-1979,8,VVV-Venlo,Feyenoord,0,0,3,1,1,0,0,2.0,8.0
5549,1978-1979,8,HFC Haarlem,FC Twente,2,2,3,1,1,4,0,3.0,9.0
5550,1978-1979,9,FC Twente,Go Ahead Eagles,1,2,2,0,3,3,-1,8.0,11.0
5551,1978-1979,9,FC Utrecht,FC Den Haag,5,3,1,3,0,8,2,3.0,3.0
5552,1978-1979,9,MVV Maastricht,Sparta Rotterdam,3,1,1,3,0,4,2,13.0,7.0
5553,1978-1979,9,NAC Breda,HFC Haarlem,1,1,3,1,1,2,0,5.0,3.0
5554,1978-1979,9,PEC Zwolle,AZ '67 Alkmaar,0,0,3,1,1,0,0,4.0,7.0
5555,1978-1979,9,FC Volendam,PSV,1,2,2,0,3,3,-1,4.0,12.0
5556,1978-1979,9,Feyenoord,Vitesse,3,0,1,3,0,3,3,10.0,2.0
5557,1978-1979,9,NEC Nijmegen,AFC Ajax,0,2,2,0,3,2,-2,6.0,12.0
5558,1978-1979,9,Roda JC Kerkrade,VVV-Venlo,2,1,1,3,0,3,1,8.0,2.0
5559,1978-1979,10,AFC Ajax,Feyenoord,0,0,3,1,1,0,0,10.0,8.0
5560,1978-1979,10,AZ '67 Alkmaar,FC Utrecht,3,0,1,3,0,3,3,10.0,3.0
5561,1978-1979,10,FC Den Haag,MVV Maastricht,1,1,3,1,1,2,0,3.0,11.0
5562,1978-1979,10,Go Ahead Eagles,NAC Breda,1,0,1,3,0,1,1,13.0,4.0
5563,1978-1979,10,PSV,FC Twente,1,0,1,3,0,1,1,12.0,5.0
5564,1978-1979,10,VVV-Venlo,FC Volendam,1,1,3,1,1,2,0,3.0,4.0
5565,1978-1979,10,HFC Haarlem,PEC Zwolle,2,1,1,3,0,3,1,6.0,4.0
5566,1978-1979,10,Sparta Rotterdam,NEC Nijmegen,1,0,1,3,0,1,1,10.0,5.0
5567,1978-1979,10,Vitesse,Roda JC Kerkrade,2,5,2,0,3,7,-3,1.0,8.0
5568,1978-1979,11,FC Utrecht,HFC Haarlem,4,0,1,3,0,4,4,6.0,5.0
5569,1978-1979,11,MVV Maastricht,AZ '67 Alkmaar,1,3,2,0,3,4,-2,8.0,10.0
5570,1978-1979,11,NAC Breda,PSV,0,2,2,0,3,2,-2,4.0,12.0
5571,1978-1979,11,PEC Zwolle,Go Ahead Eagles,1,1,3,1,1,2,0,4.0,11.0
5572,1978-1979,11,FC Twente,VVV-Venlo,2,0,1,3,0,2,2,7.0,3.0
5573,1978-1979,11,FC Volendam,Vitesse,2,2,3,1,1,4,0,5.0,2.0
5574,1978-1979,11,NEC Nijmegen,FC Den Haag,0,2,2,0,3,2,-2,4.0,5.0
5575,1978-1979,11,Roda JC Kerkrade,Feyenoord,1,1,3,1,1,2,0,8.0,9.0
5576,1978-1979,11,Sparta Rotterdam,AFC Ajax,1,0,1,3,0,1,1,10.0,7.0
5577,1978-1979,12,AZ '67 Alkmaar,NEC Nijmegen,8,1,1,3,0,9,7,13.0,1.0
5578,1978-1979,12,Go Ahead Eagles,FC Utrecht,2,3,2,0,3,5,-1,10.0,9.0
5579,1978-1979,12,PSV,PEC Zwolle,0,1,2,0,3,1,-1,12.0,6.0
5580,1978-1979,12,AFC Ajax,Roda JC Kerkrade,1,2,2,0,3,3,-1,7.0,10.0
5581,1978-1979,12,FC Den Haag,Sparta Rotterdam,0,2,2,0,3,2,-2,5.0,12.0
5582,1978-1979,12,VVV-Venlo,NAC Breda,0,1,2,0,3,1,-1,2.0,4.0
5583,1978-1979,12,Feyenoord,FC Volendam,2,0,1,3,0,2,2,9.0,2.0
5584,1978-1979,12,HFC Haarlem,MVV Maastricht,0,1,2,0,3,1,-1,5.0,8.0
5585,1978-1979,12,Vitesse,FC Twente,3,2,1,3,0,5,1,4.0,4.0
5586,1978-1979,13,MVV Maastricht,Go Ahead Eagles,2,1,1,3,0,3,1,10.0,7.0
5587,1978-1979,13,NAC Breda,Vitesse,0,0,3,1,1,0,0,5.0,5.0
5588,1978-1979,13,PEC Zwolle,VVV-Venlo,3,2,1,3,0,5,1,8.0,1.0
5589,1978-1979,13,FC Den Haag,AFC Ajax,0,0,3,1,1,0,0,5.0,5.0
5590,1978-1979,13,FC Twente,Feyenoord,0,0,3,1,1,0,0,4.0,9.0
5591,1978-1979,13,FC Utrecht,PSV,2,2,3,1,1,4,0,10.0,10.0
5592,1978-1979,13,FC Volendam,Roda JC Kerkrade,1,2,2,0,3,3,-1,2.0,13.0
5593,1978-1979,13,NEC Nijmegen,HFC Haarlem,0,1,2,0,3,1,-1,0.0,7.0
5594,1978-1979,13,Sparta Rotterdam,AZ '67 Alkmaar,2,3,2,0,3,5,-1,9.0,13.0
5595,1978-1979,14,AFC Ajax,FC Volendam,7,3,1,3,0,10,4,5.0,2.0
5596,1978-1979,14,AZ '67 Alkmaar,FC Den Haag,7,1,1,3,0,8,6,15.0,5.0
5597,1978-1979,14,Go Ahead Eagles,NEC Nijmegen,2,0,1,3,0,2,2,7.0,0.0
5598,1978-1979,14,PSV,MVV Maastricht,0,0,3,1,1,0,0,8.0,8.0
5599,1978-1979,14,VVV-Venlo,FC Utrecht,1,2,2,0,3,3,-1,1.0,10.0
5600,1978-1979,14,Feyenoord,NAC Breda,2,1,1,3,0,3,1,9.0,4.0
5601,1978-1979,14,HFC Haarlem,Sparta Rotterdam,0,0,3,1,1,0,0,7.0,10.0
5602,1978-1979,14,Roda JC Kerkrade,FC Twente,0,0,3,1,1,0,0,11.0,5.0
5603,1978-1979,14,Vitesse,PEC Zwolle,3,1,1,3,0,4,2,8.0,7.0
5604,1978-1979,15,MVV Maastricht,VVV-Venlo,1,1,3,1,1,2,0,8.0,1.0
5605,1978-1979,15,NAC Breda,Roda JC Kerkrade,0,0,3,1,1,0,0,5.0,9.0
5606,1978-1979,15,AZ '67 Alkmaar,AFC Ajax,1,2,2,0,3,3,-1,12.0,7.0
5607,1978-1979,15,FC Den Haag,HFC Haarlem,3,1,1,3,0,4,2,7.0,4.0
5608,1978-1979,15,FC Twente,FC Volendam,3,0,1,3,0,3,3,8.0,1.0
5609,1978-1979,15,FC Utrecht,Vitesse,2,0,1,3,0,2,2,13.0,8.0
5610,1978-1979,15,Sparta Rotterdam,Go Ahead Eagles,2,0,1,3,0,2,2,10.0,4.0
5611,1978-1979,15,PEC Zwolle,Feyenoord,0,2,2,0,3,2,-2,7.0,11.0
5612,1978-1979,15,NEC Nijmegen,PSV,0,0,3,1,1,0,0,1.0,6.0
5613,1978-1979,16,AFC Ajax,HFC Haarlem,4,1,1,3,0,5,3,10.0,4.0
5614,1978-1979,16,AZ '67 Alkmaar,Go Ahead Eagles,1,0,1,3,0,1,1,12.0,3.0
5615,1978-1979,16,FC Den Haag,PSV,0,0,3,1,1,0,0,5.0,4.0
5616,1978-1979,16,FC Utrecht,Roda JC Kerkrade,1,0,1,3,0,1,1,13.0,8.0
5617,1978-1979,16,MVV Maastricht,Feyenoord,0,2,2,0,3,2,-2,8.0,13.0
5618,1978-1979,16,NAC Breda,FC Twente,3,1,1,3,0,4,2,8.0,5.0
5619,1978-1979,16,NEC Nijmegen,Vitesse,4,1,1,3,0,5,3,4.0,7.0
5620,1978-1979,16,PEC Zwolle,FC Volendam,2,1,1,3,0,3,1,9.0,0.0
5621,1978-1979,16,Sparta Rotterdam,VVV-Venlo,3,0,1,3,0,3,3,10.0,1.0
5622,1978-1979,17,Go Ahead Eagles,FC Den Haag,1,1,3,1,1,2,0,4.0,6.0
5623,1978-1979,17,PSV,Sparta Rotterdam,2,1,1,3,0,3,1,7.0,7.0
5624,1978-1979,17,FC Twente,AFC Ajax,2,3,2,0,3,5,-1,5.0,13.0
5625,1978-1979,17,FC Volendam,NAC Breda,3,0,1,3,0,3,3,3.0,5.0
5626,1978-1979,17,VVV-Venlo,NEC Nijmegen,1,1,3,1,1,2,0,2.0,5.0
5627,1978-1979,17,Feyenoord,FC Utrecht,1,0,1,3,0,1,1,13.0,10.0
5628,1978-1979,17,HFC Haarlem,AZ '67 Alkmaar,3,2,1,3,0,5,1,7.0,9.0
5629,1978-1979,17,Roda JC Kerkrade,PEC Zwolle,2,0,1,3,0,2,2,8.0,6.0
5630,1978-1979,17,Vitesse,MVV Maastricht,3,0,1,3,0,3,3,7.0,5.0
5631,1978-1979,18,AZ '67 Alkmaar,PSV,1,0,1,3,0,1,1,9.0,6.0
5632,1978-1979,18,MVV Maastricht,Roda JC Kerkrade,0,3,2,0,3,3,-3,2.0,8.0
5633,1978-1979,18,PEC Zwolle,FC Twente,3,3,3,1,1,6,0,4.0,5.0
5634,1978-1979,18,AFC Ajax,NAC Breda,0,0,3,1,1,0,0,13.0,5.0
5635,1978-1979,18,FC Den Haag,VVV-Venlo,3,1,1,3,0,4,2,8.0,2.0
5636,1978-1979,18,FC Utrecht,FC Volendam,2,1,1,3,0,3,1,12.0,3.0
5637,1978-1979,18,HFC Haarlem,Go Ahead Eagles,0,0,3,1,1,0,0,5.0,5.0
5638,1978-1979,18,Sparta Rotterdam,Vitesse,3,1,1,3,0,4,2,10.0,6.0
5639,1978-1979,18,NEC Nijmegen,Feyenoord,2,2,3,1,1,4,0,6.0,13.0
5640,1978-1979,19,NAC Breda,PEC Zwolle,1,1,3,1,1,2,0,6.0,5.0
5641,1978-1979,19,FC Twente,FC Utrecht,2,2,3,1,1,4,0,5.0,10.0
5642,1978-1979,19,Feyenoord,Sparta Rotterdam,4,1,1,3,0,5,3,13.0,9.0
5643,1978-1979,19,Roda JC Kerkrade,NEC Nijmegen,3,1,1,3,0,4,2,10.0,6.0
5644,1978-1979,19,FC Volendam,MVV Maastricht,1,1,3,1,1,2,0,4.0,2.0
5645,1978-1979,19,Vitesse,FC Den Haag,1,1,3,1,1,2,0,4.0,9.0
5646,1978-1979,19,Go Ahead Eagles,AFC Ajax,1,2,2,0,3,3,-1,2.0,13.0
5647,1978-1979,19,VVV-Venlo,AZ '67 Alkmaar,1,1,3,1,1,2,0,3.0,7.0
5648,1978-1979,19,PSV,HFC Haarlem,4,1,1,3,0,5,3,8.0,4.0
5649,1978-1979,20,FC Twente,MVV Maastricht,3,0,1,3,0,3,3,5.0,1.0
5650,1978-1979,20,FC Volendam,NEC Nijmegen,0,0,3,1,1,0,0,5.0,6.0
5651,1978-1979,20,VVV-Venlo,HFC Haarlem,1,0,1,3,0,1,1,5.0,4.0
5652,1978-1979,20,Feyenoord,FC Den Haag,2,0,1,3,0,2,2,13.0,6.0
5653,1978-1979,20,NAC Breda,FC Utrecht,3,2,1,3,0,5,1,8.0,7.0
5654,1978-1979,20,PEC Zwolle,AFC Ajax,0,3,2,0,3,3,-3,5.0,13.0
5655,1978-1979,20,PSV,Go Ahead Eagles,1,0,1,3,0,1,1,10.0,2.0
5656,1978-1979,20,Roda JC Kerkrade,Sparta Rotterdam,4,0,1,3,0,4,4,12.0,6.0
5657,1978-1979,20,Vitesse,AZ '67 Alkmaar,3,4,2,0,3,7,-1,4.0,10.0
5658,1978-1979,21,PEC Zwolle,FC Utrecht,1,0,1,3,0,1,1,5.0,4.0
5659,1978-1979,21,PSV,AFC Ajax,3,1,1,3,0,4,2,12.0,10.0
5660,1978-1979,21,FC Twente,NEC Nijmegen,2,1,1,3,0,3,1,8.0,3.0
5661,1978-1979,21,FC Volendam,Sparta Rotterdam,1,3,2,0,3,4,-2,5.0,6.0
5662,1978-1979,21,VVV-Venlo,Go Ahead Eagles,1,4,2,0,3,5,-3,5.0,5.0
5663,1978-1979,21,Feyenoord,AZ '67 Alkmaar,1,1,3,1,1,2,0,11.0,8.0
5664,1978-1979,21,NAC Breda,MVV Maastricht,0,0,3,1,1,0,0,6.0,2.0
5665,1978-1979,21,Roda JC Kerkrade,FC Den Haag,1,0,1,3,0,1,1,15.0,5.0
5666,1978-1979,21,Vitesse,HFC Haarlem,2,2,3,1,1,4,0,5.0,5.0
5667,1978-1979,22,AZ '67 Alkmaar,Roda JC Kerkrade,3,1,1,3,0,4,2,11.0,12.0
5668,1978-1979,22,Go Ahead Eagles,Vitesse,4,0,1,3,0,4,4,7.0,2.0
5669,1978-1979,22,MVV Maastricht,PEC Zwolle,1,1,3,1,1,2,0,3.0,6.0
5670,1978-1979,22,PSV,VVV-Venlo,2,0,1,3,0,2,2,12.0,4.0
5671,1978-1979,22,AFC Ajax,FC Utrecht,6,1,1,3,0,7,5,10.0,4.0
5672,1978-1979,22,FC Den Haag,FC Volendam,2,1,1,3,0,3,1,7.0,2.0
5673,1978-1979,22,HFC Haarlem,Feyenoord,1,1,3,1,1,2,0,3.0,9.0
5674,1978-1979,22,NEC Nijmegen,NAC Breda,0,0,3,1,1,0,0,3.0,7.0
5675,1978-1979,22,Sparta Rotterdam,FC Twente,1,0,1,3,0,1,1,9.0,8.0
5676,1978-1979,23,NAC Breda,Sparta Rotterdam,3,2,1,3,0,5,1,9.0,6.0
5677,1978-1979,23,PEC Zwolle,NEC Nijmegen,2,0,1,3,0,2,2,8.0,2.0
5678,1978-1979,23,FC Twente,FC Den Haag,5,2,1,3,0,7,3,10.0,4.0
5679,1978-1979,23,FC Utrecht,MVV Maastricht,0,0,3,1,1,0,0,2.0,4.0
5680,1978-1979,23,FC Volendam,AZ '67 Alkmaar,0,0,3,1,1,0,0,3.0,9.0
5681,1978-1979,23,VVV-Venlo,AFC Ajax,1,3,2,0,3,4,-2,4.0,12.0
5682,1978-1979,23,Feyenoord,Go Ahead Eagles,5,0,1,3,0,5,5,11.0,6.0
5683,1978-1979,23,Roda JC Kerkrade,HFC Haarlem,2,1,1,3,0,3,1,12.0,2.0
5684,1978-1979,23,Vitesse,PSV,2,2,3,1,1,4,0,3.0,13.0
5685,1978-1979,24,AFC Ajax,MVV Maastricht,6,0,1,3,0,6,6,12.0,3.0
5686,1978-1979,24,AZ '67 Alkmaar,FC Twente,3,0,1,3,0,3,3,11.0,9.0
5687,1978-1979,24,Go Ahead Eagles,Roda JC Kerkrade,3,0,1,3,0,3,3,9.0,9.0
5688,1978-1979,24,NEC Nijmegen,FC Utrecht,0,0,3,1,1,0,0,3.0,2.0
5689,1978-1979,24,PSV,Feyenoord,1,2,2,0,3,3,-1,10.0,11.0
5690,1978-1979,24,FC Den Haag,NAC Breda,1,1,3,1,1,2,0,4.0,9.0
5691,1978-1979,24,VVV-Venlo,Vitesse,1,2,2,0,3,3,-1,3.0,5.0
5692,1978-1979,24,HFC Haarlem,FC Volendam,0,1,2,0,3,1,-1,2.0,5.0
5693,1978-1979,24,Sparta Rotterdam,PEC Zwolle,2,2,3,1,1,4,0,7.0,8.0
5694,1978-1979,25,MVV Maastricht,NEC Nijmegen,2,0,1,3,0,2,2,6.0,2.0
5695,1978-1979,25,NAC Breda,AZ '67 Alkmaar,2,3,2,0,3,5,-1,6.0,11.0
5696,1978-1979,25,PEC Zwolle,FC Den Haag,0,0,3,1,1,0,0,9.0,5.0
5697,1978-1979,25,FC Twente,HFC Haarlem,7,2,1,3,0,9,5,9.0,2.0
5698,1978-1979,25,FC Utrecht,Sparta Rotterdam,2,3,2,0,3,5,-1,2.0,10.0
5699,1978-1979,25,FC Volendam,Go Ahead Eagles,2,1,1,3,0,3,1,7.0,9.0
5700,1978-1979,25,Feyenoord,VVV-Venlo,5,0,1,3,0,5,5,11.0,0.0
5701,1978-1979,25,Roda JC Kerkrade,PSV,1,3,2,0,3,4,-2,6.0,10.0
5702,1978-1979,25,Vitesse,AFC Ajax,0,0,3,1,1,0,0,6.0,10.0
5703,1978-1979,26,AFC Ajax,NEC Nijmegen,3,2,1,3,0,5,1,13.0,2.0
5704,1978-1979,26,AZ '67 Alkmaar,PEC Zwolle,4,1,1,3,0,5,3,13.0,6.0
5705,1978-1979,26,Go Ahead Eagles,FC Twente,1,0,1,3,0,1,1,9.0,6.0
5706,1978-1979,26,PSV,FC Volendam,3,1,1,3,0,4,2,10.0,7.0
5707,1978-1979,26,FC Den Haag,FC Utrecht,3,1,1,3,0,4,2,8.0,2.0
5708,1978-1979,26,VVV-Venlo,Roda JC Kerkrade,1,0,1,3,0,1,1,3.0,3.0
5709,1978-1979,26,HFC Haarlem,NAC Breda,0,0,3,1,1,0,0,2.0,6.0
5710,1978-1979,26,Sparta Rotterdam,MVV Maastricht,2,1,1,3,0,3,1,10.0,5.0
5711,1978-1979,26,Vitesse,Feyenoord,1,1,3,1,1,2,0,6.0,11.0
5712,1978-1979,27,MVV Maastricht,FC Den Haag,1,3,2,0,3,4,-2,4.0,8.0
5713,1978-1979,27,NAC Breda,Go Ahead Eagles,3,1,1,3,0,4,2,8.0,6.0
5714,1978-1979,27,PEC Zwolle,HFC Haarlem,2,0,1,3,0,2,2,8.0,1.0
5715,1978-1979,27,FC Twente,PSV,2,2,3,1,1,4,0,7.0,8.0
5716,1978-1979,27,FC Utrecht,AZ '67 Alkmaar,1,2,2,0,3,3,-1,2.0,13.0
5717,1978-1979,27,FC Volendam,VVV-Venlo,4,0,1,3,0,4,4,10.0,3.0
5718,1978-1979,27,Feyenoord,AFC Ajax,1,1,3,1,1,2,0,11.0,11.0
5719,1978-1979,27,NEC Nijmegen,Sparta Rotterdam,1,0,1,3,0,1,1,4.0,7.0
5720,1978-1979,27,Roda JC Kerkrade,Vitesse,3,0,1,3,0,3,3,6.0,6.0
5721,1978-1979,28,AFC Ajax,Sparta Rotterdam,1,0,1,3,0,1,1,11.0,7.0
5722,1978-1979,28,AZ '67 Alkmaar,MVV Maastricht,0,0,3,1,1,0,0,13.0,4.0
5723,1978-1979,28,Go Ahead Eagles,PEC Zwolle,2,2,3,1,1,4,0,7.0,6.0
5724,1978-1979,28,PSV,NAC Breda,2,0,1,3,0,2,2,10.0,5.0
5725,1978-1979,28,FC Den Haag,NEC Nijmegen,3,2,1,3,0,5,1,11.0,4.0
5726,1978-1979,28,VVV-Venlo,FC Twente,1,4,2,0,3,5,-3,3.0,7.0
5727,1978-1979,28,Feyenoord,Roda JC Kerkrade,2,1,1,3,0,3,1,11.0,3.0
5728,1978-1979,28,HFC Haarlem,FC Utrecht,0,0,3,1,1,0,0,2.0,2.0
5729,1978-1979,28,Vitesse,FC Volendam,0,0,3,1,1,0,0,6.0,10.0
5730,1978-1979,29,MVV Maastricht,HFC Haarlem,1,1,3,1,1,2,0,5.0,3.0
5731,1978-1979,29,NAC Breda,VVV-Venlo,2,0,1,3,0,2,2,7.0,3.0
5732,1978-1979,29,PEC Zwolle,PSV,0,0,3,1,1,0,0,6.0,11.0
5733,1978-1979,29,Roda JC Kerkrade,AFC Ajax,1,3,2,0,3,4,-2,3.0,11.0
5734,1978-1979,29,FC Twente,Vitesse,2,3,2,0,3,5,-1,7.0,6.0
5735,1978-1979,29,FC Utrecht,Go Ahead Eagles,2,1,1,3,0,3,1,4.0,4.0
5736,1978-1979,29,FC Volendam,Feyenoord,0,2,2,0,3,2,-2,7.0,11.0
5737,1978-1979,29,NEC Nijmegen,AZ '67 Alkmaar,1,0,1,3,0,1,1,6.0,10.0
5738,1978-1979,29,Sparta Rotterdam,FC Den Haag,1,2,2,0,3,3,-1,6.0,13.0
5739,1978-1979,30,AFC Ajax,FC Den Haag,4,1,1,3,0,5,3,13.0,12.0
5740,1978-1979,30,AZ '67 Alkmaar,Sparta Rotterdam,2,0,1,3,0,2,2,10.0,3.0
5741,1978-1979,30,Feyenoord,FC Twente,2,0,1,3,0,2,2,11.0,4.0
5742,1978-1979,30,Go Ahead Eagles,MVV Maastricht,0,1,2,0,3,1,-1,4.0,5.0
5743,1978-1979,30,PSV,FC Utrecht,3,0,1,3,0,3,3,11.0,4.0
5744,1978-1979,30,Roda JC Kerkrade,FC Volendam,5,1,1,3,0,6,4,6.0,4.0
5745,1978-1979,30,VVV-Venlo,PEC Zwolle,2,3,2,0,3,5,-1,3.0,8.0
5746,1978-1979,30,HFC Haarlem,NEC Nijmegen,2,2,3,1,1,4,0,4.0,7.0
5747,1978-1979,30,Vitesse,NAC Breda,3,1,1,3,0,4,2,8.0,7.0
5748,1978-1979,31,FC Den Haag,AZ '67 Alkmaar,3,2,1,3,0,5,1,12.0,7.0
5749,1978-1979,31,FC Twente,Roda JC Kerkrade,1,2,2,0,3,3,-1,4.0,9.0
5750,1978-1979,31,FC Utrecht,VVV-Venlo,2,0,1,3,0,2,2,7.0,0.0
5751,1978-1979,31,FC Volendam,AFC Ajax,1,3,2,0,3,4,-2,4.0,13.0
5752,1978-1979,31,MVV Maastricht,PSV,0,2,2,0,3,2,-2,5.0,11.0
5753,1978-1979,31,NAC Breda,Feyenoord,0,0,3,1,1,0,0,7.0,11.0
5754,1978-1979,31,NEC Nijmegen,Go Ahead Eagles,1,1,3,1,1,2,0,8.0,2.0
5755,1978-1979,31,PEC Zwolle,Vitesse,2,2,3,1,1,4,0,9.0,8.0
5756,1978-1979,31,Sparta Rotterdam,HFC Haarlem,0,1,2,0,3,1,-1,0.0,6.0
5757,1978-1979,32,AFC Ajax,AZ '67 Alkmaar,1,1,3,1,1,2,0,13.0,5.0
5758,1978-1979,32,FC Volendam,FC Twente,5,0,1,3,0,5,5,4.0,3.0
5759,1978-1979,32,VVV-Venlo,MVV Maastricht,0,2,2,0,3,2,-2,0.0,8.0
5760,1978-1979,32,Feyenoord,PEC Zwolle,3,1,1,3,0,4,2,13.0,6.0
5761,1978-1979,32,Go Ahead Eagles,Sparta Rotterdam,5,3,1,3,0,8,2,5.0,0.0
5762,1978-1979,32,HFC Haarlem,FC Den Haag,3,1,1,3,0,4,2,9.0,9.0
5763,1978-1979,32,PSV,NEC Nijmegen,4,0,1,3,0,4,4,13.0,5.0
5764,1978-1979,32,Roda JC Kerkrade,NAC Breda,3,1,1,3,0,4,2,9.0,4.0
5765,1978-1979,32,Vitesse,FC Utrecht,1,1,3,1,1,2,0,9.0,8.0
5766,1978-1979,33,FC Twente,NAC Breda,1,1,3,1,1,2,0,1.0,5.0
5767,1978-1979,33,FC Volendam,PEC Zwolle,0,0,3,1,1,0,0,4.0,6.0
5768,1978-1979,33,VVV-Venlo,Sparta Rotterdam,2,0,1,3,0,2,2,3.0,0.0
5769,1978-1979,33,Feyenoord,MVV Maastricht,3,0,1,3,0,3,3,13.0,7.0
5770,1978-1979,33,Go Ahead Eagles,AZ '67 Alkmaar,1,3,2,0,3,4,-2,4.0,7.0
5771,1978-1979,33,HFC Haarlem,AFC Ajax,0,1,2,0,3,1,-1,8.0,13.0
5772,1978-1979,33,PSV,FC Den Haag,2,0,1,3,0,2,2,13.0,6.0
5773,1978-1979,33,Roda JC Kerkrade,FC Utrecht,0,0,3,1,1,0,0,10.0,8.0
5774,1978-1979,33,Vitesse,NEC Nijmegen,0,1,2,0,3,1,-1,8.0,8.0
5775,1978-1979,34,AFC Ajax,FC Twente,8,1,1,3,0,9,7,13.0,1.0
5776,1978-1979,34,AZ '67 Alkmaar,HFC Haarlem,3,0,1,3,0,3,3,10.0,7.0
5777,1978-1979,34,MVV Maastricht,Vitesse,1,1,3,1,1,2,0,7.0,6.0
5778,1978-1979,34,NEC Nijmegen,VVV-Venlo,4,1,1,3,0,5,3,8.0,3.0
5779,1978-1979,34,PEC Zwolle,Roda JC Kerkrade,1,1,3,1,1,2,0,6.0,11.0
5780,1978-1979,34,Sparta Rotterdam,PSV,1,1,3,1,1,2,0,1.0,13.0
5781,1978-1979,34,FC Den Haag,Go Ahead Eagles,2,1,1,3,0,3,1,6.0,4.0
5782,1978-1979,34,FC Utrecht,Feyenoord,1,3,2,0,3,4,-2,5.0,13.0
5783,1978-1979,34,NAC Breda,FC Volendam,5,1,1,3,0,6,4,5.0,4.0
5784,1979-1980,1,AZ '67 Alkmaar,PSV,2,1,1,3,0,3,1,10.0,10.0
5785,1979-1980,1,Go Ahead Eagles,Sparta Rotterdam,1,0,1,3,0,1,1,7.0,1.0
5786,1979-1980,1,NAC Breda,SBV Excelsior,1,1,3,1,1,2,0,6.0,5.0
5787,1979-1980,1,FC Utrecht,NEC Nijmegen,3,1,1,3,0,4,2,8.0,7.0
5788,1979-1980,1,Feyenoord,PEC Zwolle,2,0,1,3,0,2,2,13.0,3.0
5789,1979-1980,1,HFC Haarlem,MVV Maastricht,2,2,3,1,1,4,0,7.0,5.0
5790,1979-1980,1,Roda JC Kerkrade,FC Twente,3,0,1,3,0,3,3,11.0,1.0
5791,1979-1980,1,Vitesse,FC Den Haag,1,0,1,3,0,1,1,6.0,6.0
5792,1979-1980,1,Willem II,AFC Ajax,1,3,2,0,3,4,-2,0.0,13.0
5793,1979-1980,2,AFC Ajax,NAC Breda,2,1,1,3,0,3,1,13.0,5.0
5794,1979-1980,2,SBV Excelsior,Go Ahead Eagles,2,1,1,3,0,3,1,8.0,6.0
5795,1979-1980,2,FC Den Haag,HFC Haarlem,2,1,1,3,0,3,1,6.0,4.0
5796,1979-1980,2,FC Twente,Willem II,0,0,3,1,1,0,0,2.0,1.0
5797,1979-1980,2,MVV Maastricht,AZ '67 Alkmaar,1,2,2,0,3,3,-1,5.0,13.0
5798,1979-1980,2,NEC Nijmegen,Feyenoord,0,2,2,0,3,2,-2,6.0,15.0
5799,1979-1980,2,PEC Zwolle,Roda JC Kerkrade,0,0,3,1,1,0,0,3.0,9.0
5800,1979-1980,2,PSV,FC Utrecht,3,0,1,3,0,3,3,10.0,5.0
5801,1979-1980,2,Sparta Rotterdam,Vitesse,1,2,2,0,3,3,-1,1.0,8.0
5802,1979-1980,3,SBV Excelsior,Vitesse,2,0,1,3,0,2,2,10.0,7.0
5803,1979-1980,3,FC Den Haag,AZ '67 Alkmaar,1,0,1,3,0,1,1,9.0,12.0
5804,1979-1980,3,MVV Maastricht,FC Utrecht,0,0,3,1,1,0,0,3.0,5.0
5805,1979-1980,3,NAC Breda,Willem II,0,1,2,0,3,1,-1,5.0,4.0
5806,1979-1980,3,NEC Nijmegen,Roda JC Kerkrade,2,0,1,3,0,2,2,9.0,6.0
5807,1979-1980,3,PEC Zwolle,FC Twente,0,1,2,0,3,1,-1,3.0,5.0
5808,1979-1980,3,PSV,Feyenoord,2,2,3,1,1,4,0,8.0,13.0
5809,1979-1980,3,Sparta Rotterdam,HFC Haarlem,3,0,1,3,0,3,3,4.0,1.0
5810,1979-1980,3,AFC Ajax,Go Ahead Eagles,2,1,1,3,0,3,1,15.0,3.0
5811,1979-1980,4,AZ '67 Alkmaar,Sparta Rotterdam,2,1,1,3,0,3,1,12.0,4.0
5812,1979-1980,4,FC Twente,NEC Nijmegen,2,1,1,3,0,3,1,7.0,6.0
5813,1979-1980,4,FC Utrecht,FC Den Haag,0,0,3,1,1,0,0,5.0,10.0
5814,1979-1980,4,Feyenoord,MVV Maastricht,1,1,3,1,1,2,0,11.0,4.0
5815,1979-1980,4,Go Ahead Eagles,NAC Breda,4,0,1,3,0,4,4,6.0,4.0
5816,1979-1980,4,HFC Haarlem,SBV Excelsior,1,5,2,0,3,6,-4,1.0,10.0
5817,1979-1980,4,Roda JC Kerkrade,PSV,1,3,2,0,3,4,-2,5.0,8.0
5818,1979-1980,4,Vitesse,AFC Ajax,1,1,3,1,1,2,0,8.0,13.0
5819,1979-1980,4,Willem II,PEC Zwolle,1,1,3,1,1,2,0,5.0,3.0
5820,1979-1980,5,FC Den Haag,Feyenoord,2,2,3,1,1,4,0,8.0,9.0
5821,1979-1980,5,Go Ahead Eagles,Willem II,3,0,1,3,0,3,3,9.0,5.0
5822,1979-1980,5,MVV Maastricht,Roda JC Kerkrade,4,1,1,3,0,5,3,6.0,4.0
5823,1979-1980,5,NAC Breda,Vitesse,2,2,3,1,1,4,0,2.0,8.0
5824,1979-1980,5,NEC Nijmegen,PEC Zwolle,4,1,1,3,0,5,3,6.0,2.0
5825,1979-1980,5,PSV,FC Twente,7,1,1,3,0,8,6,10.0,7.0
5826,1979-1980,5,Sparta Rotterdam,FC Utrecht,1,1,3,1,1,2,0,4.0,6.0
5827,1979-1980,5,AFC Ajax,HFC Haarlem,1,1,3,1,1,2,0,11.0,2.0
5828,1979-1980,5,SBV Excelsior,AZ '67 Alkmaar,1,5,2,0,3,6,-4,10.0,12.0
5829,1979-1980,6,AZ '67 Alkmaar,AFC Ajax,2,3,2,0,3,5,-1,9.0,11.0
5830,1979-1980,6,FC Twente,MVV Maastricht,3,1,1,3,0,4,2,10.0,5.0
5831,1979-1980,6,Feyenoord,Sparta Rotterdam,3,1,1,3,0,4,2,9.0,4.0
5832,1979-1980,6,PEC Zwolle,PSV,1,2,2,0,3,3,-1,2.0,13.0
5833,1979-1980,6,FC Utrecht,SBV Excelsior,3,0,1,3,0,3,3,6.0,9.0
5834,1979-1980,6,HFC Haarlem,NAC Breda,1,0,1,3,0,1,1,4.0,1.0
5835,1979-1980,6,Roda JC Kerkrade,FC Den Haag,5,1,1,3,0,6,4,4.0,8.0
5836,1979-1980,6,Vitesse,Go Ahead Eagles,3,5,2,0,3,8,-2,5.0,9.0
5837,1979-1980,6,Willem II,NEC Nijmegen,3,2,1,3,0,5,1,8.0,6.0
5838,1979-1980,7,FC Den Haag,FC Twente,2,1,1,3,0,3,1,8.0,9.0
5839,1979-1980,7,Go Ahead Eagles,HFC Haarlem,2,1,1,3,0,3,1,12.0,4.0
5840,1979-1980,7,MVV Maastricht,PEC Zwolle,0,1,2,0,3,1,-1,5.0,4.0
5841,1979-1980,7,NAC Breda,AZ '67 Alkmaar,0,3,2,0,3,3,-3,1.0,9.0
5842,1979-1980,7,PSV,NEC Nijmegen,1,0,1,3,0,1,1,13.0,6.0
5843,1979-1980,7,Sparta Rotterdam,Roda JC Kerkrade,1,0,1,3,0,1,1,7.0,3.0
5844,1979-1980,7,AFC Ajax,FC Utrecht,3,2,1,3,0,5,1,11.0,6.0
5845,1979-1980,7,SBV Excelsior,Feyenoord,0,2,2,0,3,2,-2,6.0,9.0
5846,1979-1980,7,Vitesse,Willem II,3,1,1,3,0,4,2,5.0,7.0
5847,1979-1980,8,AZ '67 Alkmaar,Go Ahead Eagles,2,0,1,3,0,2,2,12.0,12.0
5848,1979-1980,8,FC Twente,Sparta Rotterdam,2,0,1,3,0,2,2,9.0,4.0
5849,1979-1980,8,Feyenoord,AFC Ajax,4,0,1,3,0,4,4,11.0,8.0
5850,1979-1980,8,NEC Nijmegen,MVV Maastricht,2,1,1,3,0,3,1,6.0,4.0
5851,1979-1980,8,PEC Zwolle,FC Den Haag,3,1,1,3,0,4,2,7.0,5.0
5852,1979-1980,8,Willem II,PSV,1,1,3,1,1,2,0,5.0,13.0
5853,1979-1980,8,FC Utrecht,NAC Breda,1,1,3,1,1,2,0,6.0,2.0
5854,1979-1980,8,HFC Haarlem,Vitesse,3,1,1,3,0,4,2,7.0,5.0
5855,1979-1980,8,Roda JC Kerkrade,SBV Excelsior,1,1,3,1,1,2,0,4.0,4.0
5856,1979-1980,9,FC Den Haag,NEC Nijmegen,2,0,1,3,0,2,2,7.0,6.0
5857,1979-1980,9,Go Ahead Eagles,FC Utrecht,0,0,3,1,1,0,0,10.0,6.0
5858,1979-1980,9,MVV Maastricht,PSV,2,1,1,3,0,3,1,6.0,10.0
5859,1979-1980,9,Sparta Rotterdam,PEC Zwolle,1,0,1,3,0,1,1,7.0,6.0
5860,1979-1980,9,AFC Ajax,Roda JC Kerkrade,4,0,1,3,0,4,4,10.0,4.0
5861,1979-1980,9,SBV Excelsior,FC Twente,2,2,3,1,1,4,0,2.0,7.0
5862,1979-1980,9,HFC Haarlem,Willem II,3,1,1,3,0,4,2,10.0,4.0
5863,1979-1980,9,Vitesse,AZ '67 Alkmaar,1,1,3,1,1,2,0,5.0,10.0
5864,1979-1980,9,NAC Breda,Feyenoord,3,2,1,3,0,5,1,5.0,10.0
5865,1979-1980,10,AZ '67 Alkmaar,HFC Haarlem,2,0,1,3,0,2,2,10.0,9.0
5866,1979-1980,10,Feyenoord,Go Ahead Eagles,1,1,3,1,1,2,0,10.0,8.0
5867,1979-1980,10,PEC Zwolle,SBV Excelsior,4,2,1,3,0,6,2,9.0,2.0
5868,1979-1980,10,PSV,FC Den Haag,1,1,3,1,1,2,0,8.0,7.0
5869,1979-1980,10,FC Utrecht,Vitesse,4,0,1,3,0,4,4,8.0,4.0
5870,1979-1980,10,Roda JC Kerkrade,NAC Breda,2,1,1,3,0,3,1,7.0,4.0
5871,1979-1980,10,Willem II,MVV Maastricht,1,1,3,1,1,2,0,5.0,4.0
5872,1979-1980,10,NEC Nijmegen,Sparta Rotterdam,3,1,1,3,0,4,2,6.0,6.0
5873,1979-1980,10,FC Twente,AFC Ajax,1,0,1,3,0,1,1,10.0,9.0
5874,1979-1980,11,AZ '67 Alkmaar,Willem II,3,1,1,3,0,4,2,13.0,2.0
5875,1979-1980,11,FC Den Haag,MVV Maastricht,1,1,3,1,1,2,0,8.0,5.0
5876,1979-1980,11,Go Ahead Eagles,Roda JC Kerkrade,1,2,2,0,3,3,-1,5.0,7.0
5877,1979-1980,11,NAC Breda,FC Twente,1,0,1,3,0,1,1,7.0,7.0
5878,1979-1980,11,Sparta Rotterdam,PSV,1,2,2,0,3,3,-1,6.0,8.0
5879,1979-1980,11,AFC Ajax,PEC Zwolle,2,0,1,3,0,2,2,9.0,9.0
5880,1979-1980,11,SBV Excelsior,NEC Nijmegen,4,0,1,3,0,4,4,5.0,6.0
5881,1979-1980,11,HFC Haarlem,FC Utrecht,0,2,2,0,3,2,-2,6.0,8.0
5882,1979-1980,11,Vitesse,Feyenoord,1,3,2,0,3,4,-2,4.0,10.0
5883,1979-1980,12,Feyenoord,HFC Haarlem,1,1,3,1,1,2,0,8.0,7.0
5884,1979-1980,12,MVV Maastricht,Sparta Rotterdam,1,3,2,0,3,4,-2,5.0,6.0
5885,1979-1980,12,NEC Nijmegen,AFC Ajax,0,3,2,0,3,3,-3,6.0,9.0
5886,1979-1980,12,PEC Zwolle,NAC Breda,3,0,1,3,0,3,3,9.0,7.0
5887,1979-1980,12,PSV,SBV Excelsior,1,1,3,1,1,2,0,6.0,6.0
5888,1979-1980,12,FC Twente,Go Ahead Eagles,3,1,1,3,0,4,2,10.0,2.0
5889,1979-1980,12,FC Utrecht,AZ '67 Alkmaar,3,2,1,3,0,5,1,11.0,10.0
5890,1979-1980,12,Roda JC Kerkrade,Vitesse,2,1,1,3,0,3,1,10.0,1.0
5891,1979-1980,12,Willem II,FC Den Haag,0,0,3,1,1,0,0,3.0,6.0
5892,1979-1980,13,AZ '67 Alkmaar,Feyenoord,0,0,3,1,1,0,0,8.0,6.0
5893,1979-1980,13,Go Ahead Eagles,PEC Zwolle,0,0,3,1,1,0,0,3.0,7.0
5894,1979-1980,13,NAC Breda,NEC Nijmegen,1,0,1,3,0,1,1,9.0,3.0
5895,1979-1980,13,Sparta Rotterdam,FC Den Haag,2,2,3,1,1,4,0,7.0,7.0
5896,1979-1980,13,AFC Ajax,PSV,4,1,1,3,0,5,3,12.0,5.0
5897,1979-1980,13,SBV Excelsior,MVV Maastricht,0,0,3,1,1,0,0,6.0,6.0
5898,1979-1980,13,FC Utrecht,Willem II,2,2,3,1,1,4,0,11.0,3.0
5899,1979-1980,13,HFC Haarlem,Roda JC Kerkrade,1,3,2,0,3,4,-2,4.0,12.0
5900,1979-1980,13,Vitesse,FC Twente,1,3,2,0,3,4,-2,1.0,10.0
5901,1979-1980,14,MVV Maastricht,AFC Ajax,0,2,2,0,3,2,-2,3.0,12.0
5902,1979-1980,14,PEC Zwolle,Vitesse,2,1,1,3,0,3,1,10.0,0.0
5903,1979-1980,14,PSV,NAC Breda,2,0,1,3,0,2,2,8.0,6.0
5904,1979-1980,14,FC Den Haag,SBV Excelsior,1,2,2,0,3,3,-1,4.0,8.0
5905,1979-1980,14,FC Twente,HFC Haarlem,2,2,3,1,1,4,0,10.0,2.0
5906,1979-1980,14,Feyenoord,FC Utrecht,3,0,1,3,0,3,3,9.0,10.0
5907,1979-1980,14,NEC Nijmegen,Go Ahead Eagles,0,3,2,0,3,3,-3,3.0,5.0
5908,1979-1980,14,Roda JC Kerkrade,AZ '67 Alkmaar,1,2,2,0,3,3,-1,12.0,10.0
5909,1979-1980,14,Willem II,Sparta Rotterdam,1,1,3,1,1,2,0,4.0,5.0
5910,1979-1980,15,AZ '67 Alkmaar,FC Twente,2,0,1,3,0,2,2,10.0,7.0
5911,1979-1980,15,NAC Breda,MVV Maastricht,0,0,3,1,1,0,0,7.0,3.0
5912,1979-1980,15,AFC Ajax,FC Den Haag,3,0,1,3,0,3,3,15.0,3.0
5913,1979-1980,15,SBV Excelsior,Sparta Rotterdam,3,1,1,3,0,4,2,11.0,5.0
5914,1979-1980,15,FC Utrecht,Roda JC Kerkrade,0,2,2,0,3,2,-2,7.0,12.0
5915,1979-1980,15,Feyenoord,Willem II,5,1,1,3,0,6,4,11.0,3.0
5916,1979-1980,15,Go Ahead Eagles,PSV,2,1,1,3,0,3,1,7.0,7.0
5917,1979-1980,15,HFC Haarlem,PEC Zwolle,1,1,3,1,1,2,0,3.0,8.0
5918,1979-1980,15,Vitesse,NEC Nijmegen,0,0,3,1,1,0,0,1.0,1.0
5919,1979-1980,16,MVV Maastricht,Go Ahead Eagles,3,3,3,1,1,6,0,3.0,8.0
5920,1979-1980,16,PEC Zwolle,AZ '67 Alkmaar,1,1,3,1,1,2,0,9.0,8.0
5921,1979-1980,16,PSV,Vitesse,1,1,3,1,1,2,0,5.0,2.0
5922,1979-1980,16,FC Den Haag,NAC Breda,3,0,1,3,0,3,3,5.0,4.0
5923,1979-1980,16,FC Twente,FC Utrecht,0,1,2,0,3,1,-1,7.0,7.0
5924,1979-1980,16,NEC Nijmegen,HFC Haarlem,0,0,3,1,1,0,0,2.0,4.0
5925,1979-1980,16,Roda JC Kerkrade,Feyenoord,1,0,1,3,0,1,1,12.0,8.0
5926,1979-1980,16,Sparta Rotterdam,AFC Ajax,3,4,2,0,3,7,-1,5.0,15.0
5927,1979-1980,16,Willem II,SBV Excelsior,3,1,1,3,0,4,2,6.0,8.0
5928,1979-1980,17,AFC Ajax,SBV Excelsior,6,0,1,3,0,6,6,15.0,7.0
5929,1979-1980,17,FC Utrecht,PEC Zwolle,3,1,1,3,0,4,2,7.0,6.0
5930,1979-1980,17,Feyenoord,FC Twente,1,1,3,1,1,2,0,8.0,5.0
5931,1979-1980,17,HFC Haarlem,PSV,1,4,2,0,3,5,-3,3.0,7.0
5932,1979-1980,17,Roda JC Kerkrade,Willem II,1,2,2,0,3,3,-1,9.0,8.0
5933,1979-1980,17,Vitesse,MVV Maastricht,1,1,3,1,1,2,0,3.0,4.0
5934,1979-1980,17,Go Ahead Eagles,FC Den Haag,1,0,1,3,0,1,1,11.0,4.0
5935,1979-1980,17,NAC Breda,Sparta Rotterdam,2,1,1,3,0,3,1,7.0,2.0
5936,1979-1980,17,AZ '67 Alkmaar,NEC Nijmegen,3,0,1,3,0,3,3,11.0,2.0
5937,1979-1980,18,AFC Ajax,Willem II,7,1,1,3,0,8,6,15.0,7.0
5938,1979-1980,18,FC Den Haag,Vitesse,2,0,1,3,0,2,2,6.0,3.0
5939,1979-1980,18,MVV Maastricht,HFC Haarlem,4,1,1,3,0,5,3,6.0,3.0
5940,1979-1980,18,PEC Zwolle,Feyenoord,0,2,2,0,3,2,-2,5.0,10.0
5941,1979-1980,18,PSV,AZ '67 Alkmaar,1,1,3,1,1,2,0,8.0,11.0
5942,1979-1980,18,SBV Excelsior,NAC Breda,4,2,1,3,0,6,2,9.0,4.0
5943,1979-1980,18,FC Twente,Roda JC Kerkrade,1,1,3,1,1,2,0,3.0,7.0
5944,1979-1980,18,NEC Nijmegen,FC Utrecht,3,1,1,3,0,4,2,5.0,6.0
5945,1979-1980,18,Sparta Rotterdam,Go Ahead Eagles,2,1,1,3,0,3,1,4.0,10.0
5946,1979-1980,19,AZ '67 Alkmaar,MVV Maastricht,5,1,1,3,0,6,4,11.0,6.0
5947,1979-1980,19,NAC Breda,AFC Ajax,0,1,2,0,3,1,-1,4.0,15.0
5948,1979-1980,19,FC Utrecht,PSV,2,1,1,3,0,3,1,9.0,5.0
5949,1979-1980,19,Feyenoord,NEC Nijmegen,2,1,1,3,0,3,1,10.0,5.0
5950,1979-1980,19,Go Ahead Eagles,SBV Excelsior,0,2,2,0,3,2,-2,7.0,9.0
5951,1979-1980,19,HFC Haarlem,FC Den Haag,1,1,3,1,1,2,0,3.0,7.0
5952,1979-1980,19,Roda JC Kerkrade,PEC Zwolle,2,1,1,3,0,3,1,10.0,2.0
5953,1979-1980,19,Vitesse,Sparta Rotterdam,2,1,1,3,0,3,1,6.0,3.0
5954,1979-1980,19,Willem II,FC Twente,1,0,1,3,0,1,1,9.0,2.0
5955,1979-1980,20,AZ '67 Alkmaar,FC Den Haag,2,1,1,3,0,3,1,11.0,7.0
5956,1979-1980,20,FC Utrecht,MVV Maastricht,2,0,1,3,0,2,2,12.0,5.0
5957,1979-1980,20,Feyenoord,PSV,0,3,2,0,3,3,-3,7.0,8.0
5958,1979-1980,20,HFC Haarlem,Sparta Rotterdam,5,3,1,3,0,8,2,5.0,3.0
5959,1979-1980,20,Roda JC Kerkrade,NEC Nijmegen,2,0,1,3,0,2,2,10.0,4.0
5960,1979-1980,20,Go Ahead Eagles,AFC Ajax,0,1,2,0,3,1,-1,4.0,15.0
5961,1979-1980,20,Willem II,NAC Breda,3,1,1,3,0,4,2,12.0,3.0
5962,1979-1980,20,Vitesse,SBV Excelsior,3,3,3,1,1,6,0,6.0,7.0
5963,1979-1980,20,FC Twente,PEC Zwolle,1,0,1,3,0,1,1,5.0,1.0
5964,1979-1980,21,NAC Breda,Go Ahead Eagles,1,0,1,3,0,1,1,6.0,3.0
5965,1979-1980,21,PSV,Roda JC Kerkrade,0,1,2,0,3,1,-1,7.0,10.0
5966,1979-1980,21,AFC Ajax,Vitesse,3,0,1,3,0,3,3,15.0,5.0
5967,1979-1980,21,SBV Excelsior,HFC Haarlem,1,2,2,0,3,3,-1,7.0,7.0
5968,1979-1980,21,FC Den Haag,FC Utrecht,2,1,1,3,0,3,1,7.0,9.0
5969,1979-1980,21,NEC Nijmegen,FC Twente,0,3,2,0,3,3,-3,3.0,8.0
5970,1979-1980,21,Sparta Rotterdam,AZ '67 Alkmaar,3,3,3,1,1,6,0,4.0,11.0
5971,1979-1980,21,MVV Maastricht,Feyenoord,2,1,1,3,0,3,1,7.0,7.0
5972,1979-1980,21,PEC Zwolle,Willem II,2,2,3,1,1,4,0,1.0,10.0
5973,1979-1980,22,AZ '67 Alkmaar,SBV Excelsior,1,0,1,3,0,1,1,11.0,7.0
5974,1979-1980,22,PEC Zwolle,NEC Nijmegen,1,0,1,3,0,1,1,4.0,3.0
5975,1979-1980,22,FC Twente,PSV,2,1,1,3,0,3,1,10.0,4.0
5976,1979-1980,22,FC Utrecht,Sparta Rotterdam,3,1,1,3,0,4,2,9.0,4.0
5977,1979-1980,22,Feyenoord,FC Den Haag,2,1,1,3,0,3,1,9.0,7.0
5978,1979-1980,22,HFC Haarlem,AFC Ajax,1,3,2,0,3,4,-2,7.0,15.0
5979,1979-1980,22,Roda JC Kerkrade,MVV Maastricht,4,0,1,3,0,4,4,13.0,6.0
5980,1979-1980,22,Vitesse,NAC Breda,2,0,1,3,0,2,2,7.0,3.0
5981,1979-1980,22,Willem II,Go Ahead Eagles,3,0,1,3,0,3,3,10.0,0.0
5982,1979-1980,23,MVV Maastricht,FC Twente,1,0,1,3,0,1,1,6.0,9.0
5983,1979-1980,23,NAC Breda,HFC Haarlem,1,0,1,3,0,1,1,6.0,7.0
5984,1979-1980,23,PSV,PEC Zwolle,0,0,3,1,1,0,0,4.0,5.0
5985,1979-1980,23,AFC Ajax,AZ '67 Alkmaar,2,2,3,1,1,4,0,13.0,11.0
5986,1979-1980,23,SBV Excelsior,FC Utrecht,1,1,3,1,1,2,0,5.0,10.0
5987,1979-1980,23,FC Den Haag,Roda JC Kerkrade,2,0,1,3,0,2,2,7.0,12.0
5988,1979-1980,23,Go Ahead Eagles,Vitesse,5,1,1,3,0,6,4,3.0,7.0
5989,1979-1980,23,NEC Nijmegen,Willem II,2,3,2,0,3,5,-1,0.0,13.0
5990,1979-1980,23,Sparta Rotterdam,Feyenoord,0,4,2,0,3,4,-4,1.0,9.0
5991,1979-1980,24,AZ '67 Alkmaar,NAC Breda,7,0,1,3,0,7,7,11.0,6.0
5992,1979-1980,24,PEC Zwolle,MVV Maastricht,1,2,2,0,3,3,-1,5.0,9.0
5993,1979-1980,24,FC Twente,FC Den Haag,2,0,1,3,0,2,2,12.0,6.0
5994,1979-1980,24,FC Utrecht,AFC Ajax,1,2,2,0,3,3,-1,7.0,13.0
5995,1979-1980,24,Feyenoord,SBV Excelsior,0,4,2,0,3,4,-4,6.0,5.0
5996,1979-1980,24,HFC Haarlem,Go Ahead Eagles,2,3,2,0,3,5,-1,6.0,6.0
5997,1979-1980,24,NEC Nijmegen,PSV,2,0,1,3,0,2,2,3.0,4.0
5998,1979-1980,24,Roda JC Kerkrade,Sparta Rotterdam,2,2,3,1,1,4,0,10.0,2.0
5999,1979-1980,24,Willem II,Vitesse,0,0,3,1,1,0,0,11.0,5.0
6000,1979-1980,25,FC Den Haag,PEC Zwolle,2,0,1,3,0,2,2,9.0,5.0
6001,1979-1980,25,MVV Maastricht,NEC Nijmegen,0,2,2,0,3,2,-2,9.0,6.0
6002,1979-1980,25,NAC Breda,FC Utrecht,0,0,3,1,1,0,0,7.0,5.0
6003,1979-1980,25,PSV,Willem II,3,0,1,3,0,3,3,4.0,8.0
6004,1979-1980,25,AFC Ajax,Feyenoord,1,1,3,1,1,2,0,11.0,7.0
6005,1979-1980,25,SBV Excelsior,Roda JC Kerkrade,1,1,3,1,1,2,0,5.0,8.0
6006,1979-1980,25,Go Ahead Eagles,AZ '67 Alkmaar,2,1,1,3,0,3,1,9.0,8.0
6007,1979-1980,25,Sparta Rotterdam,FC Twente,1,0,1,3,0,1,1,5.0,9.0
6008,1979-1980,25,Vitesse,HFC Haarlem,1,1,3,1,1,2,0,5.0,4.0
6009,1979-1980,26,AZ '67 Alkmaar,Vitesse,2,1,1,3,0,3,1,10.0,5.0
6010,1979-1980,26,NEC Nijmegen,FC Den Haag,1,0,1,3,0,1,1,9.0,6.0
6011,1979-1980,26,PEC Zwolle,Sparta Rotterdam,0,1,2,0,3,1,-1,4.0,7.0
6012,1979-1980,26,PSV,MVV Maastricht,2,0,1,3,0,2,2,7.0,6.0
6013,1979-1980,26,FC Twente,SBV Excelsior,2,1,1,3,0,3,1,9.0,5.0
6014,1979-1980,26,FC Utrecht,Go Ahead Eagles,4,0,1,3,0,4,4,8.0,9.0
6015,1979-1980,26,Feyenoord,NAC Breda,3,1,1,3,0,4,2,10.0,4.0
6016,1979-1980,26,Roda JC Kerkrade,AFC Ajax,2,1,1,3,0,3,1,8.0,8.0
6017,1979-1980,26,Willem II,HFC Haarlem,2,2,3,1,1,4,0,8.0,2.0
6018,1979-1980,27,FC Den Haag,PSV,2,3,2,0,3,5,-1,6.0,10.0
6019,1979-1980,27,Go Ahead Eagles,Feyenoord,1,1,3,1,1,2,0,10.0,8.0
6020,1979-1980,27,MVV Maastricht,Willem II,0,1,2,0,3,1,-1,6.0,8.0
6021,1979-1980,27,NAC Breda,Roda JC Kerkrade,3,0,1,3,0,3,3,7.0,5.0
6022,1979-1980,27,Sparta Rotterdam,NEC Nijmegen,0,0,3,1,1,0,0,8.0,10.0
6023,1979-1980,27,AFC Ajax,FC Twente,3,2,1,3,0,5,1,8.0,6.0
6024,1979-1980,27,SBV Excelsior,PEC Zwolle,3,1,1,3,0,4,2,8.0,1.0
6025,1979-1980,27,HFC Haarlem,AZ '67 Alkmaar,0,3,2,0,3,3,-3,2.0,10.0
6026,1979-1980,27,Vitesse,FC Utrecht,1,0,1,3,0,1,1,5.0,5.0
6027,1979-1980,28,MVV Maastricht,FC Den Haag,2,0,1,3,0,2,2,6.0,3.0
6028,1979-1980,28,NEC Nijmegen,SBV Excelsior,2,2,3,1,1,4,0,11.0,8.0
6029,1979-1980,28,PEC Zwolle,AFC Ajax,3,0,1,3,0,3,3,3.0,7.0
6030,1979-1980,28,PSV,Sparta Rotterdam,1,0,1,3,0,1,1,12.0,8.0
6031,1979-1980,28,FC Twente,NAC Breda,1,4,2,0,3,5,-3,6.0,7.0
6032,1979-1980,28,FC Utrecht,HFC Haarlem,1,0,1,3,0,1,1,7.0,2.0
6033,1979-1980,28,Feyenoord,Vitesse,0,0,3,1,1,0,0,6.0,6.0
6034,1979-1980,28,Roda JC Kerkrade,Go Ahead Eagles,3,1,1,3,0,4,2,8.0,7.0
6035,1979-1980,28,Willem II,AZ '67 Alkmaar,0,6,2,0,3,6,-6,5.0,12.0
6036,1979-1980,29,AFC Ajax,NEC Nijmegen,3,0,1,3,0,3,3,7.0,8.0
6037,1979-1980,29,AZ '67 Alkmaar,FC Utrecht,1,0,1,3,0,1,1,12.0,7.0
6038,1979-1980,29,FC Den Haag,Willem II,0,0,3,1,1,0,0,4.0,5.0
6039,1979-1980,29,Go Ahead Eagles,FC Twente,1,2,2,0,3,3,-1,4.0,6.0
6040,1979-1980,29,NAC Breda,PEC Zwolle,2,1,1,3,0,3,1,10.0,3.0
6041,1979-1980,29,Sparta Rotterdam,MVV Maastricht,1,0,1,3,0,1,1,10.0,3.0
6042,1979-1980,29,SBV Excelsior,PSV,1,2,2,0,3,3,-1,5.0,15.0
6043,1979-1980,29,HFC Haarlem,Feyenoord,0,2,2,0,3,2,-2,2.0,9.0
6044,1979-1980,29,Vitesse,Roda JC Kerkrade,1,1,3,1,1,2,0,6.0,8.0
6045,1979-1980,30,FC Den Haag,Sparta Rotterdam,2,0,1,3,0,2,2,4.0,7.0
6046,1979-1980,30,MVV Maastricht,SBV Excelsior,3,1,1,3,0,4,2,6.0,4.0
6047,1979-1980,30,PEC Zwolle,Go Ahead Eagles,2,1,1,3,0,3,1,6.0,1.0
6048,1979-1980,30,PSV,AFC Ajax,1,1,3,1,1,2,0,13.0,7.0
6049,1979-1980,30,FC Twente,Vitesse,4,1,1,3,0,5,3,9.0,5.0
6050,1979-1980,30,Feyenoord,AZ '67 Alkmaar,3,1,1,3,0,4,2,11.0,12.0
6051,1979-1980,30,NEC Nijmegen,NAC Breda,1,1,3,1,1,2,0,6.0,10.0
6052,1979-1980,30,Roda JC Kerkrade,HFC Haarlem,1,2,2,0,3,3,-1,7.0,4.0
6053,1979-1980,30,Willem II,FC Utrecht,0,2,2,0,3,2,-2,5.0,9.0
6054,1979-1980,31,AZ '67 Alkmaar,Roda JC Kerkrade,2,2,3,1,1,4,0,10.0,5.0
6055,1979-1980,31,FC Utrecht,Feyenoord,1,1,3,1,1,2,0,7.0,9.0
6056,1979-1980,31,Go Ahead Eagles,NEC Nijmegen,0,1,2,0,3,1,-1,1.0,6.0
6057,1979-1980,31,NAC Breda,PSV,2,4,2,0,3,6,-2,10.0,13.0
6058,1979-1980,31,Sparta Rotterdam,Willem II,4,0,1,3,0,4,4,7.0,4.0
6059,1979-1980,31,AFC Ajax,MVV Maastricht,3,6,2,0,3,9,-3,7.0,9.0
6060,1979-1980,31,SBV Excelsior,FC Den Haag,1,1,3,1,1,2,0,5.0,5.0
6061,1979-1980,31,HFC Haarlem,FC Twente,0,0,3,1,1,0,0,4.0,7.0
6062,1979-1980,31,Vitesse,PEC Zwolle,0,0,3,1,1,0,0,6.0,7.0
6063,1979-1980,32,FC Den Haag,AFC Ajax,1,0,1,3,0,1,1,8.0,4.0
6064,1979-1980,32,MVV Maastricht,NAC Breda,3,2,1,3,0,5,1,12.0,7.0
6065,1979-1980,32,NEC Nijmegen,Vitesse,1,0,1,3,0,1,1,8.0,3.0
6066,1979-1980,32,PEC Zwolle,HFC Haarlem,3,0,1,3,0,3,3,10.0,4.0
6067,1979-1980,32,PSV,Go Ahead Eagles,3,2,1,3,0,5,1,13.0,0.0
6068,1979-1980,32,Sparta Rotterdam,SBV Excelsior,3,1,1,3,0,4,2,9.0,2.0
6069,1979-1980,32,FC Twente,AZ '67 Alkmaar,4,1,1,3,0,5,3,10.0,7.0
6070,1979-1980,32,Roda JC Kerkrade,FC Utrecht,1,3,2,0,3,4,-2,5.0,10.0
6071,1979-1980,32,Willem II,Feyenoord,1,1,3,1,1,2,0,2.0,9.0
6072,1979-1980,33,AFC Ajax,Sparta Rotterdam,1,0,1,3,0,1,1,7.0,9.0
6073,1979-1980,33,AZ '67 Alkmaar,PEC Zwolle,5,0,1,3,0,5,5,7.0,7.0
6074,1979-1980,33,SBV Excelsior,Willem II,1,2,2,0,3,3,-1,1.0,5.0
6075,1979-1980,33,FC Utrecht,FC Twente,0,0,3,1,1,0,0,8.0,11.0
6076,1979-1980,33,Feyenoord,Roda JC Kerkrade,1,1,3,1,1,2,0,9.0,3.0
6077,1979-1980,33,Go Ahead Eagles,MVV Maastricht,1,1,3,1,1,2,0,1.0,10.0
6078,1979-1980,33,HFC Haarlem,NEC Nijmegen,2,1,1,3,0,3,1,7.0,7.0
6079,1979-1980,33,NAC Breda,FC Den Haag,1,0,1,3,0,1,1,7.0,8.0
6080,1979-1980,33,Vitesse,PSV,0,2,2,0,3,2,-2,2.0,13.0
6081,1979-1980,34,SBV Excelsior,AFC Ajax,2,2,3,1,1,4,0,2.0,5.0
6082,1979-1980,34,FC Den Haag,Go Ahead Eagles,2,4,2,0,3,6,-2,7.0,4.0
6083,1979-1980,34,FC Twente,Feyenoord,3,0,1,3,0,3,3,11.0,6.0
6084,1979-1980,34,MVV Maastricht,Vitesse,2,2,3,1,1,4,0,11.0,2.0
6085,1979-1980,34,NEC Nijmegen,AZ '67 Alkmaar,1,0,1,3,0,1,1,10.0,4.0
6086,1979-1980,34,PEC Zwolle,FC Utrecht,2,2,3,1,1,4,0,8.0,9.0
6087,1979-1980,34,PSV,HFC Haarlem,5,0,1,3,0,5,5,13.0,7.0
6088,1979-1980,34,Sparta Rotterdam,NAC Breda,1,1,3,1,1,2,0,7.0,5.0
6089,1979-1980,34,Willem II,Roda JC Kerkrade,4,2,1,3,0,6,2,7.0,2.0
6090,1980-1981,1,Go Ahead Eagles,AFC Ajax,2,4,2,0,3,6,-2,4.0,7.0
6091,1980-1981,1,NAC Breda,AZ '67 Alkmaar,1,4,2,0,3,5,-3,4.0,7.0
6092,1980-1981,1,PSV,FC Den Haag,3,0,1,3,0,3,3,15.0,4.0
6093,1980-1981,1,SBV Excelsior,FC Groningen,3,2,1,3,0,5,1,5.0,6.0
6094,1980-1981,1,FC Utrecht,MVV Maastricht,3,1,1,3,0,4,2,9.0,8.0
6095,1980-1981,1,FC Wageningen,PEC Zwolle,0,0,3,1,1,0,0,,6.0
6096,1980-1981,1,Roda JC Kerkrade,NEC Nijmegen,2,0,1,3,0,2,2,5.0,9.0
6097,1980-1981,1,Sparta Rotterdam,Feyenoord,1,2,2,0,3,3,-1,7.0,6.0
6098,1980-1981,1,Willem II,FC Twente,0,2,2,0,3,2,-2,7.0,11.0
6099,1980-1981,2,AFC Ajax,Roda JC Kerkrade,4,2,1,3,0,6,2,10.0,4.0
6100,1980-1981,2,AZ '67 Alkmaar,PSV,2,0,1,3,0,2,2,9.0,12.0
6101,1980-1981,2,FC Den Haag,SBV Excelsior,3,1,1,3,0,4,2,6.0,4.0
6102,1980-1981,2,FC Groningen,Sparta Rotterdam,5,0,1,3,0,5,5,9.0,4.0
6103,1980-1981,2,FC Twente,FC Utrecht,3,0,1,3,0,3,3,13.0,8.0
6104,1980-1981,2,Feyenoord,Willem II,4,0,1,3,0,4,4,8.0,7.0
6105,1980-1981,2,MVV Maastricht,Go Ahead Eagles,1,1,3,1,1,2,0,6.0,5.0
6106,1980-1981,2,NEC Nijmegen,FC Wageningen,2,2,3,1,1,4,0,7.0,
6107,1980-1981,2,PEC Zwolle,NAC Breda,0,0,3,1,1,0,0,6.0,5.0
6108,1980-1981,3,AFC Ajax,FC Wageningen,2,4,2,0,3,6,-2,10.0,
6109,1980-1981,3,AZ '67 Alkmaar,SBV Excelsior,2,1,1,3,0,3,1,12.0,4.0
6110,1980-1981,3,FC Den Haag,FC Groningen,3,3,3,1,1,6,0,4.0,7.0
6111,1980-1981,3,FC Twente,Go Ahead Eagles,3,1,1,3,0,4,2,13.0,5.0
6112,1980-1981,3,Feyenoord,FC Utrecht,1,1,3,1,1,2,0,8.0,6.0
6113,1980-1981,3,MVV Maastricht,Roda JC Kerkrade,2,1,1,3,0,3,1,6.0,4.0
6114,1980-1981,3,NEC Nijmegen,NAC Breda,4,2,1,3,0,6,2,7.0,5.0
6115,1980-1981,3,PEC Zwolle,PSV,0,0,3,1,1,0,0,4.0,10.0
6116,1980-1981,3,Willem II,Sparta Rotterdam,1,0,1,3,0,1,1,9.0,1.0
6117,1980-1981,4,SBV Excelsior,PEC Zwolle,3,3,3,1,1,6,0,5.0,5.0
6118,1980-1981,4,FC Groningen,AZ '67 Alkmaar,1,4,2,0,3,5,-3,4.0,12.0
6119,1980-1981,4,FC Utrecht,Willem II,0,2,2,0,3,2,-2,5.0,9.0
6120,1980-1981,4,FC Wageningen,MVV Maastricht,1,2,2,0,3,3,-1,,8.0
6121,1980-1981,4,Go Ahead Eagles,Feyenoord,0,2,2,0,3,2,-2,4.0,10.0
6122,1980-1981,4,NAC Breda,AFC Ajax,1,1,3,1,1,2,0,3.0,8.0
6123,1980-1981,4,PSV,NEC Nijmegen,0,0,3,1,1,0,0,8.0,8.0
6124,1980-1981,4,Roda JC Kerkrade,FC Twente,6,1,1,3,0,7,5,6.0,12.0
6125,1980-1981,4,Sparta Rotterdam,FC Den Haag,2,0,1,3,0,2,2,4.0,4.0
6126,1980-1981,5,AZ '67 Alkmaar,FC Den Haag,4,0,1,3,0,4,4,15.0,4.0
6127,1980-1981,5,FC Twente,FC Wageningen,2,1,1,3,0,3,1,12.0,5.0
6128,1980-1981,5,FC Utrecht,Sparta Rotterdam,5,1,1,3,0,6,4,7.0,3.0
6129,1980-1981,5,MVV Maastricht,NAC Breda,2,0,1,3,0,2,2,10.0,2.0
6130,1980-1981,5,NEC Nijmegen,SBV Excelsior,1,1,3,1,1,2,0,6.0,5.0
6131,1980-1981,5,PEC Zwolle,FC Groningen,0,0,3,1,1,0,0,5.0,5.0
6132,1980-1981,5,AFC Ajax,PSV,5,2,1,3,0,7,3,10.0,5.0
6133,1980-1981,5,Feyenoord,Roda JC Kerkrade,2,3,2,0,3,5,-1,10.0,9.0
6134,1980-1981,5,Willem II,Go Ahead Eagles,6,1,1,3,0,7,5,9.0,1.0
6135,1980-1981,6,FC Den Haag,PEC Zwolle,2,3,2,0,3,5,-1,4.0,7.0
6136,1980-1981,6,Go Ahead Eagles,FC Utrecht,2,1,1,3,0,3,1,4.0,4.0
6137,1980-1981,6,NAC Breda,FC Twente,1,2,2,0,3,3,-1,2.0,12.0
6138,1980-1981,6,PSV,MVV Maastricht,2,2,3,1,1,4,0,3.0,11.0
6139,1980-1981,6,SBV Excelsior,AFC Ajax,2,4,2,0,3,6,-2,2.0,10.0
6140,1980-1981,6,FC Groningen,NEC Nijmegen,2,0,1,3,0,2,2,8.0,6.0
6141,1980-1981,6,FC Wageningen,Feyenoord,0,1,2,0,3,1,-1,4.0,10.0
6142,1980-1981,6,Roda JC Kerkrade,Willem II,1,1,3,1,1,2,0,7.0,10.0
6143,1980-1981,6,Sparta Rotterdam,AZ '67 Alkmaar,3,7,2,0,3,10,-4,3.0,15.0
6144,1980-1981,7,FC Twente,PSV,0,1,2,0,3,1,-1,9.0,6.0
6145,1980-1981,7,FC Utrecht,Roda JC Kerkrade,3,1,1,3,0,4,2,7.0,7.0
6146,1980-1981,7,Feyenoord,NAC Breda,4,0,1,3,0,4,4,10.0,1.0
6147,1980-1981,7,Go Ahead Eagles,Sparta Rotterdam,1,2,2,0,3,3,-1,3.0,6.0
6148,1980-1981,7,MVV Maastricht,SBV Excelsior,2,0,1,3,0,2,2,13.0,2.0
6149,1980-1981,7,NEC Nijmegen,FC Den Haag,2,4,2,0,3,6,-2,5.0,4.0
6150,1980-1981,7,PEC Zwolle,AZ '67 Alkmaar,0,3,2,0,3,3,-3,6.0,15.0
6151,1980-1981,7,AFC Ajax,FC Groningen,5,1,1,3,0,6,4,10.0,5.0
6152,1980-1981,7,Willem II,FC Wageningen,1,2,2,0,3,3,-1,10.0,6.0
6153,1980-1981,8,AZ '67 Alkmaar,NEC Nijmegen,6,1,1,3,0,7,5,15.0,2.0
6154,1980-1981,8,FC Den Haag,AFC Ajax,4,3,1,3,0,7,1,6.0,10.0
6155,1980-1981,8,NAC Breda,Willem II,0,2,2,0,3,2,-2,1.0,10.0
6156,1980-1981,8,PSV,Feyenoord,0,1,2,0,3,1,-1,5.0,12.0
6157,1980-1981,8,SBV Excelsior,FC Twente,1,1,3,1,1,2,0,3.0,7.0
6158,1980-1981,8,FC Groningen,MVV Maastricht,1,2,2,0,3,3,-1,4.0,13.0
6159,1980-1981,8,FC Wageningen,FC Utrecht,1,1,3,1,1,2,0,4.0,7.0
6160,1980-1981,8,Roda JC Kerkrade,Go Ahead Eagles,2,2,3,1,1,4,0,8.0,4.0
6161,1980-1981,8,Sparta Rotterdam,PEC Zwolle,4,1,1,3,0,5,3,9.0,5.0
6162,1980-1981,9,AFC Ajax,AZ '67 Alkmaar,1,2,2,0,3,3,-1,9.0,15.0
6163,1980-1981,9,FC Twente,FC Groningen,3,1,1,3,0,4,2,10.0,4.0
6164,1980-1981,9,FC Utrecht,NAC Breda,3,0,1,3,0,3,3,10.0,0.0
6165,1980-1981,9,Feyenoord,SBV Excelsior,2,0,1,3,0,2,2,12.0,2.0
6166,1980-1981,9,Go Ahead Eagles,FC Wageningen,2,2,3,1,1,4,0,5.0,5.0
6167,1980-1981,9,MVV Maastricht,FC Den Haag,3,4,2,0,3,7,-1,10.0,9.0
6168,1980-1981,9,NEC Nijmegen,PEC Zwolle,2,0,1,3,0,2,2,4.0,4.0
6169,1980-1981,9,Roda JC Kerkrade,Sparta Rotterdam,4,1,1,3,0,5,3,8.0,6.0
6170,1980-1981,9,Willem II,PSV,1,6,2,0,3,7,-5,7.0,7.0
6171,1980-1981,10,AZ '67 Alkmaar,MVV Maastricht,4,1,1,3,0,5,3,15.0,7.0
6172,1980-1981,10,FC Den Haag,FC Twente,1,0,1,3,0,1,1,12.0,7.0
6173,1980-1981,10,NAC Breda,Go Ahead Eagles,2,0,1,3,0,2,2,3.0,5.0
6174,1980-1981,10,PEC Zwolle,AFC Ajax,2,0,1,3,0,2,2,6.0,6.0
6175,1980-1981,10,PSV,FC Utrecht,2,3,2,0,3,5,-1,7.0,10.0
6176,1980-1981,10,SBV Excelsior,Willem II,0,2,2,0,3,2,-2,1.0,7.0
6177,1980-1981,10,FC Groningen,Feyenoord,0,0,3,1,1,0,0,4.0,13.0
6178,1980-1981,10,FC Wageningen,Roda JC Kerkrade,1,1,3,1,1,2,0,6.0,6.0
6179,1980-1981,10,Sparta Rotterdam,NEC Nijmegen,4,1,1,3,0,5,3,9.0,3.0
6180,1980-1981,11,AFC Ajax,NEC Nijmegen,2,0,1,3,0,2,2,6.0,3.0
6181,1980-1981,11,FC Twente,AZ '67 Alkmaar,1,1,3,1,1,2,0,5.0,13.0
6182,1980-1981,11,FC Utrecht,SBV Excelsior,2,0,1,3,0,2,2,13.0,1.0
6183,1980-1981,11,Feyenoord,FC Den Haag,4,1,1,3,0,5,3,13.0,12.0
6184,1980-1981,11,Go Ahead Eagles,PSV,1,2,2,0,3,3,-1,2.0,9.0
6185,1980-1981,11,MVV Maastricht,PEC Zwolle,2,1,1,3,0,3,1,9.0,3.0
6186,1980-1981,11,FC Wageningen,Sparta Rotterdam,1,2,2,0,3,3,-1,6.0,12.0
6187,1980-1981,11,Roda JC Kerkrade,NAC Breda,3,2,1,3,0,5,1,8.0,3.0
6188,1980-1981,11,Willem II,FC Groningen,4,1,1,3,0,5,3,9.0,1.0
6189,1980-1981,12,AZ '67 Alkmaar,Feyenoord,5,2,1,3,0,7,3,13.0,10.0
6190,1980-1981,12,FC Den Haag,Willem II,0,1,2,0,3,1,-1,9.0,12.0
6191,1980-1981,12,NAC Breda,FC Wageningen,1,1,3,1,1,2,0,4.0,4.0
6192,1980-1981,12,PSV,Roda JC Kerkrade,4,1,1,3,0,5,3,9.0,8.0
6193,1980-1981,12,SBV Excelsior,Go Ahead Eagles,3,0,1,3,0,3,3,4.0,2.0
6194,1980-1981,12,Sparta Rotterdam,AFC Ajax,4,3,1,3,0,7,1,12.0,3.0
6195,1980-1981,12,NEC Nijmegen,MVV Maastricht,4,1,1,3,0,5,3,6.0,6.0
6196,1980-1981,12,PEC Zwolle,FC Twente,0,0,3,1,1,0,0,4.0,6.0
6197,1980-1981,12,FC Groningen,FC Utrecht,1,1,3,1,1,2,0,2.0,11.0
6198,1980-1981,13,FC Twente,NEC Nijmegen,6,1,1,3,0,7,5,8.0,6.0
6199,1980-1981,13,Go Ahead Eagles,FC Groningen,2,0,1,3,0,2,2,4.0,2.0
6200,1980-1981,13,MVV Maastricht,AFC Ajax,1,1,3,1,1,2,0,4.0,4.0
6201,1980-1981,13,NAC Breda,Sparta Rotterdam,5,0,1,3,0,5,5,7.0,9.0
6202,1980-1981,13,FC Utrecht,FC Den Haag,5,0,1,3,0,5,5,13.0,6.0
6203,1980-1981,13,FC Wageningen,PSV,0,3,2,0,3,3,-3,3.0,12.0
6204,1980-1981,13,Feyenoord,PEC Zwolle,3,1,1,3,0,4,2,10.0,4.0
6205,1980-1981,13,Roda JC Kerkrade,SBV Excelsior,1,1,3,1,1,2,0,8.0,4.0
6206,1980-1981,13,Willem II,AZ '67 Alkmaar,0,2,2,0,3,2,-2,9.0,13.0
6207,1980-1981,14,AZ '67 Alkmaar,FC Utrecht,2,1,1,3,0,3,1,13.0,10.0
6208,1980-1981,14,PEC Zwolle,Willem II,3,0,1,3,0,3,3,7.0,9.0
6209,1980-1981,14,PSV,NAC Breda,3,0,1,3,0,3,3,12.0,7.0
6210,1980-1981,14,AFC Ajax,FC Twente,5,3,1,3,0,8,2,7.0,5.0
6211,1980-1981,14,SBV Excelsior,FC Wageningen,1,2,2,0,3,3,-1,4.0,5.0
6212,1980-1981,14,FC Den Haag,Go Ahead Eagles,1,0,1,3,0,1,1,6.0,3.0
6213,1980-1981,14,FC Groningen,Roda JC Kerkrade,3,2,1,3,0,5,1,5.0,5.0
6214,1980-1981,14,NEC Nijmegen,Feyenoord,2,4,2,0,3,6,-2,3.0,10.0
6215,1980-1981,14,Sparta Rotterdam,MVV Maastricht,0,2,2,0,3,2,-2,9.0,7.0
6216,1980-1981,15,NAC Breda,SBV Excelsior,1,1,3,1,1,2,0,5.0,5.0
6217,1980-1981,15,PSV,Sparta Rotterdam,0,0,3,1,1,0,0,13.0,7.0
6218,1980-1981,15,Feyenoord,AFC Ajax,4,2,1,3,0,6,2,12.0,7.0
6219,1980-1981,15,Willem II,NEC Nijmegen,1,1,3,1,1,2,0,7.0,4.0
6220,1980-1981,15,FC Twente,MVV Maastricht,3,3,3,1,1,6,0,6.0,8.0
6221,1980-1981,15,FC Utrecht,PEC Zwolle,1,0,1,3,0,1,1,10.0,4.0
6222,1980-1981,15,Go Ahead Eagles,AZ '67 Alkmaar,1,3,2,0,3,4,-2,3.0,13.0
6223,1980-1981,15,Roda JC Kerkrade,FC Den Haag,3,2,1,3,0,5,1,7.0,3.0
6224,1980-1981,15,FC Wageningen,FC Groningen,3,0,1,3,0,3,3,7.0,4.0
6225,1980-1981,16,AZ '67 Alkmaar,Roda JC Kerkrade,3,0,1,3,0,3,3,15.0,4.0
6226,1980-1981,16,MVV Maastricht,Feyenoord,0,0,3,1,1,0,0,6.0,10.0
6227,1980-1981,16,PEC Zwolle,Go Ahead Eagles,2,0,1,3,0,2,2,7.0,3.0
6228,1980-1981,16,AFC Ajax,Willem II,1,1,3,1,1,2,0,5.0,5.0
6229,1980-1981,16,SBV Excelsior,PSV,0,0,3,1,1,0,0,6.0,11.0
6230,1980-1981,16,FC Den Haag,FC Wageningen,3,2,1,3,0,5,1,6.0,7.0
6231,1980-1981,16,FC Groningen,NAC Breda,3,1,1,3,0,4,2,7.0,5.0
6232,1980-1981,16,NEC Nijmegen,FC Utrecht,1,3,2,0,3,4,-2,4.0,10.0
6233,1980-1981,16,Sparta Rotterdam,FC Twente,1,2,2,0,3,3,-1,4.0,8.0
6234,1980-1981,17,Go Ahead Eagles,NEC Nijmegen,3,1,1,3,0,4,2,6.0,1.0
6235,1980-1981,17,NAC Breda,FC Den Haag,1,0,1,3,0,1,1,7.0,6.0
6236,1980-1981,17,PSV,FC Groningen,5,0,1,3,0,5,5,11.0,6.0
6237,1980-1981,17,SBV Excelsior,Sparta Rotterdam,1,2,2,0,3,3,-1,3.0,4.0
6238,1980-1981,17,FC Wageningen,AZ '67 Alkmaar,1,2,2,0,3,3,-1,6.0,15.0
6239,1980-1981,17,Feyenoord,FC Twente,1,0,1,3,0,1,1,13.0,7.0
6240,1980-1981,17,Roda JC Kerkrade,PEC Zwolle,4,0,1,3,0,4,4,7.0,6.0
6241,1980-1981,17,Willem II,MVV Maastricht,2,1,1,3,0,3,1,5.0,6.0
6242,1980-1981,17,FC Utrecht,AFC Ajax,1,2,2,0,3,3,-1,9.0,8.0
6243,1980-1981,18,AZ '67 Alkmaar,NAC Breda,6,1,1,3,0,7,5,15.0,4.0
6244,1980-1981,18,MVV Maastricht,FC Utrecht,1,3,2,0,3,4,-2,5.0,9.0
6245,1980-1981,18,PEC Zwolle,FC Wageningen,1,0,1,3,0,1,1,9.0,6.0
6246,1980-1981,18,AFC Ajax,Go Ahead Eagles,4,2,1,3,0,6,2,10.0,3.0
6247,1980-1981,18,FC Den Haag,PSV,1,4,2,0,3,5,-3,6.0,11.0
6248,1980-1981,18,FC Groningen,SBV Excelsior,2,2,3,1,1,4,0,7.0,3.0
6249,1980-1981,18,FC Twente,Willem II,5,1,1,3,0,6,4,7.0,5.0
6250,1980-1981,18,Feyenoord,Sparta Rotterdam,2,2,3,1,1,4,0,11.0,5.0
6251,1980-1981,18,NEC Nijmegen,Roda JC Kerkrade,2,2,3,1,1,4,0,2.0,7.0
6252,1980-1981,19,FC Wageningen,NEC Nijmegen,1,1,3,1,1,2,0,4.0,3.0
6253,1980-1981,19,Go Ahead Eagles,MVV Maastricht,4,2,1,3,0,6,2,6.0,2.0
6254,1980-1981,19,NAC Breda,PEC Zwolle,0,0,3,1,1,0,0,5.0,7.0
6255,1980-1981,19,PSV,AZ '67 Alkmaar,0,3,2,0,3,3,-3,8.0,15.0
6256,1980-1981,19,SBV Excelsior,FC Den Haag,0,2,2,0,3,2,-2,3.0,6.0
6257,1980-1981,19,FC Utrecht,FC Twente,2,2,3,1,1,4,0,10.0,8.0
6258,1980-1981,19,Roda JC Kerkrade,AFC Ajax,2,3,2,0,3,5,-1,7.0,10.0
6259,1980-1981,19,Sparta Rotterdam,FC Groningen,2,2,3,1,1,4,0,6.0,5.0
6260,1980-1981,19,Willem II,Feyenoord,1,2,2,0,3,3,-1,5.0,11.0
6261,1980-1981,20,FC Wageningen,AFC Ajax,0,2,2,0,3,2,-2,1.0,13.0
6262,1980-1981,20,Go Ahead Eagles,FC Twente,3,0,1,3,0,3,3,9.0,7.0
6263,1980-1981,20,NAC Breda,NEC Nijmegen,4,0,1,3,0,4,4,7.0,2.0
6264,1980-1981,20,PSV,PEC Zwolle,0,1,2,0,3,1,-1,7.0,10.0
6265,1980-1981,20,SBV Excelsior,AZ '67 Alkmaar,1,3,2,0,3,4,-2,2.0,15.0
6266,1980-1981,20,FC Groningen,FC Den Haag,0,1,2,0,3,1,-1,5.0,9.0
6267,1980-1981,20,FC Utrecht,Feyenoord,2,0,1,3,0,2,2,10.0,8.0
6268,1980-1981,20,Roda JC Kerkrade,MVV Maastricht,2,5,2,0,3,7,-3,4.0,4.0
6269,1980-1981,20,Sparta Rotterdam,Willem II,3,1,1,3,0,4,2,8.0,4.0
6270,1980-1981,21,MVV Maastricht,FC Wageningen,1,0,1,3,0,1,1,6.0,1.0
6271,1980-1981,21,FC Den Haag,Sparta Rotterdam,1,3,2,0,3,4,-2,6.0,11.0
6272,1980-1981,21,PEC Zwolle,SBV Excelsior,1,1,3,1,1,2,0,8.0,2.0
6273,1980-1981,21,Willem II,FC Utrecht,0,1,2,0,3,1,-1,3.0,10.0
6274,1980-1981,21,Feyenoord,Go Ahead Eagles,2,2,3,1,1,4,0,8.0,10.0
6275,1980-1981,21,FC Twente,Roda JC Kerkrade,3,2,1,3,0,5,1,7.0,4.0
6276,1980-1981,21,NEC Nijmegen,PSV,0,0,3,1,1,0,0,3.0,7.0
6277,1980-1981,21,AFC Ajax,NAC Breda,4,1,1,3,0,5,3,15.0,7.0
6278,1980-1981,21,AZ '67 Alkmaar,FC Groningen,5,0,1,3,0,5,5,15.0,2.0
6279,1980-1981,22,FC Wageningen,FC Twente,0,1,2,0,3,1,-1,1.0,10.0
6280,1980-1981,22,Go Ahead Eagles,Willem II,4,2,1,3,0,6,2,10.0,0.0
6281,1980-1981,22,NAC Breda,MVV Maastricht,4,0,1,3,0,4,4,7.0,6.0
6282,1980-1981,22,PSV,AFC Ajax,3,1,1,3,0,4,2,7.0,12.0
6283,1980-1981,22,SBV Excelsior,NEC Nijmegen,2,0,1,3,0,2,2,5.0,3.0
6284,1980-1981,22,FC Den Haag,AZ '67 Alkmaar,0,4,2,0,3,4,-4,6.0,15.0
6285,1980-1981,22,FC Groningen,PEC Zwolle,4,2,1,3,0,6,2,5.0,8.0
6286,1980-1981,22,Roda JC Kerkrade,Feyenoord,2,2,3,1,1,4,0,2.0,6.0
6287,1980-1981,22,Sparta Rotterdam,FC Utrecht,2,3,2,0,3,5,-1,8.0,13.0
6288,1980-1981,23,AZ '67 Alkmaar,Sparta Rotterdam,3,2,1,3,0,5,1,15.0,7.0
6289,1980-1981,23,MVV Maastricht,PSV,0,2,2,0,3,2,-2,6.0,7.0
6290,1980-1981,23,PEC Zwolle,FC Den Haag,4,2,1,3,0,6,2,8.0,6.0
6291,1980-1981,23,AFC Ajax,SBV Excelsior,7,2,1,3,0,9,5,12.0,4.0
6292,1980-1981,23,FC Twente,NAC Breda,2,2,3,1,1,4,0,8.0,8.0
6293,1980-1981,23,FC Utrecht,Go Ahead Eagles,1,1,3,1,1,2,0,11.0,11.0
6294,1980-1981,23,Feyenoord,FC Wageningen,6,0,1,3,0,6,6,8.0,1.0
6295,1980-1981,23,NEC Nijmegen,FC Groningen,1,1,3,1,1,2,0,3.0,5.0
6296,1980-1981,23,Willem II,Roda JC Kerkrade,2,2,3,1,1,4,0,1.0,2.0
6297,1980-1981,24,AZ '67 Alkmaar,PEC Zwolle,1,0,1,3,0,1,1,15.0,7.0
6298,1980-1981,24,FC Den Haag,NEC Nijmegen,2,0,1,3,0,2,2,6.0,2.0
6299,1980-1981,24,FC Wageningen,Willem II,2,1,1,3,0,3,1,3.0,1.0
6300,1980-1981,24,NAC Breda,Feyenoord,0,1,2,0,3,1,-1,7.0,8.0
6301,1980-1981,24,PSV,FC Twente,1,0,1,3,0,1,1,10.0,7.0
6302,1980-1981,24,SBV Excelsior,MVV Maastricht,0,0,3,1,1,0,0,5.0,7.0
6303,1980-1981,24,FC Groningen,AFC Ajax,0,1,2,0,3,1,-1,4.0,12.0
6304,1980-1981,24,Roda JC Kerkrade,FC Utrecht,0,0,3,1,1,0,0,3.0,11.0
6305,1980-1981,24,Sparta Rotterdam,Go Ahead Eagles,6,2,1,3,0,8,4,9.0,8.0
6306,1980-1981,25,Go Ahead Eagles,Roda JC Kerkrade,5,1,1,3,0,6,4,8.0,3.0
6307,1980-1981,25,MVV Maastricht,FC Groningen,2,2,3,1,1,4,0,5.0,5.0
6308,1980-1981,25,NEC Nijmegen,AZ '67 Alkmaar,0,0,3,1,1,0,0,3.0,13.0
6309,1980-1981,25,PEC Zwolle,Sparta Rotterdam,3,1,1,3,0,4,2,7.0,6.0
6310,1980-1981,25,AFC Ajax,FC Den Haag,2,0,1,3,0,2,2,12.0,3.0
6311,1980-1981,25,FC Twente,SBV Excelsior,0,1,2,0,3,1,-1,7.0,8.0
6312,1980-1981,25,FC Utrecht,FC Wageningen,5,0,1,3,0,5,5,11.0,3.0
6313,1980-1981,25,Feyenoord,PSV,0,1,2,0,3,1,-1,8.0,13.0
6314,1980-1981,25,Willem II,NAC Breda,2,2,3,1,1,4,0,2.0,5.0
6315,1980-1981,26,AZ '67 Alkmaar,AFC Ajax,0,1,2,0,3,1,-1,10.0,12.0
6316,1980-1981,26,FC Den Haag,MVV Maastricht,2,3,2,0,3,5,-1,3.0,5.0
6317,1980-1981,26,FC Wageningen,Go Ahead Eagles,2,1,1,3,0,3,1,6.0,7.0
6318,1980-1981,26,NAC Breda,FC Utrecht,0,3,2,0,3,3,-3,5.0,11.0
6319,1980-1981,26,PEC Zwolle,NEC Nijmegen,0,1,2,0,3,1,-1,6.0,5.0
6320,1980-1981,26,PSV,Willem II,4,0,1,3,0,4,4,15.0,2.0
6321,1980-1981,26,SBV Excelsior,Feyenoord,1,3,2,0,3,4,-2,7.0,10.0
6322,1980-1981,26,FC Groningen,FC Twente,0,1,2,0,3,1,-1,5.0,7.0
6323,1980-1981,26,Sparta Rotterdam,Roda JC Kerkrade,4,1,1,3,0,5,3,6.0,3.0
6324,1980-1981,27,AFC Ajax,PEC Zwolle,2,1,1,3,0,3,1,15.0,6.0
6325,1980-1981,27,FC Twente,FC Den Haag,4,1,1,3,0,5,3,7.0,3.0
6326,1980-1981,27,Feyenoord,FC Groningen,3,3,3,1,1,6,0,10.0,3.0
6327,1980-1981,27,Go Ahead Eagles,NAC Breda,4,0,1,3,0,4,4,7.0,2.0
6328,1980-1981,27,MVV Maastricht,AZ '67 Alkmaar,1,3,2,0,3,4,-2,5.0,10.0
6329,1980-1981,27,NEC Nijmegen,Sparta Rotterdam,2,2,3,1,1,4,0,6.0,7.0
6330,1980-1981,27,Roda JC Kerkrade,FC Wageningen,4,1,1,3,0,5,3,5.0,6.0
6331,1980-1981,27,Willem II,SBV Excelsior,2,1,1,3,0,3,1,5.0,4.0
6332,1980-1981,27,FC Utrecht,PSV,0,0,3,1,1,0,0,9.0,13.0
6333,1980-1981,28,AZ '67 Alkmaar,FC Twente,0,0,3,1,1,0,0,8.0,7.0
6334,1980-1981,28,FC Den Haag,Feyenoord,1,0,1,3,0,1,1,6.0,7.0
6335,1980-1981,28,NAC Breda,Roda JC Kerkrade,1,0,1,3,0,1,1,4.0,4.0
6336,1980-1981,28,NEC Nijmegen,AFC Ajax,0,0,3,1,1,0,0,6.0,13.0
6337,1980-1981,28,PEC Zwolle,MVV Maastricht,0,1,2,0,3,1,-1,3.0,8.0
6338,1980-1981,28,PSV,Go Ahead Eagles,1,1,3,1,1,2,0,11.0,7.0
6339,1980-1981,28,SBV Excelsior,FC Utrecht,2,2,3,1,1,4,0,5.0,9.0
6340,1980-1981,28,FC Groningen,Willem II,0,2,2,0,3,2,-2,2.0,7.0
6341,1980-1981,28,Sparta Rotterdam,FC Wageningen,3,0,1,3,0,3,3,10.0,6.0
6342,1980-1981,29,FC Wageningen,NAC Breda,2,2,3,1,1,4,0,4.0,5.0
6343,1980-1981,29,Go Ahead Eagles,SBV Excelsior,4,2,1,3,0,6,2,10.0,4.0
6344,1980-1981,29,MVV Maastricht,NEC Nijmegen,0,0,3,1,1,0,0,8.0,7.0
6345,1980-1981,29,Roda JC Kerkrade,PSV,2,3,2,0,3,5,-1,3.0,11.0
6346,1980-1981,29,AFC Ajax,Sparta Rotterdam,2,1,1,3,0,3,1,13.0,7.0
6347,1980-1981,29,FC Twente,PEC Zwolle,2,0,1,3,0,2,2,10.0,3.0
6348,1980-1981,29,FC Utrecht,FC Groningen,3,0,1,3,0,3,3,11.0,2.0
6349,1980-1981,29,Feyenoord,AZ '67 Alkmaar,1,5,2,0,3,6,-4,4.0,8.0
6350,1980-1981,29,Willem II,FC Den Haag,2,1,1,3,0,3,1,10.0,3.0
6351,1980-1981,30,AZ '67 Alkmaar,Willem II,3,3,3,1,1,6,0,8.0,10.0
6352,1980-1981,30,FC Den Haag,FC Utrecht,1,3,2,0,3,4,-2,3.0,11.0
6353,1980-1981,30,NEC Nijmegen,FC Twente,0,2,2,0,3,2,-2,6.0,13.0
6354,1980-1981,30,PEC Zwolle,Feyenoord,2,2,3,1,1,4,0,1.0,5.0
6355,1980-1981,30,PSV,FC Wageningen,4,0,1,3,0,4,4,11.0,4.0
6356,1980-1981,30,AFC Ajax,MVV Maastricht,6,1,1,3,0,7,5,13.0,7.0
6357,1980-1981,30,SBV Excelsior,Roda JC Kerkrade,1,0,1,3,0,1,1,4.0,3.0
6358,1980-1981,30,FC Groningen,Go Ahead Eagles,3,1,1,3,0,4,2,4.0,7.0
6359,1980-1981,30,Sparta Rotterdam,NAC Breda,3,3,3,1,1,6,0,8.0,5.0
6360,1980-1981,31,FC Wageningen,SBV Excelsior,0,0,3,1,1,0,0,2.0,5.0
6361,1980-1981,31,Go Ahead Eagles,FC Den Haag,3,3,3,1,1,6,0,8.0,4.0
6362,1980-1981,31,MVV Maastricht,Sparta Rotterdam,3,3,3,1,1,6,0,5.0,6.0
6363,1980-1981,31,NAC Breda,PSV,0,2,2,0,3,2,-2,5.0,11.0
6364,1980-1981,31,Roda JC Kerkrade,FC Groningen,4,2,1,3,0,6,2,6.0,4.0
6365,1980-1981,31,FC Twente,AFC Ajax,3,0,1,3,0,3,3,13.0,10.0
6366,1980-1981,31,FC Utrecht,AZ '67 Alkmaar,2,2,3,1,1,4,0,9.0,9.0
6367,1980-1981,31,Feyenoord,NEC Nijmegen,1,1,3,1,1,2,0,3.0,4.0
6368,1980-1981,31,Willem II,PEC Zwolle,2,5,2,0,3,7,-3,10.0,4.0
6369,1980-1981,32,AZ '67 Alkmaar,Go Ahead Eagles,4,1,1,3,0,5,3,9.0,5.0
6370,1980-1981,32,FC Den Haag,Roda JC Kerkrade,4,4,3,1,1,8,0,5.0,4.0
6371,1980-1981,32,MVV Maastricht,FC Twente,1,0,1,3,0,1,1,8.0,10.0
6372,1980-1981,32,NEC Nijmegen,Willem II,4,0,1,3,0,4,4,6.0,7.0
6373,1980-1981,32,PEC Zwolle,FC Utrecht,0,3,2,0,3,3,-3,4.0,11.0
6374,1980-1981,32,AFC Ajax,Feyenoord,4,1,1,3,0,5,3,10.0,2.0
6375,1980-1981,32,SBV Excelsior,NAC Breda,1,2,2,0,3,3,-1,5.0,8.0
6376,1980-1981,32,FC Groningen,FC Wageningen,2,0,1,3,0,2,2,6.0,2.0
6377,1980-1981,32,Sparta Rotterdam,PSV,3,0,1,3,0,3,3,8.0,10.0
6378,1980-1981,33,FC Twente,Sparta Rotterdam,0,3,2,0,3,3,-3,9.0,8.0
6379,1980-1981,33,FC Utrecht,NEC Nijmegen,0,1,2,0,3,1,-1,10.0,8.0
6380,1980-1981,33,FC Wageningen,FC Den Haag,1,2,2,0,3,3,-1,2.0,5.0
6381,1980-1981,33,Feyenoord,MVV Maastricht,4,2,1,3,0,6,2,5.0,5.0
6382,1980-1981,33,Go Ahead Eagles,PEC Zwolle,3,3,3,1,1,6,0,5.0,5.0
6383,1980-1981,33,NAC Breda,FC Groningen,4,2,1,3,0,6,2,8.0,6.0
6384,1980-1981,33,PSV,SBV Excelsior,4,1,1,3,0,5,3,12.0,4.0
6385,1980-1981,33,Roda JC Kerkrade,AZ '67 Alkmaar,2,2,3,1,1,4,0,5.0,9.0
6386,1980-1981,33,Willem II,AFC Ajax,1,3,2,0,3,4,-2,4.0,12.0
6387,1980-1981,34,AFC Ajax,FC Utrecht,1,0,1,3,0,1,1,12.0,7.0
6388,1980-1981,34,AZ '67 Alkmaar,FC Wageningen,1,0,1,3,0,1,1,9.0,1.0
6389,1980-1981,34,FC Den Haag,NAC Breda,1,2,2,0,3,3,-1,5.0,10.0
6390,1980-1981,34,FC Groningen,PSV,2,0,1,3,0,2,2,9.0,9.0
6391,1980-1981,34,FC Twente,Feyenoord,3,7,2,0,3,10,-4,6.0,8.0
6392,1980-1981,34,MVV Maastricht,Willem II,2,2,3,1,1,4,0,5.0,2.0
6393,1980-1981,34,NEC Nijmegen,Go Ahead Eagles,2,3,2,0,3,5,-1,7.0,5.0
6394,1980-1981,34,PEC Zwolle,Roda JC Kerkrade,3,0,1,3,0,3,3,8.0,5.0
6395,1980-1981,34,Sparta Rotterdam,SBV Excelsior,5,2,1,3,0,7,3,11.0,4.0
6396,1981-1982,1,AZ '67 Alkmaar,NAC Breda,4,0,1,3,0,4,4,11.0,9.0
6397,1981-1982,1,SBV Haarlem,Sparta Rotterdam,0,0,3,1,1,0,0,,11.0
6398,1981-1982,1,MVV Maastricht,FC Twente,3,1,1,3,0,4,2,8.0,3.0
6399,1981-1982,1,NEC Nijmegen,FC Groningen,2,2,3,1,1,4,0,8.0,7.0
6400,1981-1982,1,PEC Zwolle,De Graafschap,3,1,1,3,0,4,2,10.0,3.0
6401,1981-1982,1,FC Utrecht,Go Ahead Eagles,2,0,1,3,0,2,2,7.0,5.0
6402,1981-1982,1,Feyenoord,FC Den Haag,2,1,1,3,0,3,1,10.0,5.0
6403,1981-1982,1,Roda JC Kerkrade,PSV,2,3,2,0,3,5,-1,5.0,9.0
6404,1981-1982,1,Willem II,AFC Ajax,1,7,2,0,3,8,-6,1.0,12.0
6405,1981-1982,2,AFC Ajax,Feyenoord,1,1,3,1,1,2,0,13.0,10.0
6406,1981-1982,2,De Graafschap,Willem II,0,0,3,1,1,0,0,4.0,2.0
6407,1981-1982,2,FC Den Haag,NEC Nijmegen,0,1,2,0,3,1,-1,4.0,10.0
6408,1981-1982,2,FC Groningen,SBV Haarlem,1,1,3,1,1,2,0,8.0,
6409,1981-1982,2,FC Twente,PEC Zwolle,2,0,1,3,0,2,2,3.0,7.0
6410,1981-1982,2,Go Ahead Eagles,MVV Maastricht,4,1,1,3,0,5,3,7.0,7.0
6411,1981-1982,2,NAC Breda,Roda JC Kerkrade,3,1,1,3,0,4,2,12.0,2.0
6412,1981-1982,2,PSV,FC Utrecht,3,1,1,3,0,4,2,9.0,6.0
6413,1981-1982,2,Sparta Rotterdam,AZ '67 Alkmaar,2,2,3,1,1,4,0,11.0,11.0
6414,1981-1982,3,De Graafschap,FC Twente,1,6,2,0,3,7,-5,4.0,6.0
6415,1981-1982,3,FC Den Haag,Willem II,3,1,1,3,0,4,2,6.0,2.0
6416,1981-1982,3,Go Ahead Eagles,Roda JC Kerkrade,0,0,3,1,1,0,0,8.0,2.0
6417,1981-1982,3,NAC Breda,SBV Haarlem,2,0,1,3,0,2,2,12.0,
6418,1981-1982,3,PSV,AZ '67 Alkmaar,2,4,2,0,3,6,-2,9.0,11.0
6419,1981-1982,3,AFC Ajax,PEC Zwolle,5,1,1,3,0,6,4,13.0,7.0
6420,1981-1982,3,FC Groningen,Feyenoord,2,2,3,1,1,4,0,6.0,11.0
6421,1981-1982,3,FC Utrecht,MVV Maastricht,1,0,1,3,0,1,1,6.0,4.0
6422,1981-1982,3,Sparta Rotterdam,NEC Nijmegen,1,0,1,3,0,1,1,11.0,7.0
6423,1981-1982,4,AZ '67 Alkmaar,Go Ahead Eagles,1,3,2,0,3,4,-2,10.0,10.0
6424,1981-1982,4,FC Twente,AFC Ajax,2,1,1,3,0,3,1,9.0,10.0
6425,1981-1982,4,Feyenoord,Sparta Rotterdam,2,4,2,0,3,6,-2,8.0,11.0
6426,1981-1982,4,SBV Haarlem,PSV,4,3,1,3,0,7,1,,6.0
6427,1981-1982,4,MVV Maastricht,De Graafschap,0,2,2,0,3,2,-2,4.0,7.0
6428,1981-1982,4,NEC Nijmegen,NAC Breda,1,1,3,1,1,2,0,5.0,10.0
6429,1981-1982,4,PEC Zwolle,FC Den Haag,2,2,3,1,1,4,0,7.0,4.0
6430,1981-1982,4,Roda JC Kerkrade,FC Utrecht,2,1,1,3,0,3,1,4.0,6.0
6431,1981-1982,4,Willem II,FC Groningen,1,1,3,1,1,2,0,3.0,7.0
6432,1981-1982,5,FC Den Haag,FC Twente,3,2,1,3,0,5,1,7.0,9.0
6433,1981-1982,5,FC Utrecht,AZ '67 Alkmaar,1,0,1,3,0,1,1,9.0,7.0
6434,1981-1982,5,Go Ahead Eagles,SBV Haarlem,3,1,1,3,0,4,2,10.0,5.0
6435,1981-1982,5,NAC Breda,Feyenoord,0,1,2,0,3,1,-1,7.0,8.0
6436,1981-1982,5,PSV,NEC Nijmegen,3,0,1,3,0,3,3,9.0,5.0
6437,1981-1982,5,AFC Ajax,De Graafschap,9,1,1,3,0,10,8,10.0,4.0
6438,1981-1982,5,FC Groningen,PEC Zwolle,6,2,1,3,0,8,4,7.0,4.0
6439,1981-1982,5,Roda JC Kerkrade,MVV Maastricht,2,2,3,1,1,4,0,5.0,4.0
6440,1981-1982,5,Sparta Rotterdam,Willem II,3,1,1,3,0,4,2,11.0,2.0
6441,1981-1982,6,AZ '67 Alkmaar,Roda JC Kerkrade,4,0,1,3,0,4,4,7.0,5.0
6442,1981-1982,6,De Graafschap,FC Den Haag,1,1,3,1,1,2,0,5.0,8.0
6443,1981-1982,6,FC Twente,FC Groningen,1,1,3,1,1,2,0,10.0,7.0
6444,1981-1982,6,Feyenoord,PSV,2,4,2,0,3,6,-2,5.0,9.0
6445,1981-1982,6,SBV Haarlem,FC Utrecht,2,0,1,3,0,2,2,7.0,6.0
6446,1981-1982,6,MVV Maastricht,AFC Ajax,0,2,2,0,3,2,-2,1.0,10.0
6447,1981-1982,6,NEC Nijmegen,Go Ahead Eagles,1,3,2,0,3,4,-2,4.0,13.0
6448,1981-1982,6,PEC Zwolle,Sparta Rotterdam,1,1,3,1,1,2,0,2.0,11.0
6449,1981-1982,6,Willem II,NAC Breda,2,1,1,3,0,3,1,5.0,7.0
6450,1981-1982,7,AZ '67 Alkmaar,MVV Maastricht,4,1,1,3,0,5,3,9.0,1.0
6451,1981-1982,7,FC Den Haag,AFC Ajax,1,3,2,0,3,4,-2,8.0,12.0
6452,1981-1982,7,Go Ahead Eagles,Feyenoord,3,2,1,3,0,5,1,13.0,4.0
6453,1981-1982,7,NAC Breda,PEC Zwolle,4,0,1,3,0,4,4,7.0,2.0
6454,1981-1982,7,PSV,Willem II,4,0,1,3,0,4,4,9.0,4.0
6455,1981-1982,7,FC Groningen,De Graafschap,3,2,1,3,0,5,1,9.0,4.0
6456,1981-1982,7,FC Utrecht,NEC Nijmegen,1,0,1,3,0,1,1,9.0,1.0
6457,1981-1982,7,Roda JC Kerkrade,SBV Haarlem,2,0,1,3,0,2,2,8.0,6.0
6458,1981-1982,7,Sparta Rotterdam,FC Twente,1,2,2,0,3,3,-1,10.0,10.0
6459,1981-1982,8,AFC Ajax,FC Groningen,6,1,1,3,0,7,5,12.0,8.0
6460,1981-1982,8,De Graafschap,Sparta Rotterdam,1,4,2,0,3,5,-3,4.0,10.0
6461,1981-1982,8,FC Twente,NAC Breda,0,1,2,0,3,1,-1,7.0,7.0
6462,1981-1982,8,Feyenoord,FC Utrecht,1,0,1,3,0,1,1,6.0,6.0
6463,1981-1982,8,SBV Haarlem,AZ '67 Alkmaar,0,0,3,1,1,0,0,7.0,7.0
6464,1981-1982,8,MVV Maastricht,FC Den Haag,1,0,1,3,0,1,1,4.0,5.0
6465,1981-1982,8,NEC Nijmegen,Roda JC Kerkrade,2,1,1,3,0,3,1,4.0,7.0
6466,1981-1982,8,PEC Zwolle,PSV,0,1,2,0,3,1,-1,2.0,12.0
6467,1981-1982,8,Willem II,Go Ahead Eagles,3,2,1,3,0,5,1,7.0,12.0
6468,1981-1982,9,AZ '67 Alkmaar,NEC Nijmegen,4,2,1,3,0,6,2,10.0,3.0
6469,1981-1982,9,Go Ahead Eagles,PEC Zwolle,2,2,3,1,1,4,0,10.0,2.0
6470,1981-1982,9,SBV Haarlem,MVV Maastricht,3,2,1,3,0,5,1,7.0,4.0
6471,1981-1982,9,NAC Breda,De Graafschap,5,1,1,3,0,6,4,9.0,1.0
6472,1981-1982,9,PSV,FC Twente,4,0,1,3,0,4,4,15.0,4.0
6473,1981-1982,9,FC Groningen,FC Den Haag,4,2,1,3,0,6,2,10.0,4.0
6474,1981-1982,9,FC Utrecht,Willem II,5,2,1,3,0,7,3,9.0,6.0
6475,1981-1982,9,Roda JC Kerkrade,Feyenoord,2,2,3,1,1,4,0,5.0,7.0
6476,1981-1982,9,Sparta Rotterdam,AFC Ajax,5,3,1,3,0,8,2,10.0,12.0
6477,1981-1982,10,De Graafschap,PSV,1,2,2,0,3,3,-1,1.0,15.0
6478,1981-1982,10,FC Den Haag,Sparta Rotterdam,1,2,2,0,3,3,-1,1.0,10.0
6479,1981-1982,10,FC Twente,Go Ahead Eagles,1,0,1,3,0,1,1,7.0,7.0
6480,1981-1982,10,MVV Maastricht,FC Groningen,3,1,1,3,0,4,2,6.0,7.0
6481,1981-1982,10,NEC Nijmegen,SBV Haarlem,1,1,3,1,1,2,0,4.0,8.0
6482,1981-1982,10,PEC Zwolle,FC Utrecht,1,1,3,1,1,2,0,3.0,7.0
6483,1981-1982,10,AFC Ajax,NAC Breda,2,2,3,1,1,4,0,10.0,10.0
6484,1981-1982,10,Feyenoord,AZ '67 Alkmaar,4,2,1,3,0,6,2,7.0,10.0
6485,1981-1982,10,Willem II,Roda JC Kerkrade,1,2,2,0,3,3,-1,6.0,7.0
6486,1981-1982,11,AZ '67 Alkmaar,Willem II,2,0,1,3,0,2,2,10.0,3.0
6487,1981-1982,11,Go Ahead Eagles,De Graafschap,1,0,1,3,0,1,1,7.0,0.0
6488,1981-1982,11,SBV Haarlem,Feyenoord,1,1,3,1,1,2,0,6.0,8.0
6489,1981-1982,11,NAC Breda,FC Den Haag,5,0,1,3,0,5,5,13.0,0.0
6490,1981-1982,11,NEC Nijmegen,MVV Maastricht,2,1,1,3,0,3,1,7.0,6.0
6491,1981-1982,11,PSV,AFC Ajax,3,0,1,3,0,3,3,15.0,7.0
6492,1981-1982,11,FC Utrecht,FC Twente,4,2,1,3,0,6,2,10.0,6.0
6493,1981-1982,11,Roda JC Kerkrade,PEC Zwolle,4,1,1,3,0,5,3,10.0,2.0
6494,1981-1982,11,Sparta Rotterdam,FC Groningen,4,0,1,3,0,4,4,12.0,6.0
6495,1981-1982,12,De Graafschap,FC Utrecht,0,3,2,0,3,3,-3,0.0,10.0
6496,1981-1982,12,FC Den Haag,PSV,0,0,3,1,1,0,0,1.0,13.0
6497,1981-1982,12,FC Twente,Roda JC Kerkrade,1,3,2,0,3,4,-2,3.0,10.0
6498,1981-1982,12,MVV Maastricht,Sparta Rotterdam,2,1,1,3,0,3,1,9.0,12.0
6499,1981-1982,12,PEC Zwolle,AZ '67 Alkmaar,0,0,3,1,1,0,0,3.0,8.0
6500,1981-1982,12,AFC Ajax,Go Ahead Eagles,4,1,1,3,0,5,3,7.0,4.0
6501,1981-1982,12,FC Groningen,NAC Breda,1,1,3,1,1,2,0,4.0,11.0
6502,1981-1982,12,Feyenoord,NEC Nijmegen,2,2,3,1,1,4,0,9.0,8.0
6503,1981-1982,12,Willem II,SBV Haarlem,2,2,3,1,1,4,0,4.0,7.0
6504,1981-1982,13,AZ '67 Alkmaar,FC Twente,2,1,1,3,0,3,1,10.0,3.0
6505,1981-1982,13,FC Utrecht,AFC Ajax,3,5,2,0,3,8,-2,10.0,7.0
6506,1981-1982,13,Feyenoord,MVV Maastricht,6,1,1,3,0,7,5,9.0,6.0
6507,1981-1982,13,Go Ahead Eagles,FC Den Haag,3,0,1,3,0,3,3,7.0,1.0
6508,1981-1982,13,SBV Haarlem,PEC Zwolle,2,1,1,3,0,3,1,9.0,3.0
6509,1981-1982,13,NAC Breda,Sparta Rotterdam,0,2,2,0,3,2,-2,8.0,12.0
6510,1981-1982,13,NEC Nijmegen,Willem II,0,4,2,0,3,4,-4,5.0,4.0
6511,1981-1982,13,PSV,FC Groningen,2,0,1,3,0,2,2,13.0,4.0
6512,1981-1982,13,Roda JC Kerkrade,De Graafschap,0,1,2,0,3,1,-1,10.0,3.0
6513,1981-1982,14,MVV Maastricht,NAC Breda,1,1,3,1,1,2,0,7.0,6.0
6514,1981-1982,14,PEC Zwolle,NEC Nijmegen,1,0,1,3,0,1,1,5.0,5.0
6515,1981-1982,14,AFC Ajax,Roda JC Kerkrade,3,2,1,3,0,5,1,10.0,9.0
6516,1981-1982,14,De Graafschap,AZ '67 Alkmaar,0,3,2,0,3,3,-3,3.0,10.0
6517,1981-1982,14,FC Groningen,Go Ahead Eagles,2,2,3,1,1,4,0,2.0,7.0
6518,1981-1982,14,FC Twente,SBV Haarlem,0,2,2,0,3,2,-2,3.0,9.0
6519,1981-1982,14,Sparta Rotterdam,PSV,0,2,2,0,3,2,-2,9.0,13.0
6520,1981-1982,14,Willem II,Feyenoord,0,1,2,0,3,1,-1,4.0,11.0
6521,1981-1982,14,FC Den Haag,FC Utrecht,0,1,2,0,3,1,-1,1.0,10.0
6522,1981-1982,15,AZ '67 Alkmaar,AFC Ajax,1,0,1,3,0,1,1,13.0,9.0
6523,1981-1982,15,Go Ahead Eagles,Sparta Rotterdam,0,0,3,1,1,0,0,8.0,7.0
6524,1981-1982,15,PSV,NAC Breda,4,1,1,3,0,5,3,13.0,5.0
6525,1981-1982,15,Feyenoord,PEC Zwolle,5,5,3,1,1,10,0,9.0,5.0
6526,1981-1982,15,SBV Haarlem,De Graafschap,3,0,1,3,0,3,3,11.0,3.0
6527,1981-1982,15,NEC Nijmegen,FC Twente,2,1,1,3,0,3,1,7.0,0.0
6528,1981-1982,15,Roda JC Kerkrade,FC Den Haag,3,2,1,3,0,5,1,9.0,1.0
6529,1981-1982,15,Willem II,MVV Maastricht,1,2,2,0,3,3,-1,4.0,7.0
6530,1981-1982,15,FC Utrecht,FC Groningen,1,0,1,3,0,1,1,12.0,2.0
6531,1981-1982,16,NEC Nijmegen,AFC Ajax,1,3,2,0,3,4,-2,4.0,12.0
6532,1981-1982,16,Roda JC Kerkrade,Sparta Rotterdam,2,0,1,3,0,2,2,9.0,4.0
6533,1981-1982,16,Willem II,FC Twente,0,2,2,0,3,2,-2,4.0,3.0
6534,1981-1982,16,Go Ahead Eagles,PSV,1,2,2,0,3,3,-1,5.0,13.0
6535,1981-1982,16,FC Utrecht,NAC Breda,2,2,3,1,1,4,0,10.0,3.0
6536,1981-1982,16,Feyenoord,De Graafschap,1,0,1,3,0,1,1,11.0,3.0
6537,1981-1982,16,SBV Haarlem,FC Den Haag,1,1,3,1,1,2,0,11.0,2.0
6538,1981-1982,16,AZ '67 Alkmaar,FC Groningen,3,1,1,3,0,4,2,13.0,2.0
6539,1981-1982,16,MVV Maastricht,PEC Zwolle,0,1,2,0,3,1,-1,7.0,8.0
6540,1981-1982,17,AFC Ajax,SBV Haarlem,4,1,1,3,0,5,3,12.0,10.0
6541,1981-1982,17,FC Den Haag,AZ '67 Alkmaar,1,4,2,0,3,5,-3,1.0,15.0
6542,1981-1982,17,FC Groningen,Roda JC Kerkrade,2,2,3,1,1,4,0,2.0,7.0
6543,1981-1982,17,PEC Zwolle,Willem II,1,5,2,0,3,6,-4,7.0,6.0
6544,1981-1982,17,PSV,MVV Maastricht,2,2,3,1,1,4,0,13.0,5.0
6545,1981-1982,17,NAC Breda,Go Ahead Eagles,1,0,1,3,0,1,1,5.0,5.0
6546,1981-1982,17,De Graafschap,NEC Nijmegen,1,2,2,0,3,3,-1,3.0,6.0
6547,1981-1982,17,FC Twente,Feyenoord,4,0,1,3,0,4,4,6.0,10.0
6548,1981-1982,17,Sparta Rotterdam,FC Utrecht,2,2,3,1,1,4,0,5.0,8.0
6549,1981-1982,18,Go Ahead Eagles,FC Utrecht,2,3,2,0,3,5,-1,2.0,11.0
6550,1981-1982,18,NAC Breda,AZ '67 Alkmaar,0,1,2,0,3,1,-1,5.0,15.0
6551,1981-1982,18,PSV,Roda JC Kerkrade,3,1,1,3,0,4,2,13.0,7.0
6552,1981-1982,18,AFC Ajax,Willem II,4,1,1,3,0,5,3,12.0,3.0
6553,1981-1982,18,De Graafschap,PEC Zwolle,2,0,1,3,0,2,2,3.0,7.0
6554,1981-1982,18,FC Den Haag,Feyenoord,1,2,2,0,3,3,-1,1.0,10.0
6555,1981-1982,18,FC Groningen,NEC Nijmegen,2,0,1,3,0,2,2,5.0,6.0
6556,1981-1982,18,FC Twente,MVV Maastricht,2,2,3,1,1,4,0,7.0,6.0
6557,1981-1982,18,Sparta Rotterdam,SBV Haarlem,0,3,2,0,3,3,-3,2.0,10.0
6558,1981-1982,19,MVV Maastricht,Go Ahead Eagles,1,1,3,1,1,2,0,6.0,2.0
6559,1981-1982,19,PEC Zwolle,FC Twente,5,1,1,3,0,6,4,7.0,7.0
6560,1981-1982,19,AZ '67 Alkmaar,Sparta Rotterdam,2,2,3,1,1,4,0,13.0,3.0
6561,1981-1982,19,FC Utrecht,PSV,2,1,1,3,0,3,1,11.0,10.0
6562,1981-1982,19,Feyenoord,AFC Ajax,2,2,3,1,1,4,0,8.0,10.0
6563,1981-1982,19,SBV Haarlem,FC Groningen,1,2,2,0,3,3,-1,7.0,7.0
6564,1981-1982,19,NEC Nijmegen,FC Den Haag,2,1,1,3,0,3,1,9.0,1.0
6565,1981-1982,19,Roda JC Kerkrade,NAC Breda,1,0,1,3,0,1,1,10.0,4.0
6566,1981-1982,19,Willem II,De Graafschap,2,2,3,1,1,4,0,4.0,4.0
6567,1981-1982,20,AZ '67 Alkmaar,PSV,0,2,2,0,3,2,-2,10.0,10.0
6568,1981-1982,20,MVV Maastricht,FC Utrecht,0,3,2,0,3,3,-3,3.0,11.0
6569,1981-1982,20,PEC Zwolle,AFC Ajax,1,3,2,0,3,4,-2,6.0,13.0
6570,1981-1982,20,FC Twente,De Graafschap,4,0,1,3,0,4,4,10.0,4.0
6571,1981-1982,20,Feyenoord,FC Groningen,3,2,1,3,0,5,1,10.0,7.0
6572,1981-1982,20,SBV Haarlem,NAC Breda,4,2,1,3,0,6,2,7.0,4.0
6573,1981-1982,20,NEC Nijmegen,Sparta Rotterdam,3,3,3,1,1,6,0,7.0,3.0
6574,1981-1982,20,Roda JC Kerkrade,Go Ahead Eagles,2,3,2,0,3,5,-1,7.0,4.0
6575,1981-1982,20,Willem II,FC Den Haag,1,0,1,3,0,1,1,7.0,1.0
6576,1981-1982,21,Go Ahead Eagles,AZ '67 Alkmaar,4,1,1,3,0,5,3,7.0,7.0
6577,1981-1982,21,NAC Breda,NEC Nijmegen,1,0,1,3,0,1,1,6.0,7.0
6578,1981-1982,21,PSV,SBV Haarlem,3,0,1,3,0,3,3,10.0,6.0
6579,1981-1982,21,AFC Ajax,FC Twente,5,1,1,3,0,6,4,13.0,7.0
6580,1981-1982,21,De Graafschap,MVV Maastricht,2,2,3,1,1,4,0,5.0,4.0
6581,1981-1982,21,FC Den Haag,PEC Zwolle,2,1,1,3,0,3,1,3.0,3.0
6582,1981-1982,21,FC Groningen,Willem II,2,1,1,3,0,3,1,10.0,7.0
6583,1981-1982,21,FC Utrecht,Roda JC Kerkrade,0,0,3,1,1,0,0,11.0,5.0
6584,1981-1982,21,Sparta Rotterdam,Feyenoord,1,1,3,1,1,2,0,4.0,8.0
6585,1981-1982,22,AZ '67 Alkmaar,FC Utrecht,2,1,1,3,0,3,1,7.0,10.0
6586,1981-1982,22,De Graafschap,AFC Ajax,1,4,2,0,3,5,-3,5.0,13.0
6587,1981-1982,22,FC Twente,FC Den Haag,2,0,1,3,0,2,2,7.0,3.0
6588,1981-1982,22,SBV Haarlem,Go Ahead Eagles,3,1,1,3,0,4,2,9.0,7.0
6589,1981-1982,22,MVV Maastricht,Roda JC Kerkrade,1,2,2,0,3,3,-1,3.0,7.0
6590,1981-1982,22,NEC Nijmegen,PSV,0,4,2,0,3,4,-4,4.0,12.0
6591,1981-1982,22,PEC Zwolle,FC Groningen,0,4,2,0,3,4,-4,3.0,12.0
6592,1981-1982,22,Feyenoord,NAC Breda,0,0,3,1,1,0,0,9.0,4.0
6593,1981-1982,22,Willem II,Sparta Rotterdam,2,1,1,3,0,3,1,7.0,3.0
6594,1981-1982,23,FC Den Haag,De Graafschap,2,1,1,3,0,3,1,6.0,2.0
6595,1981-1982,23,Go Ahead Eagles,NEC Nijmegen,0,0,3,1,1,0,0,8.0,5.0
6596,1981-1982,23,NAC Breda,Willem II,1,4,2,0,3,5,-3,4.0,10.0
6597,1981-1982,23,PSV,Feyenoord,1,2,2,0,3,3,-1,9.0,9.0
6598,1981-1982,23,AFC Ajax,MVV Maastricht,2,0,1,3,0,2,2,13.0,2.0
6599,1981-1982,23,FC Groningen,FC Twente,3,0,1,3,0,3,3,12.0,6.0
6600,1981-1982,23,FC Utrecht,SBV Haarlem,2,0,1,3,0,2,2,10.0,6.0
6601,1981-1982,23,Roda JC Kerkrade,AZ '67 Alkmaar,1,2,2,0,3,3,-1,7.0,7.0
6602,1981-1982,23,Sparta Rotterdam,PEC Zwolle,1,1,3,1,1,2,0,4.0,4.0
6603,1981-1982,24,De Graafschap,FC Groningen,1,3,2,0,3,4,-2,1.0,12.0
6604,1981-1982,24,FC Twente,Sparta Rotterdam,1,0,1,3,0,1,1,9.0,3.0
6605,1981-1982,24,SBV Haarlem,Roda JC Kerkrade,1,0,1,3,0,1,1,9.0,4.0
6606,1981-1982,24,MVV Maastricht,AZ '67 Alkmaar,0,4,2,0,3,4,-4,1.0,9.0
6607,1981-1982,24,NEC Nijmegen,FC Utrecht,1,0,1,3,0,1,1,5.0,7.0
6608,1981-1982,24,PEC Zwolle,NAC Breda,1,2,2,0,3,3,-1,1.0,7.0
6609,1981-1982,24,AFC Ajax,FC Den Haag,9,1,1,3,0,10,8,15.0,6.0
6610,1981-1982,24,Feyenoord,Go Ahead Eagles,2,0,1,3,0,2,2,11.0,7.0
6611,1981-1982,24,Willem II,PSV,0,1,2,0,3,1,-1,9.0,12.0
6612,1981-1982,25,AZ '67 Alkmaar,SBV Haarlem,0,1,2,0,3,1,-1,9.0,9.0
6613,1981-1982,25,FC Den Haag,MVV Maastricht,0,0,3,1,1,0,0,7.0,2.0
6614,1981-1982,25,Go Ahead Eagles,Willem II,1,1,3,1,1,2,0,5.0,7.0
6615,1981-1982,25,NAC Breda,FC Twente,0,0,3,1,1,0,0,8.0,7.0
6616,1981-1982,25,PSV,PEC Zwolle,1,1,3,1,1,2,0,10.0,2.0
6617,1981-1982,25,FC Groningen,AFC Ajax,2,3,2,0,3,5,-1,12.0,15.0
6618,1981-1982,25,FC Utrecht,Feyenoord,2,1,1,3,0,3,1,7.0,8.0
6619,1981-1982,25,Roda JC Kerkrade,NEC Nijmegen,4,1,1,3,0,5,3,7.0,4.0
6620,1981-1982,25,Sparta Rotterdam,De Graafschap,4,0,1,3,0,4,4,5.0,1.0
6621,1981-1982,26,AFC Ajax,Sparta Rotterdam,5,1,1,3,0,6,4,15.0,4.0
6622,1981-1982,26,De Graafschap,NAC Breda,0,0,3,1,1,0,0,1.0,6.0
6623,1981-1982,26,FC Twente,PSV,2,3,2,0,3,5,-1,7.0,10.0
6624,1981-1982,26,Feyenoord,Roda JC Kerkrade,1,0,1,3,0,1,1,10.0,6.0
6625,1981-1982,26,MVV Maastricht,SBV Haarlem,2,1,1,3,0,3,1,4.0,9.0
6626,1981-1982,26,NEC Nijmegen,AZ '67 Alkmaar,0,3,2,0,3,3,-3,4.0,12.0
6627,1981-1982,26,PEC Zwolle,Go Ahead Eagles,3,0,1,3,0,3,3,5.0,2.0
6628,1981-1982,26,Willem II,FC Utrecht,3,0,1,3,0,3,3,10.0,6.0
6629,1981-1982,26,FC Den Haag,FC Groningen,0,1,2,0,3,1,-1,4.0,12.0
6630,1981-1982,27,AZ '67 Alkmaar,Feyenoord,1,0,1,3,0,1,1,12.0,9.0
6631,1981-1982,27,FC Groningen,MVV Maastricht,3,0,1,3,0,3,3,12.0,4.0
6632,1981-1982,27,FC Utrecht,PEC Zwolle,3,0,1,3,0,3,3,9.0,5.0
6633,1981-1982,27,Go Ahead Eagles,FC Twente,0,0,3,1,1,0,0,3.0,5.0
6634,1981-1982,27,SBV Haarlem,NEC Nijmegen,4,0,1,3,0,4,4,9.0,4.0
6635,1981-1982,27,NAC Breda,AFC Ajax,0,4,2,0,3,4,-4,5.0,15.0
6636,1981-1982,27,PSV,De Graafschap,4,0,1,3,0,4,4,10.0,1.0
6637,1981-1982,27,Sparta Rotterdam,FC Den Haag,2,1,1,3,0,3,1,7.0,4.0
6638,1981-1982,27,Roda JC Kerkrade,Willem II,1,2,2,0,3,3,-1,3.0,10.0
6639,1981-1982,28,De Graafschap,Go Ahead Eagles,1,4,2,0,3,5,-3,1.0,5.0
6640,1981-1982,28,FC Den Haag,NAC Breda,0,2,2,0,3,2,-2,1.0,8.0
6641,1981-1982,28,FC Groningen,Sparta Rotterdam,2,1,1,3,0,3,1,12.0,6.0
6642,1981-1982,28,MVV Maastricht,NEC Nijmegen,1,1,3,1,1,2,0,5.0,4.0
6643,1981-1982,28,PEC Zwolle,Roda JC Kerkrade,3,1,1,3,0,4,2,7.0,3.0
6644,1981-1982,28,AFC Ajax,PSV,3,0,1,3,0,3,3,15.0,10.0
6645,1981-1982,28,FC Twente,FC Utrecht,2,1,1,3,0,3,1,8.0,6.0
6646,1981-1982,28,Feyenoord,SBV Haarlem,1,3,2,0,3,4,-2,6.0,12.0
6647,1981-1982,28,Willem II,AZ '67 Alkmaar,2,3,2,0,3,5,-1,7.0,12.0
6648,1981-1982,29,AZ '67 Alkmaar,PEC Zwolle,1,1,3,1,1,2,0,10.0,8.0
6649,1981-1982,29,Go Ahead Eagles,AFC Ajax,1,2,2,0,3,3,-1,5.0,15.0
6650,1981-1982,29,SBV Haarlem,Willem II,2,1,1,3,0,3,1,12.0,7.0
6651,1981-1982,29,NAC Breda,FC Groningen,0,4,2,0,3,4,-4,5.0,12.0
6652,1981-1982,29,NEC Nijmegen,Feyenoord,5,1,1,3,0,6,4,4.0,3.0
6653,1981-1982,29,PSV,FC Den Haag,1,0,1,3,0,1,1,10.0,1.0
6654,1981-1982,29,FC Utrecht,De Graafschap,5,0,1,3,0,5,5,9.0,1.0
6655,1981-1982,29,Roda JC Kerkrade,FC Twente,3,0,1,3,0,3,3,6.0,5.0
6656,1981-1982,29,Sparta Rotterdam,MVV Maastricht,4,1,1,3,0,5,3,9.0,5.0
6657,1981-1982,30,De Graafschap,Roda JC Kerkrade,2,4,2,0,3,6,-2,1.0,6.0
6658,1981-1982,30,FC Den Haag,Go Ahead Eagles,0,6,2,0,3,6,-6,0.0,7.0
6659,1981-1982,30,FC Twente,AZ '67 Alkmaar,2,0,1,3,0,2,2,7.0,10.0
6660,1981-1982,30,MVV Maastricht,Feyenoord,1,1,3,1,1,2,0,5.0,4.0
6661,1981-1982,30,PEC Zwolle,SBV Haarlem,0,0,3,1,1,0,0,8.0,10.0
6662,1981-1982,30,AFC Ajax,FC Utrecht,1,0,1,3,0,1,1,15.0,6.0
6663,1981-1982,30,FC Groningen,PSV,4,0,1,3,0,4,4,15.0,9.0
6664,1981-1982,30,Sparta Rotterdam,NAC Breda,5,0,1,3,0,5,5,9.0,4.0
6665,1981-1982,30,Willem II,NEC Nijmegen,2,2,3,1,1,4,0,7.0,5.0
6666,1981-1982,31,AZ '67 Alkmaar,De Graafschap,4,0,1,3,0,4,4,10.0,0.0
6667,1981-1982,31,Go Ahead Eagles,FC Groningen,3,1,1,3,0,4,2,10.0,12.0
6668,1981-1982,31,SBV Haarlem,FC Twente,3,0,1,3,0,3,3,13.0,7.0
6669,1981-1982,31,NEC Nijmegen,PEC Zwolle,3,1,1,3,0,4,2,8.0,5.0
6670,1981-1982,31,PSV,Sparta Rotterdam,2,1,1,3,0,3,1,9.0,9.0
6671,1981-1982,31,FC Utrecht,FC Den Haag,4,0,1,3,0,4,4,9.0,0.0
6672,1981-1982,31,Feyenoord,Willem II,2,0,1,3,0,2,2,4.0,4.0
6673,1981-1982,31,NAC Breda,MVV Maastricht,0,0,3,1,1,0,0,4.0,3.0
6674,1981-1982,31,Roda JC Kerkrade,AFC Ajax,1,1,3,1,1,2,0,7.0,13.0
6675,1981-1982,32,AFC Ajax,AZ '67 Alkmaar,3,2,1,3,0,5,1,13.0,7.0
6676,1981-1982,32,De Graafschap,SBV Haarlem,1,2,2,0,3,3,-1,0.0,13.0
6677,1981-1982,32,FC Den Haag,Roda JC Kerkrade,1,3,2,0,3,4,-2,0.0,10.0
6678,1981-1982,32,FC Groningen,FC Utrecht,1,1,3,1,1,2,0,10.0,7.0
6679,1981-1982,32,FC Twente,NEC Nijmegen,0,2,2,0,3,2,-2,6.0,11.0
6680,1981-1982,32,MVV Maastricht,Willem II,1,1,3,1,1,2,0,4.0,2.0
6681,1981-1982,32,NAC Breda,PSV,2,0,1,3,0,2,2,7.0,6.0
6682,1981-1982,32,PEC Zwolle,Feyenoord,2,1,1,3,0,3,1,8.0,4.0
6683,1981-1982,32,Sparta Rotterdam,Go Ahead Eagles,1,1,3,1,1,2,0,7.0,10.0
6684,1981-1982,33,AFC Ajax,NEC Nijmegen,5,0,1,3,0,5,5,13.0,10.0
6685,1981-1982,33,De Graafschap,Feyenoord,3,3,3,1,1,6,0,1.0,5.0
6686,1981-1982,33,FC Den Haag,SBV Haarlem,0,4,2,0,3,4,-4,0.0,13.0
6687,1981-1982,33,FC Groningen,AZ '67 Alkmaar,1,3,2,0,3,4,-2,7.0,7.0
6688,1981-1982,33,FC Twente,Willem II,2,0,1,3,0,2,2,6.0,2.0
6689,1981-1982,33,NAC Breda,FC Utrecht,1,0,1,3,0,1,1,7.0,7.0
6690,1981-1982,33,PEC Zwolle,MVV Maastricht,2,0,1,3,0,2,2,8.0,3.0
6691,1981-1982,33,PSV,Go Ahead Eagles,4,1,1,3,0,5,3,9.0,7.0
6692,1981-1982,33,Sparta Rotterdam,Roda JC Kerkrade,1,2,2,0,3,3,-1,7.0,13.0
6693,1981-1982,34,AZ '67 Alkmaar,FC Den Haag,5,2,1,3,0,7,3,9.0,0.0
6694,1981-1982,34,FC Utrecht,Sparta Rotterdam,0,1,2,0,3,1,-1,4.0,7.0
6695,1981-1982,34,Feyenoord,FC Twente,3,3,3,1,1,6,0,6.0,7.0
6696,1981-1982,34,Go Ahead Eagles,NAC Breda,2,1,1,3,0,3,1,10.0,7.0
6697,1981-1982,34,SBV Haarlem,AFC Ajax,1,3,2,0,3,4,-2,10.0,13.0
6698,1981-1982,34,MVV Maastricht,PSV,1,7,2,0,3,8,-6,3.0,9.0
6699,1981-1982,34,NEC Nijmegen,De Graafschap,2,0,1,3,0,2,2,10.0,1.0
6700,1981-1982,34,Roda JC Kerkrade,FC Groningen,4,3,1,3,0,7,1,13.0,4.0
6701,1981-1982,34,Willem II,PEC Zwolle,3,1,1,3,0,4,2,5.0,7.0
6702,1982-1983,1,FC Twente,Roda JC Kerkrade,0,3,2,0,3,3,-3,4.0,13.0
6703,1982-1983,1,SBV Haarlem,Fortuna Sittard,0,0,3,1,1,0,0,10.0,
6704,1982-1983,1,NAC Breda,Helmond Sport,4,2,1,3,0,6,2,10.0,
6705,1982-1983,1,NEC Nijmegen,AZ '67 Alkmaar,2,0,1,3,0,2,2,12.0,9.0
6706,1982-1983,1,PEC Zwolle '82,FC Groningen,1,3,2,0,3,4,-2,,4.0
6707,1982-1983,1,PSV,Willem II,2,0,1,3,0,2,2,12.0,4.0
6708,1982-1983,1,Sparta Rotterdam,FC Utrecht,2,1,1,3,0,3,1,7.0,4.0
6709,1982-1983,1,AFC Ajax,Go Ahead Eagles,4,1,1,3,0,5,3,13.0,7.0
6710,1982-1983,1,SBV Excelsior,Feyenoord,2,3,2,0,3,5,-1,1.0,8.0
6711,1982-1983,2,AZ '67 Alkmaar,FC Twente,3,2,1,3,0,5,1,9.0,4.0
6712,1982-1983,2,FC Groningen,AFC Ajax,2,1,1,3,0,3,1,7.0,12.0
6713,1982-1983,2,FC Utrecht,PSV,0,1,2,0,3,1,-1,1.0,12.0
6714,1982-1983,2,Feyenoord,Sparta Rotterdam,3,1,1,3,0,4,2,8.0,7.0
6715,1982-1983,2,Fortuna Sittard,NAC Breda,1,0,1,3,0,1,1,,9.0
6716,1982-1983,2,Go Ahead Eagles,SBV Haarlem,2,3,2,0,3,5,-1,4.0,10.0
6717,1982-1983,2,Helmond Sport,SBV Excelsior,1,4,2,0,3,5,-3,,3.0
6718,1982-1983,2,Roda JC Kerkrade,PEC Zwolle '82,3,1,1,3,0,4,2,15.0,
6719,1982-1983,2,Willem II,NEC Nijmegen,4,0,1,3,0,4,4,7.0,9.0
6720,1982-1983,3,FC Twente,Willem II,0,0,3,1,1,0,0,5.0,7.0
6721,1982-1983,3,SBV Haarlem,AFC Ajax,0,2,2,0,3,2,-2,7.0,12.0
6722,1982-1983,3,NAC Breda,Go Ahead Eagles,0,0,3,1,1,0,0,7.0,4.0
6723,1982-1983,3,NEC Nijmegen,FC Utrecht,2,1,1,3,0,3,1,9.0,0.0
6724,1982-1983,3,PEC Zwolle '82,AZ '67 Alkmaar,0,2,2,0,3,2,-2,,12.0
6725,1982-1983,3,PSV,Feyenoord,1,3,2,0,3,4,-2,12.0,11.0
6726,1982-1983,3,SBV Excelsior,Fortuna Sittard,1,0,1,3,0,1,1,6.0,
6727,1982-1983,3,Roda JC Kerkrade,FC Groningen,5,1,1,3,0,6,4,15.0,6.0
6728,1982-1983,3,Sparta Rotterdam,Helmond Sport,1,2,2,0,3,3,-1,6.0,
6729,1982-1983,4,AFC Ajax,NAC Breda,4,1,1,3,0,5,3,12.0,4.0
6730,1982-1983,4,AZ '67 Alkmaar,Roda JC Kerkrade,1,2,2,0,3,3,-1,9.0,15.0
6731,1982-1983,4,Fortuna Sittard,Sparta Rotterdam,3,2,1,3,0,5,1,,6.0
6732,1982-1983,4,Go Ahead Eagles,SBV Excelsior,2,1,1,3,0,3,1,7.0,6.0
6733,1982-1983,4,Helmond Sport,PSV,2,5,2,0,3,7,-3,,12.0
6734,1982-1983,4,FC Groningen,SBV Haarlem,2,2,3,1,1,4,0,7.0,5.0
6735,1982-1983,4,FC Utrecht,FC Twente,3,2,1,3,0,5,1,3.0,2.0
6736,1982-1983,4,Feyenoord,NEC Nijmegen,1,0,1,3,0,1,1,13.0,9.0
6737,1982-1983,4,Willem II,PEC Zwolle '82,5,2,1,3,0,7,3,10.0,
6738,1982-1983,5,SBV Excelsior,AFC Ajax,0,3,2,0,3,3,-3,6.0,12.0
6739,1982-1983,5,AZ '67 Alkmaar,FC Groningen,0,0,3,1,1,0,0,7.0,8.0
6740,1982-1983,5,FC Twente,Feyenoord,1,1,3,1,1,2,0,2.0,13.0
6741,1982-1983,5,NAC Breda,SBV Haarlem,1,1,3,1,1,2,0,5.0,6.0
6742,1982-1983,5,NEC Nijmegen,Helmond Sport,1,1,3,1,1,2,0,7.0,4.0
6743,1982-1983,5,PEC Zwolle '82,FC Utrecht,1,1,3,1,1,2,0,1.0,4.0
6744,1982-1983,5,PSV,Fortuna Sittard,3,1,1,3,0,4,2,12.0,7.0
6745,1982-1983,5,Roda JC Kerkrade,Willem II,1,0,1,3,0,1,1,15.0,7.0
6746,1982-1983,5,Sparta Rotterdam,Go Ahead Eagles,2,2,3,1,1,4,0,4.0,5.0
6747,1982-1983,6,AFC Ajax,Sparta Rotterdam,1,1,3,1,1,2,0,10.0,2.0
6748,1982-1983,6,Fortuna Sittard,NEC Nijmegen,1,0,1,3,0,1,1,9.0,4.0
6749,1982-1983,6,Go Ahead Eagles,PSV,2,4,2,0,3,6,-2,5.0,12.0
6750,1982-1983,6,SBV Haarlem,SBV Excelsior,0,0,3,1,1,0,0,6.0,7.0
6751,1982-1983,6,Helmond Sport,FC Twente,0,0,3,1,1,0,0,5.0,3.0
6752,1982-1983,6,FC Groningen,NAC Breda,1,1,3,1,1,2,0,6.0,3.0
6753,1982-1983,6,FC Utrecht,Roda JC Kerkrade,3,2,1,3,0,5,1,7.0,12.0
6754,1982-1983,6,Feyenoord,PEC Zwolle '82,1,1,3,1,1,2,0,11.0,2.0
6755,1982-1983,6,Willem II,AZ '67 Alkmaar,0,3,2,0,3,3,-3,7.0,10.0
6756,1982-1983,7,AZ '67 Alkmaar,FC Utrecht,3,1,1,3,0,4,2,10.0,7.0
6757,1982-1983,7,FC Twente,Fortuna Sittard,2,1,1,3,0,3,1,6.0,6.0
6758,1982-1983,7,NEC Nijmegen,Go Ahead Eagles,1,1,3,1,1,2,0,5.0,6.0
6759,1982-1983,7,PEC Zwolle '82,Helmond Sport,2,2,3,1,1,4,0,3.0,6.0
6760,1982-1983,7,SBV Excelsior,NAC Breda,2,0,1,3,0,2,2,7.0,3.0
6761,1982-1983,7,Roda JC Kerkrade,Feyenoord,4,1,1,3,0,5,3,12.0,8.0
6762,1982-1983,7,Sparta Rotterdam,SBV Haarlem,5,1,1,3,0,6,4,5.0,3.0
6763,1982-1983,7,Willem II,FC Groningen,0,0,3,1,1,0,0,5.0,4.0
6764,1982-1983,7,PSV,AFC Ajax,4,0,1,3,0,4,4,12.0,10.0
6765,1982-1983,8,AFC Ajax,NEC Nijmegen,5,0,1,3,0,5,5,10.0,2.0
6766,1982-1983,8,Fortuna Sittard,PEC Zwolle '82,1,1,3,1,1,2,0,7.0,4.0
6767,1982-1983,8,Go Ahead Eagles,FC Twente,3,3,3,1,1,6,0,6.0,6.0
6768,1982-1983,8,SBV Haarlem,PSV,0,1,2,0,3,1,-1,3.0,15.0
6769,1982-1983,8,Helmond Sport,Roda JC Kerkrade,2,0,1,3,0,2,2,6.0,9.0
6770,1982-1983,8,NAC Breda,Sparta Rotterdam,1,2,2,0,3,3,-1,2.0,8.0
6771,1982-1983,8,FC Groningen,SBV Excelsior,1,1,3,1,1,2,0,5.0,5.0
6772,1982-1983,8,FC Utrecht,Willem II,2,0,1,3,0,2,2,10.0,4.0
6773,1982-1983,8,Feyenoord,AZ '67 Alkmaar,3,2,1,3,0,5,1,8.0,7.0
6774,1982-1983,9,FC Twente,AFC Ajax,1,2,2,0,3,3,-1,6.0,10.0
6775,1982-1983,9,NEC Nijmegen,SBV Haarlem,0,0,3,1,1,0,0,3.0,3.0
6776,1982-1983,9,PEC Zwolle '82,Go Ahead Eagles,0,1,2,0,3,1,-1,4.0,6.0
6777,1982-1983,9,PSV,NAC Breda,8,1,1,3,0,9,7,15.0,2.0
6778,1982-1983,9,AZ '67 Alkmaar,Helmond Sport,4,1,1,3,0,5,3,10.0,6.0
6779,1982-1983,9,FC Utrecht,FC Groningen,1,1,3,1,1,2,0,8.0,5.0
6780,1982-1983,9,Roda JC Kerkrade,Fortuna Sittard,1,1,3,1,1,2,0,7.0,5.0
6781,1982-1983,9,Sparta Rotterdam,SBV Excelsior,4,2,1,3,0,6,2,11.0,5.0
6782,1982-1983,9,Willem II,Feyenoord,0,2,2,0,3,2,-2,1.0,8.0
6783,1982-1983,10,Fortuna Sittard,AZ '67 Alkmaar,2,1,1,3,0,3,1,8.0,9.0
6784,1982-1983,10,Go Ahead Eagles,Roda JC Kerkrade,1,4,2,0,3,5,-3,5.0,7.0
6785,1982-1983,10,SBV Haarlem,FC Twente,1,0,1,3,0,1,1,5.0,5.0
6786,1982-1983,10,Helmond Sport,Willem II,2,1,1,3,0,3,1,8.0,1.0
6787,1982-1983,10,NAC Breda,NEC Nijmegen,1,1,3,1,1,2,0,2.0,3.0
6788,1982-1983,10,AFC Ajax,PEC Zwolle '82,3,0,1,3,0,3,3,10.0,3.0
6789,1982-1983,10,SBV Excelsior,PSV,1,0,1,3,0,1,1,8.0,12.0
6790,1982-1983,10,FC Groningen,Sparta Rotterdam,1,1,3,1,1,2,0,5.0,11.0
6791,1982-1983,10,Feyenoord,FC Utrecht,4,1,1,3,0,5,3,10.0,7.0
6792,1982-1983,11,AZ '67 Alkmaar,Go Ahead Eagles,0,0,3,1,1,0,0,7.0,6.0
6793,1982-1983,11,FC Twente,NAC Breda,4,0,1,3,0,4,4,7.0,1.0
6794,1982-1983,11,NEC Nijmegen,SBV Excelsior,2,2,3,1,1,4,0,4.0,8.0
6795,1982-1983,11,PEC Zwolle '82,SBV Haarlem,2,0,1,3,0,2,2,5.0,4.0
6796,1982-1983,11,PSV,Sparta Rotterdam,3,1,1,3,0,4,2,12.0,10.0
6797,1982-1983,11,FC Utrecht,Helmond Sport,2,1,1,3,0,3,1,7.0,7.0
6798,1982-1983,11,Feyenoord,FC Groningen,2,1,1,3,0,3,1,12.0,4.0
6799,1982-1983,11,Roda JC Kerkrade,AFC Ajax,1,2,2,0,3,3,-1,7.0,12.0
6800,1982-1983,11,Willem II,Fortuna Sittard,0,1,2,0,3,1,-1,1.0,8.0
6801,1982-1983,12,Go Ahead Eagles,Willem II,1,1,3,1,1,2,0,6.0,1.0
6802,1982-1983,12,SBV Haarlem,Roda JC Kerkrade,2,0,1,3,0,2,2,7.0,4.0
6803,1982-1983,12,Helmond Sport,Feyenoord,0,1,2,0,3,1,-1,6.0,15.0
6804,1982-1983,12,NAC Breda,PEC Zwolle '82,0,2,2,0,3,2,-2,1.0,7.0
6805,1982-1983,12,AFC Ajax,AZ '67 Alkmaar,2,0,1,3,0,2,2,15.0,4.0
6806,1982-1983,12,SBV Excelsior,FC Twente,1,0,1,3,0,1,1,8.0,4.0
6807,1982-1983,12,FC Groningen,PSV,2,2,3,1,1,4,0,4.0,10.0
6808,1982-1983,12,Fortuna Sittard,FC Utrecht,1,2,2,0,3,3,-1,8.0,10.0
6809,1982-1983,12,Sparta Rotterdam,NEC Nijmegen,2,1,1,3,0,3,1,10.0,3.0
6810,1982-1983,13,AZ '67 Alkmaar,SBV Haarlem,0,1,2,0,3,1,-1,4.0,10.0
6811,1982-1983,13,FC Twente,Sparta Rotterdam,1,1,3,1,1,2,0,4.0,8.0
6812,1982-1983,13,Helmond Sport,FC Groningen,2,2,3,1,1,4,0,4.0,4.0
6813,1982-1983,13,NEC Nijmegen,PSV,1,3,2,0,3,4,-2,3.0,10.0
6814,1982-1983,13,PEC Zwolle '82,SBV Excelsior,0,2,2,0,3,2,-2,6.0,10.0
6815,1982-1983,13,FC Utrecht,Go Ahead Eagles,3,1,1,3,0,4,2,10.0,5.0
6816,1982-1983,13,Feyenoord,Fortuna Sittard,4,1,1,3,0,5,3,15.0,7.0
6817,1982-1983,13,Roda JC Kerkrade,NAC Breda,0,0,3,1,1,0,0,5.0,2.0
6818,1982-1983,13,Willem II,AFC Ajax,0,3,2,0,3,3,-3,1.0,15.0
6819,1982-1983,14,Go Ahead Eagles,Feyenoord,1,1,3,1,1,2,0,3.0,13.0
6820,1982-1983,14,NAC Breda,AZ '67 Alkmaar,2,1,1,3,0,3,1,5.0,1.0
6821,1982-1983,14,PSV,FC Twente,1,1,3,1,1,2,0,8.0,5.0
6822,1982-1983,14,Sparta Rotterdam,PEC Zwolle '82,2,1,1,3,0,3,1,8.0,6.0
6823,1982-1983,14,AFC Ajax,FC Utrecht,3,1,1,3,0,4,2,15.0,9.0
6824,1982-1983,14,SBV Excelsior,Roda JC Kerkrade,2,0,1,3,0,2,2,13.0,4.0
6825,1982-1983,14,FC Groningen,NEC Nijmegen,3,1,1,3,0,4,2,6.0,2.0
6826,1982-1983,14,Fortuna Sittard,Helmond Sport,3,2,1,3,0,5,1,9.0,4.0
6827,1982-1983,14,SBV Haarlem,Willem II,2,0,1,3,0,2,2,12.0,1.0
6828,1982-1983,15,AZ '67 Alkmaar,SBV Excelsior,3,1,1,3,0,4,2,4.0,10.0
6829,1982-1983,15,Helmond Sport,Go Ahead Eagles,1,0,1,3,0,1,1,4.0,3.0
6830,1982-1983,15,PEC Zwolle '82,PSV,0,2,2,0,3,2,-2,6.0,11.0
6831,1982-1983,15,Willem II,NAC Breda,3,1,1,3,0,4,2,4.0,4.0
6832,1982-1983,15,FC Twente,NEC Nijmegen,0,0,3,1,1,0,0,6.0,2.0
6833,1982-1983,15,FC Utrecht,SBV Haarlem,4,1,1,3,0,5,3,12.0,9.0
6834,1982-1983,15,Feyenoord,AFC Ajax,2,2,3,1,1,4,0,11.0,13.0
6835,1982-1983,15,Fortuna Sittard,FC Groningen,1,1,3,1,1,2,0,7.0,6.0
6836,1982-1983,15,Roda JC Kerkrade,Sparta Rotterdam,1,1,3,1,1,2,0,2.0,8.0
6837,1982-1983,16,Go Ahead Eagles,Fortuna Sittard,1,2,2,0,3,3,-1,2.0,7.0
6838,1982-1983,16,NAC Breda,FC Utrecht,1,0,1,3,0,1,1,7.0,9.0
6839,1982-1983,16,PSV,Roda JC Kerkrade,1,1,3,1,1,2,0,9.0,3.0
6840,1982-1983,16,AFC Ajax,Helmond Sport,5,0,1,3,0,5,5,13.0,4.0
6841,1982-1983,16,SBV Excelsior,Willem II,1,3,2,0,3,4,-2,9.0,7.0
6842,1982-1983,16,FC Twente,FC Groningen,1,1,3,1,1,2,0,4.0,7.0
6843,1982-1983,16,SBV Haarlem,Feyenoord,0,0,3,1,1,0,0,10.0,9.0
6844,1982-1983,16,NEC Nijmegen,PEC Zwolle '82,1,1,3,1,1,2,0,2.0,4.0
6845,1982-1983,16,Sparta Rotterdam,AZ '67 Alkmaar,1,1,3,1,1,2,0,9.0,4.0
6846,1982-1983,17,AZ '67 Alkmaar,PSV,0,0,3,1,1,0,0,5.0,9.0
6847,1982-1983,17,Helmond Sport,SBV Haarlem,1,0,1,3,0,1,1,7.0,7.0
6848,1982-1983,17,PEC Zwolle '82,FC Twente,0,1,2,0,3,1,-1,1.0,7.0
6849,1982-1983,17,FC Groningen,Go Ahead Eagles,6,0,1,3,0,6,6,9.0,1.0
6850,1982-1983,17,FC Utrecht,SBV Excelsior,3,2,1,3,0,5,1,9.0,6.0
6851,1982-1983,17,Feyenoord,NAC Breda,6,1,1,3,0,7,5,9.0,7.0
6852,1982-1983,17,Fortuna Sittard,AFC Ajax,1,3,2,0,3,4,-2,7.0,13.0
6853,1982-1983,17,Roda JC Kerkrade,NEC Nijmegen,1,2,2,0,3,3,-1,3.0,5.0
6854,1982-1983,17,Willem II,Sparta Rotterdam,1,1,3,1,1,2,0,7.0,7.0
6855,1982-1983,18,AZ '67 Alkmaar,NEC Nijmegen,2,0,1,3,0,2,2,8.0,5.0
6856,1982-1983,18,Go Ahead Eagles,AFC Ajax,0,2,2,0,3,2,-2,1.0,13.0
6857,1982-1983,18,Helmond Sport,NAC Breda,6,1,1,3,0,7,5,9.0,6.0
6858,1982-1983,18,Willem II,PSV,1,2,2,0,3,3,-1,7.0,9.0
6859,1982-1983,18,FC Groningen,PEC Zwolle '82,3,0,1,3,0,3,3,11.0,1.0
6860,1982-1983,18,FC Utrecht,Sparta Rotterdam,0,3,2,0,3,3,-3,6.0,9.0
6861,1982-1983,18,Feyenoord,SBV Excelsior,1,0,1,3,0,1,1,9.0,3.0
6862,1982-1983,18,Fortuna Sittard,SBV Haarlem,2,0,1,3,0,2,2,10.0,4.0
6863,1982-1983,18,Roda JC Kerkrade,FC Twente,3,1,1,3,0,4,2,5.0,6.0
6864,1982-1983,19,NAC Breda,Fortuna Sittard,2,0,1,3,0,2,2,6.0,7.0
6865,1982-1983,19,PEC Zwolle '82,Roda JC Kerkrade,5,0,1,3,0,5,5,4.0,5.0
6866,1982-1983,19,PSV,FC Utrecht,0,0,3,1,1,0,0,9.0,7.0
6867,1982-1983,19,AFC Ajax,FC Groningen,5,5,3,1,1,10,0,11.0,9.0
6868,1982-1983,19,SBV Excelsior,Helmond Sport,0,0,3,1,1,0,0,1.0,10.0
6869,1982-1983,19,FC Twente,AZ '67 Alkmaar,0,6,2,0,3,6,-6,5.0,11.0
6870,1982-1983,19,SBV Haarlem,Go Ahead Eagles,2,0,1,3,0,2,2,4.0,0.0
6871,1982-1983,19,NEC Nijmegen,Willem II,2,2,3,1,1,4,0,6.0,8.0
6872,1982-1983,19,Sparta Rotterdam,Feyenoord,2,3,2,0,3,5,-1,6.0,11.0
6873,1982-1983,20,AZ '67 Alkmaar,PEC Zwolle '82,0,3,2,0,3,3,-3,8.0,7.0
6874,1982-1983,20,Go Ahead Eagles,NAC Breda,0,0,3,1,1,0,0,1.0,7.0
6875,1982-1983,20,Helmond Sport,Sparta Rotterdam,2,2,3,1,1,4,0,8.0,6.0
6876,1982-1983,20,Willem II,FC Twente,1,0,1,3,0,1,1,8.0,4.0
6877,1982-1983,20,AFC Ajax,SBV Haarlem,6,1,1,3,0,7,5,13.0,4.0
6878,1982-1983,20,FC Groningen,Roda JC Kerkrade,4,0,1,3,0,4,4,11.0,4.0
6879,1982-1983,20,FC Utrecht,NEC Nijmegen,2,2,3,1,1,4,0,5.0,6.0
6880,1982-1983,20,Feyenoord,PSV,2,2,3,1,1,4,0,11.0,7.0
6881,1982-1983,20,Fortuna Sittard,SBV Excelsior,0,1,2,0,3,1,-1,6.0,4.0
6882,1982-1983,21,NAC Breda,AFC Ajax,0,2,2,0,3,2,-2,4.0,13.0
6883,1982-1983,21,PEC Zwolle '82,Willem II,3,3,3,1,1,6,0,7.0,6.0
6884,1982-1983,21,PSV,Helmond Sport,3,1,1,3,0,4,2,9.0,8.0
6885,1982-1983,21,SBV Excelsior,Go Ahead Eagles,0,2,2,0,3,2,-2,4.0,4.0
6886,1982-1983,21,SBV Haarlem,FC Groningen,1,0,1,3,0,1,1,6.0,10.0
6887,1982-1983,21,NEC Nijmegen,Feyenoord,1,1,3,1,1,2,0,6.0,11.0
6888,1982-1983,21,Sparta Rotterdam,Fortuna Sittard,1,1,3,1,1,2,0,6.0,4.0
6889,1982-1983,21,FC Twente,FC Utrecht,0,0,3,1,1,0,0,4.0,6.0
6890,1982-1983,21,Roda JC Kerkrade,AZ '67 Alkmaar,1,0,1,3,0,1,1,6.0,7.0
6891,1982-1983,22,Go Ahead Eagles,Sparta Rotterdam,1,3,2,0,3,4,-2,4.0,8.0
6892,1982-1983,22,SBV Haarlem,NAC Breda,3,2,1,3,0,5,1,9.0,4.0
6893,1982-1983,22,Willem II,Roda JC Kerkrade,0,0,3,1,1,0,0,6.0,7.0
6894,1982-1983,22,AFC Ajax,SBV Excelsior,2,1,1,3,0,3,1,13.0,4.0
6895,1982-1983,22,FC Groningen,AZ '67 Alkmaar,0,1,2,0,3,1,-1,7.0,9.0
6896,1982-1983,22,FC Utrecht,PEC Zwolle '82,2,3,2,0,3,5,-1,3.0,10.0
6897,1982-1983,22,Feyenoord,FC Twente,2,0,1,3,0,2,2,11.0,1.0
6898,1982-1983,22,Fortuna Sittard,PSV,0,0,3,1,1,0,0,5.0,9.0
6899,1982-1983,22,Helmond Sport,NEC Nijmegen,1,0,1,3,0,1,1,8.0,3.0
6900,1982-1983,23,AZ '67 Alkmaar,Willem II,3,0,1,3,0,3,3,9.0,6.0
6901,1982-1983,23,NAC Breda,FC Groningen,1,1,3,1,1,2,0,5.0,5.0
6902,1982-1983,23,PEC Zwolle '82,Feyenoord,0,3,2,0,3,3,-3,10.0,11.0
6903,1982-1983,23,PSV,Go Ahead Eagles,5,0,1,3,0,5,5,9.0,4.0
6904,1982-1983,23,SBV Excelsior,SBV Haarlem,1,1,3,1,1,2,0,5.0,10.0
6905,1982-1983,23,FC Twente,Helmond Sport,3,0,1,3,0,3,3,4.0,5.0
6906,1982-1983,23,NEC Nijmegen,Fortuna Sittard,2,2,3,1,1,4,0,4.0,3.0
6907,1982-1983,23,Roda JC Kerkrade,FC Utrecht,3,3,3,1,1,6,0,5.0,4.0
6908,1982-1983,23,Sparta Rotterdam,AFC Ajax,1,1,3,1,1,2,0,6.0,11.0
6909,1982-1983,24,Go Ahead Eagles,NEC Nijmegen,5,1,1,3,0,6,4,7.0,3.0
6910,1982-1983,24,SBV Haarlem,Sparta Rotterdam,2,1,1,3,0,3,1,10.0,6.0
6911,1982-1983,24,Helmond Sport,PEC Zwolle '82,2,2,3,1,1,4,0,5.0,8.0
6912,1982-1983,24,NAC Breda,SBV Excelsior,0,0,3,1,1,0,0,3.0,5.0
6913,1982-1983,24,AFC Ajax,PSV,3,3,3,1,1,6,0,11.0,9.0
6914,1982-1983,24,FC Groningen,Willem II,4,3,1,3,0,7,1,7.0,5.0
6915,1982-1983,24,FC Utrecht,AZ '67 Alkmaar,0,0,3,1,1,0,0,4.0,7.0
6916,1982-1983,24,Feyenoord,Roda JC Kerkrade,3,2,1,3,0,5,1,11.0,5.0
6917,1982-1983,24,Fortuna Sittard,FC Twente,3,0,1,3,0,3,3,6.0,4.0
6918,1982-1983,25,AZ '67 Alkmaar,Feyenoord,0,1,2,0,3,1,-1,7.0,13.0
6919,1982-1983,25,PEC Zwolle '82,Fortuna Sittard,1,0,1,3,0,1,1,8.0,6.0
6920,1982-1983,25,PSV,SBV Haarlem,2,1,1,3,0,3,1,11.0,10.0
6921,1982-1983,25,Willem II,FC Utrecht,1,2,2,0,3,3,-1,2.0,6.0
6922,1982-1983,25,SBV Excelsior,FC Groningen,3,0,1,3,0,3,3,5.0,4.0
6923,1982-1983,25,FC Twente,Go Ahead Eagles,1,1,3,1,1,2,0,5.0,7.0
6924,1982-1983,25,NEC Nijmegen,AFC Ajax,0,4,2,0,3,4,-4,2.0,11.0
6925,1982-1983,25,Roda JC Kerkrade,Helmond Sport,3,1,1,3,0,4,2,8.0,4.0
6926,1982-1983,25,Sparta Rotterdam,NAC Breda,4,0,1,3,0,4,4,8.0,2.0
6927,1982-1983,26,Fortuna Sittard,Roda JC Kerkrade,1,1,3,1,1,2,0,6.0,6.0
6928,1982-1983,26,Go Ahead Eagles,PEC Zwolle '82,2,1,1,3,0,3,1,7.0,7.0
6929,1982-1983,26,SBV Haarlem,NEC Nijmegen,2,0,1,3,0,2,2,10.0,1.0
6930,1982-1983,26,Helmond Sport,AZ '67 Alkmaar,1,0,1,3,0,1,1,7.0,7.0
6931,1982-1983,26,NAC Breda,PSV,1,5,2,0,3,6,-4,2.0,11.0
6932,1982-1983,26,AFC Ajax,FC Twente,5,0,1,3,0,5,5,11.0,4.0
6933,1982-1983,26,SBV Excelsior,Sparta Rotterdam,2,0,1,3,0,2,2,8.0,7.0
6934,1982-1983,26,FC Groningen,FC Utrecht,2,1,1,3,0,3,1,7.0,5.0
6935,1982-1983,26,Feyenoord,Willem II,3,2,1,3,0,5,1,15.0,1.0
6936,1982-1983,27,AZ '67 Alkmaar,Fortuna Sittard,0,0,3,1,1,0,0,5.0,6.0
6937,1982-1983,27,FC Twente,SBV Haarlem,2,4,2,0,3,6,-2,4.0,10.0
6938,1982-1983,27,NEC Nijmegen,NAC Breda,1,1,3,1,1,2,0,2.0,3.0
6939,1982-1983,27,PEC Zwolle '82,AFC Ajax,1,2,2,0,3,3,-1,4.0,11.0
6940,1982-1983,27,PSV,SBV Excelsior,4,3,1,3,0,7,1,13.0,8.0
6941,1982-1983,27,Willem II,Helmond Sport,4,0,1,3,0,4,4,3.0,4.0
6942,1982-1983,27,FC Utrecht,Feyenoord,1,1,3,1,1,2,0,6.0,13.0
6943,1982-1983,27,Roda JC Kerkrade,Go Ahead Eagles,2,0,1,3,0,2,2,8.0,7.0
6944,1982-1983,27,Sparta Rotterdam,FC Groningen,3,3,3,1,1,6,0,5.0,8.0
6945,1982-1983,28,SBV Excelsior,NEC Nijmegen,2,1,1,3,0,3,1,10.0,1.0
6946,1982-1983,28,Fortuna Sittard,Willem II,2,1,1,3,0,3,1,8.0,3.0
6947,1982-1983,28,Go Ahead Eagles,AZ '67 Alkmaar,2,1,1,3,0,3,1,10.0,2.0
6948,1982-1983,28,SBV Haarlem,PEC Zwolle '82,5,1,1,3,0,6,4,12.0,4.0
6949,1982-1983,28,Helmond Sport,FC Utrecht,1,1,3,1,1,2,0,5.0,6.0
6950,1982-1983,28,NAC Breda,FC Twente,3,1,1,3,0,4,2,5.0,1.0
6951,1982-1983,28,AFC Ajax,Roda JC Kerkrade,3,1,1,3,0,4,2,13.0,7.0
6952,1982-1983,28,FC Groningen,Feyenoord,1,2,2,0,3,3,-1,7.0,13.0
6953,1982-1983,28,Sparta Rotterdam,PSV,1,1,3,1,1,2,0,5.0,11.0
6954,1982-1983,29,AZ '67 Alkmaar,AFC Ajax,2,3,2,0,3,5,-1,1.0,15.0
6955,1982-1983,29,FC Twente,SBV Excelsior,0,2,2,0,3,2,-2,1.0,12.0
6956,1982-1983,29,NEC Nijmegen,Sparta Rotterdam,5,2,1,3,0,7,3,4.0,5.0
6957,1982-1983,29,PEC Zwolle '82,NAC Breda,2,1,1,3,0,3,1,6.0,4.0
6958,1982-1983,29,PSV,FC Groningen,6,0,1,3,0,6,6,13.0,4.0
6959,1982-1983,29,Willem II,Go Ahead Eagles,2,0,1,3,0,2,2,6.0,7.0
6960,1982-1983,29,FC Utrecht,Fortuna Sittard,4,0,1,3,0,4,4,8.0,5.0
6961,1982-1983,29,Feyenoord,Helmond Sport,2,1,1,3,0,3,1,13.0,4.0
6962,1982-1983,29,Roda JC Kerkrade,SBV Haarlem,2,0,1,3,0,2,2,10.0,9.0
6963,1982-1983,30,Go Ahead Eagles,FC Utrecht,4,0,1,3,0,4,4,9.0,5.0
6964,1982-1983,30,SBV Haarlem,AZ '67 Alkmaar,3,3,3,1,1,6,0,10.0,2.0
6965,1982-1983,30,NAC Breda,Roda JC Kerkrade,2,2,3,1,1,4,0,5.0,8.0
6966,1982-1983,30,PSV,NEC Nijmegen,2,0,1,3,0,2,2,13.0,4.0
6967,1982-1983,30,AFC Ajax,Willem II,8,2,1,3,0,10,6,15.0,6.0
6968,1982-1983,30,SBV Excelsior,PEC Zwolle '82,0,1,2,0,3,1,-1,9.0,6.0
6969,1982-1983,30,FC Groningen,Helmond Sport,4,2,1,3,0,6,2,7.0,4.0
6970,1982-1983,30,Fortuna Sittard,Feyenoord,1,0,1,3,0,1,1,8.0,10.0
6971,1982-1983,30,Sparta Rotterdam,FC Twente,2,3,2,0,3,5,-1,2.0,3.0
6972,1982-1983,31,AZ '67 Alkmaar,NAC Breda,3,3,3,1,1,6,0,3.0,6.0
6973,1982-1983,31,FC Twente,PSV,3,1,1,3,0,4,2,6.0,10.0
6974,1982-1983,31,Helmond Sport,Fortuna Sittard,1,1,3,1,1,2,0,2.0,8.0
6975,1982-1983,31,NEC Nijmegen,FC Groningen,2,2,3,1,1,4,0,5.0,5.0
6976,1982-1983,31,PEC Zwolle '82,Sparta Rotterdam,0,3,2,0,3,3,-3,6.0,5.0
6977,1982-1983,31,Willem II,SBV Haarlem,4,3,1,3,0,7,1,9.0,7.0
6978,1982-1983,31,FC Utrecht,AFC Ajax,0,2,2,0,3,2,-2,5.0,15.0
6979,1982-1983,31,Feyenoord,Go Ahead Eagles,1,1,3,1,1,2,0,8.0,7.0
6980,1982-1983,31,Roda JC Kerkrade,SBV Excelsior,1,2,2,0,3,3,-1,7.0,9.0
6981,1982-1983,32,Go Ahead Eagles,Helmond Sport,3,0,1,3,0,3,3,10.0,2.0
6982,1982-1983,32,NAC Breda,Willem II,2,2,3,1,1,4,0,6.0,7.0
6983,1982-1983,32,NEC Nijmegen,FC Twente,0,0,3,1,1,0,0,5.0,7.0
6984,1982-1983,32,PSV,PEC Zwolle '82,0,1,2,0,3,1,-1,7.0,9.0
6985,1982-1983,32,AFC Ajax,Feyenoord,3,3,3,1,1,6,0,13.0,8.0
6986,1982-1983,32,SBV Excelsior,AZ '67 Alkmaar,1,4,2,0,3,5,-3,9.0,5.0
6987,1982-1983,32,FC Groningen,Fortuna Sittard,3,1,1,3,0,4,2,7.0,7.0
6988,1982-1983,32,SBV Haarlem,FC Utrecht,4,2,1,3,0,6,2,7.0,4.0
6989,1982-1983,32,Sparta Rotterdam,Roda JC Kerkrade,2,2,3,1,1,4,0,5.0,5.0
6990,1982-1983,33,AZ '67 Alkmaar,Sparta Rotterdam,0,1,2,0,3,1,-1,5.0,7.0
6991,1982-1983,33,FC Groningen,FC Twente,6,1,1,3,0,7,5,10.0,7.0
6992,1982-1983,33,FC Utrecht,NAC Breda,2,3,2,0,3,5,-1,3.0,6.0
6993,1982-1983,33,Feyenoord,SBV Haarlem,3,1,1,3,0,4,2,8.0,4.0
6994,1982-1983,33,Fortuna Sittard,Go Ahead Eagles,1,1,3,1,1,2,0,5.0,8.0
6995,1982-1983,33,Helmond Sport,AFC Ajax,1,4,2,0,3,5,-3,1.0,13.0
6996,1982-1983,33,PEC Zwolle '82,NEC Nijmegen,1,0,1,3,0,1,1,12.0,5.0
6997,1982-1983,33,Roda JC Kerkrade,PSV,1,2,2,0,3,3,-1,5.0,9.0
6998,1982-1983,33,Willem II,SBV Excelsior,3,1,1,3,0,4,2,10.0,6.0
6999,1982-1983,34,AFC Ajax,Fortuna Sittard,6,5,1,3,0,11,1,13.0,5.0
7000,1982-1983,34,SBV Excelsior,FC Utrecht,0,2,2,0,3,2,-2,3.0,3.0
7001,1982-1983,34,FC Twente,PEC Zwolle '82,2,0,1,3,0,2,2,10.0,9.0
7002,1982-1983,34,Go Ahead Eagles,FC Groningen,3,1,1,3,0,4,2,11.0,10.0
7003,1982-1983,34,SBV Haarlem,Helmond Sport,2,2,3,1,1,4,0,5.0,2.0
7004,1982-1983,34,NAC Breda,Feyenoord,2,3,2,0,3,5,-1,6.0,8.0
7005,1982-1983,34,NEC Nijmegen,Roda JC Kerkrade,2,3,2,0,3,5,-1,2.0,5.0
7006,1982-1983,34,PSV,AZ '67 Alkmaar,1,0,1,3,0,1,1,9.0,5.0
7007,1982-1983,34,Sparta Rotterdam,Willem II,3,0,1,3,0,3,3,10.0,7.0
7008,1983-1984,1,Helmond Sport,Fortuna Sittard,1,1,3,1,1,2,0,3.0,3.0
7009,1983-1984,1,PEC Zwolle '82,SBV Haarlem,3,0,1,3,0,3,3,9.0,4.0
7010,1983-1984,1,Willem II,FC Groningen,3,4,2,0,3,7,-1,7.0,10.0
7011,1983-1984,1,Drechtsteden '79,Go Ahead Eagles,2,2,3,1,1,4,0,,9.0
7012,1983-1984,1,SBV Excelsior,PSV,0,3,2,0,3,3,-3,3.0,9.0
7013,1983-1984,1,FC Den Bosch '67,Roda JC Kerkrade,1,1,3,1,1,2,0,7.0,5.0
7014,1983-1984,1,FC Utrecht,AFC Ajax,1,1,3,1,1,2,0,4.0,11.0
7015,1983-1984,1,FC Volendam,Feyenoord,1,4,2,0,3,5,-3,4.0,11.0
7016,1983-1984,1,Sparta Rotterdam,AZ '67 Alkmaar,1,1,3,1,1,2,0,11.0,5.0
7017,1983-1984,2,AFC Ajax,Willem II,5,0,1,3,0,5,5,11.0,4.0
7018,1983-1984,2,AZ '67 Alkmaar,Drechtsteden '79,2,0,1,3,0,2,2,7.0,
7019,1983-1984,2,FC Groningen,PEC Zwolle '82,1,1,3,1,1,2,0,10.0,10.0
7020,1983-1984,2,Feyenoord,Helmond Sport,5,2,1,3,0,7,3,13.0,2.0
7021,1983-1984,2,Fortuna Sittard,FC Den Bosch '67,5,1,1,3,0,6,4,5.0,4.0
7022,1983-1984,2,Go Ahead Eagles,FC Utrecht,2,0,1,3,0,2,2,11.0,4.0
7023,1983-1984,2,SBV Haarlem,FC Volendam,1,1,3,1,1,2,0,5.0,5.0
7024,1983-1984,2,PSV,Sparta Rotterdam,1,0,1,3,0,1,1,12.0,8.0
7025,1983-1984,2,Roda JC Kerkrade,SBV Excelsior,2,0,1,3,0,2,2,8.0,0.0
7026,1983-1984,3,Go Ahead Eagles,Willem II,4,6,2,0,3,10,-2,8.0,6.0
7027,1983-1984,3,SBV Haarlem,Helmond Sport,3,0,1,3,0,3,3,5.0,2.0
7028,1983-1984,3,PSV,Drechtsteden '79,5,0,1,3,0,5,5,15.0,
7029,1983-1984,3,AFC Ajax,PEC Zwolle '82,4,2,1,3,0,6,2,13.0,7.0
7030,1983-1984,3,AZ '67 Alkmaar,FC Utrecht,0,1,2,0,3,1,-1,4.0,7.0
7031,1983-1984,3,SBV Excelsior,FC Den Bosch '67,3,1,1,3,0,4,2,3.0,1.0
7032,1983-1984,3,FC Groningen,FC Volendam,4,1,1,3,0,5,3,10.0,2.0
7033,1983-1984,3,Feyenoord,Fortuna Sittard,5,2,1,3,0,7,3,15.0,5.0
7034,1983-1984,3,Roda JC Kerkrade,Sparta Rotterdam,2,2,3,1,1,4,0,8.0,8.0
7035,1983-1984,4,Drechtsteden '79,Roda JC Kerkrade,1,2,2,0,3,3,-1,,11.0
7036,1983-1984,4,FC Den Bosch '67,Feyenoord,1,1,3,1,1,2,0,2.0,13.0
7037,1983-1984,4,FC Utrecht,PSV,2,0,1,3,0,2,2,10.0,12.0
7038,1983-1984,4,FC Volendam,AFC Ajax,0,2,2,0,3,2,-2,1.0,13.0
7039,1983-1984,4,Fortuna Sittard,SBV Haarlem,2,0,1,3,0,2,2,7.0,5.0
7040,1983-1984,4,Helmond Sport,FC Groningen,0,0,3,1,1,0,0,3.0,8.0
7041,1983-1984,4,PEC Zwolle '82,Go Ahead Eagles,1,1,3,1,1,2,0,5.0,8.0
7042,1983-1984,4,Sparta Rotterdam,SBV Excelsior,3,3,3,1,1,6,0,6.0,4.0
7043,1983-1984,4,Willem II,AZ '67 Alkmaar,1,1,3,1,1,2,0,4.0,5.0
7044,1983-1984,5,Go Ahead Eagles,FC Volendam,4,0,1,3,0,4,4,8.0,1.0
7045,1983-1984,5,SBV Haarlem,Feyenoord,0,1,2,0,3,1,-1,4.0,13.0
7046,1983-1984,5,PSV,Willem II,1,2,2,0,3,3,-1,9.0,7.0
7047,1983-1984,5,AFC Ajax,Helmond Sport,7,2,1,3,0,9,5,13.0,2.0
7048,1983-1984,5,AZ '67 Alkmaar,PEC Zwolle '82,1,2,2,0,3,3,-1,5.0,8.0
7049,1983-1984,5,SBV Excelsior,Drechtsteden '79,0,1,2,0,3,1,-1,4.0,4.0
7050,1983-1984,5,FC Groningen,Fortuna Sittard,3,0,1,3,0,3,3,11.0,7.0
7051,1983-1984,5,Roda JC Kerkrade,FC Utrecht,1,1,3,1,1,2,0,9.0,8.0
7052,1983-1984,5,Sparta Rotterdam,FC Den Bosch '67,2,1,1,3,0,3,1,6.0,2.0
7053,1983-1984,6,Helmond Sport,Go Ahead Eagles,0,1,2,0,3,1,-1,1.0,10.0
7054,1983-1984,6,PEC Zwolle '82,PSV,1,3,2,0,3,4,-2,5.0,9.0
7055,1983-1984,6,Willem II,Roda JC Kerkrade,1,2,2,0,3,3,-1,7.0,11.0
7056,1983-1984,6,Drechtsteden '79,Sparta Rotterdam,1,4,2,0,3,5,-3,3.0,8.0
7057,1983-1984,6,FC Den Bosch '67,SBV Haarlem,0,2,2,0,3,2,-2,1.0,7.0
7058,1983-1984,6,FC Utrecht,SBV Excelsior,7,4,1,3,0,11,3,10.0,4.0
7059,1983-1984,6,FC Volendam,AZ '67 Alkmaar,4,0,1,3,0,4,4,4.0,4.0
7060,1983-1984,6,Feyenoord,FC Groningen,2,0,1,3,0,2,2,13.0,8.0
7061,1983-1984,6,Fortuna Sittard,AFC Ajax,1,2,2,0,3,3,-1,6.0,15.0
7062,1983-1984,7,Go Ahead Eagles,Fortuna Sittard,3,2,1,3,0,5,1,10.0,3.0
7063,1983-1984,7,PSV,FC Volendam,3,1,1,3,0,4,2,9.0,3.0
7064,1983-1984,7,AFC Ajax,Feyenoord,8,2,1,3,0,10,6,15.0,10.0
7065,1983-1984,7,AZ '67 Alkmaar,Helmond Sport,3,1,1,3,0,4,2,4.0,1.0
7066,1983-1984,7,Drechtsteden '79,FC Den Bosch '67,1,3,2,0,3,4,-2,3.0,4.0
7067,1983-1984,7,SBV Excelsior,Willem II,0,1,2,0,3,1,-1,4.0,10.0
7068,1983-1984,7,FC Groningen,SBV Haarlem,1,2,2,0,3,3,-1,7.0,9.0
7069,1983-1984,7,Roda JC Kerkrade,PEC Zwolle '82,7,3,1,3,0,10,4,11.0,4.0
7070,1983-1984,7,Sparta Rotterdam,FC Utrecht,6,1,1,3,0,7,5,11.0,10.0
7071,1983-1984,8,Fortuna Sittard,AZ '67 Alkmaar,0,0,3,1,1,0,0,4.0,5.0
7072,1983-1984,8,SBV Haarlem,AFC Ajax,3,3,3,1,1,6,0,7.0,13.0
7073,1983-1984,8,Helmond Sport,PSV,1,5,2,0,3,6,-4,1.0,9.0
7074,1983-1984,8,PEC Zwolle '82,SBV Excelsior,2,0,1,3,0,2,2,7.0,1.0
7075,1983-1984,8,Willem II,Sparta Rotterdam,1,2,2,0,3,3,-1,7.0,13.0
7076,1983-1984,8,FC Den Bosch '67,FC Groningen,0,0,3,1,1,0,0,5.0,5.0
7077,1983-1984,8,FC Utrecht,Drechtsteden '79,3,1,1,3,0,4,2,10.0,3.0
7078,1983-1984,8,FC Volendam,Roda JC Kerkrade,1,1,3,1,1,2,0,4.0,11.0
7079,1983-1984,8,Feyenoord,Go Ahead Eagles,2,0,1,3,0,2,2,10.0,10.0
7080,1983-1984,9,Go Ahead Eagles,SBV Haarlem,1,3,2,0,3,4,-2,9.0,10.0
7081,1983-1984,9,PSV,Fortuna Sittard,5,1,1,3,0,6,4,12.0,1.0
7082,1983-1984,9,AFC Ajax,FC Groningen,1,1,3,1,1,2,0,11.0,5.0
7083,1983-1984,9,AZ '67 Alkmaar,Feyenoord,0,1,2,0,3,1,-1,4.0,12.0
7084,1983-1984,9,Drechtsteden '79,Willem II,0,1,2,0,3,1,-1,3.0,9.0
7085,1983-1984,9,SBV Excelsior,FC Volendam,4,2,1,3,0,6,2,3.0,4.0
7086,1983-1984,9,FC Utrecht,FC Den Bosch '67,3,0,1,3,0,3,3,10.0,4.0
7087,1983-1984,9,Roda JC Kerkrade,Helmond Sport,2,1,1,3,0,3,1,11.0,0.0
7088,1983-1984,9,Sparta Rotterdam,PEC Zwolle '82,2,2,3,1,1,4,0,13.0,7.0
7089,1983-1984,10,FC Groningen,Go Ahead Eagles,2,0,1,3,0,2,2,5.0,6.0
7090,1983-1984,10,Fortuna Sittard,Roda JC Kerkrade,1,1,3,1,1,2,0,2.0,11.0
7091,1983-1984,10,Helmond Sport,SBV Excelsior,1,2,2,0,3,3,-1,0.0,6.0
7092,1983-1984,10,PEC Zwolle '82,Drechtsteden '79,3,2,1,3,0,5,1,7.0,0.0
7093,1983-1984,10,Willem II,FC Utrecht,0,2,2,0,3,2,-2,6.0,12.0
7094,1983-1984,10,FC Den Bosch '67,AFC Ajax,3,0,1,3,0,3,3,7.0,8.0
7095,1983-1984,10,FC Volendam,Sparta Rotterdam,3,2,1,3,0,5,1,7.0,10.0
7096,1983-1984,10,Feyenoord,PSV,1,1,3,1,1,2,0,10.0,13.0
7097,1983-1984,10,SBV Haarlem,AZ '67 Alkmaar,2,2,3,1,1,4,0,11.0,5.0
7098,1983-1984,11,PSV,SBV Haarlem,6,0,1,3,0,6,6,13.0,8.0
7099,1983-1984,11,Willem II,FC Den Bosch '67,1,0,1,3,0,1,1,9.0,7.0
7100,1983-1984,11,AZ '67 Alkmaar,FC Groningen,0,0,3,1,1,0,0,6.0,6.0
7101,1983-1984,11,Drechtsteden '79,FC Volendam,2,0,1,3,0,2,2,3.0,4.0
7102,1983-1984,11,SBV Excelsior,Fortuna Sittard,6,0,1,3,0,6,6,9.0,2.0
7103,1983-1984,11,FC Utrecht,PEC Zwolle '82,6,2,1,3,0,8,4,12.0,7.0
7104,1983-1984,11,Go Ahead Eagles,AFC Ajax,1,3,2,0,3,4,-2,3.0,8.0
7105,1983-1984,11,Roda JC Kerkrade,Feyenoord,0,4,2,0,3,4,-4,8.0,10.0
7106,1983-1984,11,Sparta Rotterdam,Helmond Sport,3,3,3,1,1,6,0,8.0,1.0
7107,1983-1984,12,FC Groningen,PSV,1,4,2,0,3,5,-3,6.0,13.0
7108,1983-1984,12,Fortuna Sittard,Sparta Rotterdam,1,0,1,3,0,1,1,5.0,5.0
7109,1983-1984,12,SBV Haarlem,Roda JC Kerkrade,0,0,3,1,1,0,0,6.0,6.0
7110,1983-1984,12,Helmond Sport,Drechtsteden '79,2,4,2,0,3,6,-2,1.0,6.0
7111,1983-1984,12,PEC Zwolle '82,Willem II,3,1,1,3,0,4,2,10.0,6.0
7112,1983-1984,12,AFC Ajax,AZ '67 Alkmaar,2,1,1,3,0,3,1,8.0,3.0
7113,1983-1984,12,FC Den Bosch '67,Go Ahead Eagles,0,0,3,1,1,0,0,5.0,1.0
7114,1983-1984,12,FC Volendam,FC Utrecht,1,1,3,1,1,2,0,5.0,13.0
7115,1983-1984,12,Feyenoord,SBV Excelsior,4,0,1,3,0,4,4,13.0,9.0
7116,1983-1984,13,PEC Zwolle '82,FC Den Bosch '67,1,1,3,1,1,2,0,8.0,5.0
7117,1983-1984,13,PSV,AFC Ajax,1,0,1,3,0,1,1,13.0,7.0
7118,1983-1984,13,Willem II,FC Volendam,1,3,2,0,3,4,-2,6.0,7.0
7119,1983-1984,13,AZ '67 Alkmaar,Go Ahead Eagles,2,2,3,1,1,4,0,3.0,2.0
7120,1983-1984,13,Drechtsteden '79,Fortuna Sittard,2,0,1,3,0,2,2,9.0,4.0
7121,1983-1984,13,SBV Excelsior,SBV Haarlem,0,0,3,1,1,0,0,10.0,6.0
7122,1983-1984,13,FC Utrecht,Helmond Sport,6,4,1,3,0,10,2,13.0,1.0
7123,1983-1984,13,Roda JC Kerkrade,FC Groningen,2,3,2,0,3,5,-1,5.0,8.0
7124,1983-1984,13,Sparta Rotterdam,Feyenoord,1,4,2,0,3,5,-3,2.0,13.0
7125,1983-1984,14,Go Ahead Eagles,PSV,2,1,1,3,0,3,1,5.0,10.0
7126,1983-1984,14,AFC Ajax,Roda JC Kerkrade,5,2,1,3,0,7,3,9.0,2.0
7127,1983-1984,14,FC Den Bosch '67,AZ '67 Alkmaar,2,4,2,0,3,6,-2,5.0,6.0
7128,1983-1984,14,FC Groningen,SBV Excelsior,0,2,2,0,3,2,-2,7.0,10.0
7129,1983-1984,14,FC Volendam,PEC Zwolle '82,0,2,2,0,3,2,-2,7.0,10.0
7130,1983-1984,14,Feyenoord,Drechtsteden '79,2,1,1,3,0,3,1,13.0,9.0
7131,1983-1984,14,Fortuna Sittard,FC Utrecht,2,0,1,3,0,2,2,7.0,10.0
7132,1983-1984,14,SBV Haarlem,Sparta Rotterdam,2,2,3,1,1,4,0,4.0,2.0
7133,1983-1984,14,Helmond Sport,Willem II,2,2,3,1,1,4,0,2.0,4.0
7134,1983-1984,15,PEC Zwolle '82,Helmond Sport,2,1,1,3,0,3,1,10.0,2.0
7135,1983-1984,15,PSV,AZ '67 Alkmaar,1,0,1,3,0,1,1,12.0,5.0
7136,1983-1984,15,Willem II,Fortuna Sittard,0,0,3,1,1,0,0,5.0,7.0
7137,1983-1984,15,Roda JC Kerkrade,Go Ahead Eagles,1,1,3,1,1,2,0,2.0,6.0
7138,1983-1984,15,FC Utrecht,Feyenoord,0,2,2,0,3,2,-2,7.0,15.0
7139,1983-1984,15,FC Volendam,FC Den Bosch '67,1,1,3,1,1,2,0,5.0,3.0
7140,1983-1984,15,SBV Excelsior,AFC Ajax,1,1,3,1,1,2,0,8.0,10.0
7141,1983-1984,15,Sparta Rotterdam,FC Groningen,3,2,1,3,0,5,1,5.0,4.0
7142,1983-1984,15,Drechtsteden '79,SBV Haarlem,0,4,2,0,3,4,-4,9.0,6.0
7143,1983-1984,16,Go Ahead Eagles,SBV Excelsior,4,1,1,3,0,5,3,9.0,5.0
7144,1983-1984,16,AFC Ajax,Sparta Rotterdam,4,0,1,3,0,4,4,10.0,4.0
7145,1983-1984,16,AZ '67 Alkmaar,Roda JC Kerkrade,2,0,1,3,0,2,2,7.0,2.0
7146,1983-1984,16,FC Den Bosch '67,PSV,2,4,2,0,3,6,-2,3.0,12.0
7147,1983-1984,16,FC Groningen,Drechtsteden '79,1,1,3,1,1,2,0,4.0,7.0
7148,1983-1984,16,Feyenoord,Willem II,4,0,1,3,0,4,4,15.0,2.0
7149,1983-1984,16,Fortuna Sittard,PEC Zwolle '82,1,1,3,1,1,2,0,8.0,11.0
7150,1983-1984,16,SBV Haarlem,FC Utrecht,5,1,1,3,0,6,4,9.0,4.0
7151,1983-1984,16,Helmond Sport,FC Volendam,1,2,2,0,3,3,-1,1.0,8.0
7152,1983-1984,17,Drechtsteden '79,AFC Ajax,1,2,2,0,3,3,-1,4.0,10.0
7153,1983-1984,17,PEC Zwolle '82,Feyenoord,2,2,3,1,1,4,0,9.0,13.0
7154,1983-1984,17,Willem II,SBV Haarlem,2,2,3,1,1,4,0,3.0,9.0
7155,1983-1984,17,SBV Excelsior,AZ '67 Alkmaar,0,2,2,0,3,2,-2,5.0,10.0
7156,1983-1984,17,FC Utrecht,FC Groningen,3,2,1,3,0,5,1,6.0,4.0
7157,1983-1984,17,FC Volendam,Fortuna Sittard,1,1,3,1,1,2,0,8.0,6.0
7158,1983-1984,17,Helmond Sport,FC Den Bosch '67,1,3,2,0,3,4,-2,1.0,5.0
7159,1983-1984,17,Sparta Rotterdam,Go Ahead Eagles,4,0,1,3,0,4,4,7.0,8.0
7160,1983-1984,17,Roda JC Kerkrade,PSV,1,2,2,0,3,3,-1,1.0,12.0
7161,1983-1984,18,PSV,SBV Excelsior,0,0,3,1,1,0,0,10.0,5.0
7162,1983-1984,18,AFC Ajax,FC Utrecht,5,2,1,3,0,7,3,13.0,3.0
7163,1983-1984,18,AZ '67 Alkmaar,Sparta Rotterdam,0,1,2,0,3,1,-1,9.0,10.0
7164,1983-1984,18,FC Groningen,Willem II,2,0,1,3,0,2,2,4.0,3.0
7165,1983-1984,18,Feyenoord,FC Volendam,2,0,1,3,0,2,2,13.0,5.0
7166,1983-1984,18,Fortuna Sittard,Helmond Sport,2,0,1,3,0,2,2,9.0,1.0
7167,1983-1984,18,Go Ahead Eagles,Drechtsteden '79,2,1,1,3,0,3,1,10.0,1.0
7168,1983-1984,18,SBV Haarlem,PEC Zwolle '82,2,1,1,3,0,3,1,11.0,8.0
7169,1983-1984,18,Roda JC Kerkrade,FC Den Bosch '67,4,0,1,3,0,4,4,4.0,4.0
7170,1983-1984,19,PEC Zwolle '82,FC Groningen,0,2,2,0,3,2,-2,5.0,7.0
7171,1983-1984,19,Willem II,AFC Ajax,0,2,2,0,3,2,-2,2.0,13.0
7172,1983-1984,19,FC Utrecht,Go Ahead Eagles,2,0,1,3,0,2,2,6.0,7.0
7173,1983-1984,19,FC Volendam,SBV Haarlem,1,0,1,3,0,1,1,8.0,10.0
7174,1983-1984,19,Helmond Sport,Feyenoord,0,5,2,0,3,5,-5,0.0,13.0
7175,1983-1984,19,FC Den Bosch '67,Fortuna Sittard,2,1,1,3,0,3,1,7.0,6.0
7176,1983-1984,19,Sparta Rotterdam,PSV,2,2,3,1,1,4,0,10.0,11.0
7177,1983-1984,19,SBV Excelsior,Roda JC Kerkrade,1,2,2,0,3,3,-1,2.0,7.0
7178,1983-1984,19,Drechtsteden '79,AZ '67 Alkmaar,0,2,2,0,3,2,-2,1.0,9.0
7179,1983-1984,20,Drechtsteden '79,PSV,1,5,2,0,3,6,-4,1.0,11.0
7180,1983-1984,20,FC Den Bosch '67,SBV Excelsior,2,0,1,3,0,2,2,9.0,1.0
7181,1983-1984,20,FC Utrecht,AZ '67 Alkmaar,1,7,2,0,3,8,-6,6.0,12.0
7182,1983-1984,20,FC Volendam,FC Groningen,2,1,1,3,0,3,1,10.0,7.0
7183,1983-1984,20,Fortuna Sittard,Feyenoord,0,4,2,0,3,4,-4,5.0,13.0
7184,1983-1984,20,Helmond Sport,SBV Haarlem,0,0,3,1,1,0,0,1.0,8.0
7185,1983-1984,20,PEC Zwolle '82,AFC Ajax,1,1,3,1,1,2,0,3.0,13.0
7186,1983-1984,20,Sparta Rotterdam,Roda JC Kerkrade,2,2,3,1,1,4,0,8.0,7.0
7187,1983-1984,20,Willem II,Go Ahead Eagles,0,0,3,1,1,0,0,2.0,7.0
7188,1983-1984,21,Go Ahead Eagles,PEC Zwolle '82,2,0,1,3,0,2,2,7.0,2.0
7189,1983-1984,21,PSV,FC Utrecht,3,3,3,1,1,6,0,9.0,7.0
7190,1983-1984,21,AFC Ajax,FC Volendam,5,0,1,3,0,5,5,13.0,7.0
7191,1983-1984,21,AZ '67 Alkmaar,Willem II,4,0,1,3,0,4,4,12.0,2.0
7192,1983-1984,21,SBV Excelsior,Sparta Rotterdam,2,1,1,3,0,3,1,4.0,8.0
7193,1983-1984,21,FC Groningen,Helmond Sport,5,3,1,3,0,8,2,9.0,1.0
7194,1983-1984,21,Feyenoord,FC Den Bosch '67,1,1,3,1,1,2,0,11.0,10.0
7195,1983-1984,21,SBV Haarlem,Fortuna Sittard,1,0,1,3,0,1,1,8.0,4.0
7196,1983-1984,21,Roda JC Kerkrade,Drechtsteden '79,2,1,1,3,0,3,1,10.0,0.0
7197,1983-1984,22,PEC Zwolle '82,AZ '67 Alkmaar,2,1,1,3,0,3,1,4.0,9.0
7198,1983-1984,22,Willem II,PSV,0,1,2,0,3,1,-1,1.0,9.0
7199,1983-1984,22,Drechtsteden '79,SBV Excelsior,0,2,2,0,3,2,-2,0.0,7.0
7200,1983-1984,22,FC Den Bosch '67,Sparta Rotterdam,2,2,3,1,1,4,0,8.0,6.0
7201,1983-1984,22,FC Utrecht,Roda JC Kerkrade,0,2,2,0,3,2,-2,4.0,13.0
7202,1983-1984,22,FC Volendam,Go Ahead Eagles,0,2,2,0,3,2,-2,6.0,10.0
7203,1983-1984,22,Feyenoord,SBV Haarlem,7,2,1,3,0,9,5,13.0,7.0
7204,1983-1984,22,Fortuna Sittard,FC Groningen,0,0,3,1,1,0,0,4.0,10.0
7205,1983-1984,22,Helmond Sport,AFC Ajax,0,2,2,0,3,2,-2,1.0,13.0
7206,1983-1984,23,Go Ahead Eagles,Helmond Sport,2,1,1,3,0,3,1,10.0,1.0
7207,1983-1984,23,PSV,PEC Zwolle '82,4,2,1,3,0,6,2,11.0,4.0
7208,1983-1984,23,AFC Ajax,Fortuna Sittard,5,1,1,3,0,6,4,13.0,1.0
7209,1983-1984,23,AZ '67 Alkmaar,FC Volendam,3,1,1,3,0,4,2,12.0,6.0
7210,1983-1984,23,SBV Excelsior,FC Utrecht,7,4,1,3,0,11,3,9.0,4.0
7211,1983-1984,23,FC Groningen,Feyenoord,1,0,1,3,0,1,1,10.0,10.0
7212,1983-1984,23,SBV Haarlem,FC Den Bosch '67,1,1,3,1,1,2,0,5.0,9.0
7213,1983-1984,23,Roda JC Kerkrade,Willem II,1,0,1,3,0,1,1,13.0,1.0
7214,1983-1984,23,Sparta Rotterdam,Drechtsteden '79,8,1,1,3,0,9,7,6.0,0.0
7215,1983-1984,24,Fortuna Sittard,Go Ahead Eagles,1,2,2,0,3,3,-1,1.0,13.0
7216,1983-1984,24,PEC Zwolle '82,Roda JC Kerkrade,1,2,2,0,3,3,-1,4.0,13.0
7217,1983-1984,24,Willem II,SBV Excelsior,0,2,2,0,3,2,-2,1.0,12.0
7218,1983-1984,24,FC Den Bosch '67,Drechtsteden '79,2,0,1,3,0,2,2,9.0,0.0
7219,1983-1984,24,FC Utrecht,Sparta Rotterdam,2,2,3,1,1,4,0,2.0,6.0
7220,1983-1984,24,FC Volendam,PSV,0,1,2,0,3,1,-1,3.0,13.0
7221,1983-1984,24,Feyenoord,AFC Ajax,4,1,1,3,0,5,3,10.0,10.0
7222,1983-1984,24,SBV Haarlem,FC Groningen,2,1,1,3,0,3,1,8.0,7.0
7223,1983-1984,24,Helmond Sport,AZ '67 Alkmaar,5,3,1,3,0,8,2,4.0,9.0
7224,1983-1984,25,AZ '67 Alkmaar,Fortuna Sittard,2,0,1,3,0,2,2,9.0,1.0
7225,1983-1984,25,FC Groningen,FC Den Bosch '67,1,1,3,1,1,2,0,8.0,7.0
7226,1983-1984,25,PSV,Helmond Sport,5,0,1,3,0,5,5,13.0,3.0
7227,1983-1984,25,AFC Ajax,SBV Haarlem,0,3,2,0,3,3,-3,9.0,10.0
7228,1983-1984,25,Drechtsteden '79,FC Utrecht,0,1,2,0,3,1,-1,0.0,5.0
7229,1983-1984,25,SBV Excelsior,PEC Zwolle '82,4,1,1,3,0,5,3,15.0,3.0
7230,1983-1984,25,Go Ahead Eagles,Feyenoord,1,1,3,1,1,2,0,13.0,8.0
7231,1983-1984,25,Roda JC Kerkrade,FC Volendam,3,0,1,3,0,3,3,15.0,0.0
7232,1983-1984,25,Sparta Rotterdam,Willem II,3,1,1,3,0,4,2,8.0,0.0
7233,1983-1984,26,Fortuna Sittard,PSV,1,2,2,0,3,3,-1,1.0,15.0
7234,1983-1984,26,SBV Haarlem,Go Ahead Eagles,3,1,1,3,0,4,2,10.0,10.0
7235,1983-1984,26,Helmond Sport,Roda JC Kerkrade,3,2,1,3,0,5,1,6.0,12.0
7236,1983-1984,26,PEC Zwolle '82,Sparta Rotterdam,1,1,3,1,1,2,0,4.0,9.0
7237,1983-1984,26,Willem II,Drechtsteden '79,0,1,2,0,3,1,-1,0.0,3.0
7238,1983-1984,26,FC Den Bosch '67,FC Utrecht,3,0,1,3,0,3,3,9.0,4.0
7239,1983-1984,26,FC Groningen,AFC Ajax,1,5,2,0,3,6,-4,5.0,9.0
7240,1983-1984,26,FC Volendam,SBV Excelsior,1,3,2,0,3,4,-2,0.0,15.0
7241,1983-1984,26,Feyenoord,AZ '67 Alkmaar,5,2,1,3,0,7,3,10.0,6.0
7242,1983-1984,27,AZ '67 Alkmaar,SBV Haarlem,4,4,3,1,1,8,0,7.0,11.0
7243,1983-1984,27,Go Ahead Eagles,FC Groningen,2,2,3,1,1,4,0,8.0,5.0
7244,1983-1984,27,PSV,Feyenoord,1,1,3,1,1,2,0,13.0,8.0
7245,1983-1984,27,AFC Ajax,FC Den Bosch '67,5,2,1,3,0,7,3,9.0,8.0
7246,1983-1984,27,Drechtsteden '79,PEC Zwolle '82,4,1,1,3,0,5,3,6.0,1.0
7247,1983-1984,27,SBV Excelsior,Helmond Sport,1,4,2,0,3,5,-3,12.0,9.0
7248,1983-1984,27,FC Utrecht,Willem II,2,0,1,3,0,2,2,7.0,0.0
7249,1983-1984,27,Roda JC Kerkrade,Fortuna Sittard,1,2,2,0,3,3,-1,9.0,3.0
7250,1983-1984,27,Sparta Rotterdam,FC Volendam,3,0,1,3,0,3,3,11.0,0.0
7251,1983-1984,28,Feyenoord,Roda JC Kerkrade,5,2,1,3,0,7,3,11.0,6.0
7252,1983-1984,28,Fortuna Sittard,SBV Excelsior,2,0,1,3,0,2,2,6.0,9.0
7253,1983-1984,28,SBV Haarlem,PSV,0,0,3,1,1,0,0,11.0,11.0
7254,1983-1984,28,Helmond Sport,Sparta Rotterdam,2,3,2,0,3,5,-1,9.0,11.0
7255,1983-1984,28,PEC Zwolle '82,FC Utrecht,1,2,2,0,3,3,-1,1.0,10.0
7256,1983-1984,28,AFC Ajax,Go Ahead Eagles,3,1,1,3,0,4,2,9.0,5.0
7257,1983-1984,28,FC Den Bosch '67,Willem II,2,0,1,3,0,2,2,10.0,0.0
7258,1983-1984,28,FC Groningen,AZ '67 Alkmaar,6,2,1,3,0,8,4,5.0,4.0
7259,1983-1984,28,FC Volendam,Drechtsteden '79,2,0,1,3,0,2,2,3.0,6.0
7260,1983-1984,29,Go Ahead Eagles,FC Den Bosch '67,0,1,2,0,3,1,-1,2.0,10.0
7261,1983-1984,29,PSV,FC Groningen,3,1,1,3,0,4,2,11.0,5.0
7262,1983-1984,29,Willem II,PEC Zwolle '82,1,2,2,0,3,3,-1,0.0,4.0
7263,1983-1984,29,AZ '67 Alkmaar,AFC Ajax,1,1,3,1,1,2,0,5.0,10.0
7264,1983-1984,29,Drechtsteden '79,Helmond Sport,0,4,2,0,3,4,-4,6.0,9.0
7265,1983-1984,29,SBV Excelsior,Feyenoord,0,2,2,0,3,2,-2,6.0,11.0
7266,1983-1984,29,FC Utrecht,FC Volendam,2,2,3,1,1,4,0,10.0,4.0
7267,1983-1984,29,Roda JC Kerkrade,SBV Haarlem,0,1,2,0,3,1,-1,3.0,11.0
7268,1983-1984,29,Sparta Rotterdam,Fortuna Sittard,1,1,3,1,1,2,0,11.0,7.0
7269,1983-1984,30,FC Groningen,Roda JC Kerkrade,4,1,1,3,0,5,3,7.0,0.0
7270,1983-1984,30,AFC Ajax,PSV,1,0,1,3,0,1,1,13.0,8.0
7271,1983-1984,30,FC Den Bosch '67,PEC Zwolle '82,3,1,1,3,0,4,2,12.0,4.0
7272,1983-1984,30,FC Volendam,Willem II,3,2,1,3,0,5,1,7.0,0.0
7273,1983-1984,30,Feyenoord,Sparta Rotterdam,0,0,3,1,1,0,0,11.0,9.0
7274,1983-1984,30,Fortuna Sittard,Drechtsteden '79,4,1,1,3,0,5,3,10.0,6.0
7275,1983-1984,30,Go Ahead Eagles,AZ '67 Alkmaar,1,4,2,0,3,5,-3,1.0,5.0
7276,1983-1984,30,SBV Haarlem,SBV Excelsior,2,2,3,1,1,4,0,9.0,4.0
7277,1983-1984,30,Helmond Sport,FC Utrecht,2,2,3,1,1,4,0,10.0,8.0
7278,1983-1984,31,AZ '67 Alkmaar,FC Den Bosch '67,1,1,3,1,1,2,0,6.0,10.0
7279,1983-1984,31,Drechtsteden '79,Feyenoord,0,3,2,0,3,3,-3,3.0,11.0
7280,1983-1984,31,SBV Excelsior,FC Groningen,3,0,1,3,0,3,3,4.0,7.0
7281,1983-1984,31,FC Utrecht,Fortuna Sittard,0,0,3,1,1,0,0,9.0,11.0
7282,1983-1984,31,PEC Zwolle '82,FC Volendam,1,1,3,1,1,2,0,4.0,8.0
7283,1983-1984,31,PSV,Go Ahead Eagles,7,1,1,3,0,8,6,8.0,1.0
7284,1983-1984,31,Roda JC Kerkrade,AFC Ajax,1,1,3,1,1,2,0,1.0,11.0
7285,1983-1984,31,Sparta Rotterdam,SBV Haarlem,3,4,2,0,3,7,-1,8.0,9.0
7286,1983-1984,31,Willem II,Helmond Sport,0,0,3,1,1,0,0,1.0,8.0
7287,1983-1984,32,AZ '67 Alkmaar,PSV,3,0,1,3,0,3,3,8.0,7.0
7288,1983-1984,32,Fortuna Sittard,Willem II,7,0,1,3,0,7,7,11.0,1.0
7289,1983-1984,32,Go Ahead Eagles,Roda JC Kerkrade,1,2,2,0,3,3,-1,0.0,4.0
7290,1983-1984,32,SBV Haarlem,Drechtsteden '79,2,2,3,1,1,4,0,9.0,1.0
7291,1983-1984,32,Helmond Sport,PEC Zwolle '82,2,6,2,0,3,8,-4,5.0,7.0
7292,1983-1984,32,AFC Ajax,SBV Excelsior,4,0,1,3,0,4,4,11.0,4.0
7293,1983-1984,32,FC Den Bosch '67,FC Volendam,1,2,2,0,3,3,-1,10.0,11.0
7294,1983-1984,32,FC Groningen,Sparta Rotterdam,4,0,1,3,0,4,4,9.0,5.0
7295,1983-1984,32,Feyenoord,FC Utrecht,3,0,1,3,0,3,3,13.0,6.0
7296,1983-1984,33,FC Volendam,Helmond Sport,0,0,3,1,1,0,0,9.0,6.0
7297,1983-1984,33,PEC Zwolle '82,Fortuna Sittard,1,3,2,0,3,4,-2,7.0,11.0
7298,1983-1984,33,Drechtsteden '79,FC Groningen,1,5,2,0,3,6,-4,1.0,9.0
7299,1983-1984,33,SBV Excelsior,Go Ahead Eagles,2,1,1,3,0,3,1,7.0,0.0
7300,1983-1984,33,FC Utrecht,SBV Haarlem,2,1,1,3,0,3,1,6.0,8.0
7301,1983-1984,33,PSV,FC Den Bosch '67,6,1,1,3,0,7,5,9.0,7.0
7302,1983-1984,33,Roda JC Kerkrade,AZ '67 Alkmaar,1,2,2,0,3,3,-1,4.0,11.0
7303,1983-1984,33,Sparta Rotterdam,AFC Ajax,5,2,1,3,0,7,3,5.0,8.0
7304,1983-1984,33,Willem II,Feyenoord,0,5,2,0,3,5,-5,1.0,13.0
7305,1983-1984,34,FC Groningen,FC Utrecht,3,1,1,3,0,4,2,12.0,5.0
7306,1983-1984,34,AZ '67 Alkmaar,SBV Excelsior,2,1,1,3,0,3,1,13.0,7.0
7307,1983-1984,34,Fortuna Sittard,FC Volendam,5,2,1,3,0,7,3,13.0,8.0
7308,1983-1984,34,Go Ahead Eagles,Sparta Rotterdam,5,3,1,3,0,8,2,3.0,4.0
7309,1983-1984,34,SBV Haarlem,Willem II,2,0,1,3,0,2,2,8.0,1.0
7310,1983-1984,34,AFC Ajax,Drechtsteden '79,7,2,1,3,0,9,5,10.0,1.0
7311,1983-1984,34,FC Den Bosch '67,Helmond Sport,3,0,1,3,0,3,3,7.0,3.0
7312,1983-1984,34,Feyenoord,PEC Zwolle '82,2,1,1,3,0,3,1,13.0,4.0
7313,1983-1984,34,PSV,Roda JC Kerkrade,2,0,1,3,0,2,2,9.0,4.0
7314,1984-1985,1,SBV Haarlem,Go Ahead Eagles,3,1,1,3,0,4,2,10.0,3.0
7315,1984-1985,1,MVV Maastricht,AZ '67 Alkmaar,1,1,3,1,1,2,0,3.0,11.0
7316,1984-1985,1,NAC Breda,SBV Excelsior,0,0,3,1,1,0,0,6.0,7.0
7317,1984-1985,1,PEC Zwolle '82,FC Den Bosch '67,1,0,1,3,0,1,1,7.0,4.0
7318,1984-1985,1,PSV,FC Groningen,1,1,3,1,1,2,0,10.0,10.0
7319,1984-1985,1,FC Twente,Fortuna Sittard,3,2,1,3,0,5,1,10.0,10.0
7320,1984-1985,1,FC Volendam,FC Utrecht,3,3,3,1,1,6,0,6.0,5.0
7321,1984-1985,1,Roda JC Kerkrade,Feyenoord,2,1,1,3,0,3,1,7.0,12.0
7322,1984-1985,1,Sparta Rotterdam,AFC Ajax,2,5,2,0,3,7,-3,3.0,10.0
7323,1984-1985,2,SBV Excelsior,Sparta Rotterdam,1,1,3,1,1,2,0,5.0,4.0
7324,1984-1985,2,AFC Ajax,MVV Maastricht,5,1,1,3,0,6,4,12.0,2.0
7325,1984-1985,2,AZ '67 Alkmaar,FC Twente,1,2,2,0,3,3,-1,10.0,10.0
7326,1984-1985,2,FC Den Bosch '67,SBV Haarlem,0,0,3,1,1,0,0,4.0,8.0
7327,1984-1985,2,FC Groningen,FC Volendam,1,3,2,0,3,4,-2,10.0,8.0
7328,1984-1985,2,FC Utrecht,Roda JC Kerkrade,4,0,1,3,0,4,4,7.0,6.0
7329,1984-1985,2,Feyenoord,NAC Breda,1,0,1,3,0,1,1,12.0,5.0
7330,1984-1985,2,Fortuna Sittard,PEC Zwolle '82,1,0,1,3,0,1,1,12.0,6.0
7331,1984-1985,2,Go Ahead Eagles,PSV,0,4,2,0,3,4,-4,3.0,10.0
7332,1984-1985,3,AZ '67 Alkmaar,Sparta Rotterdam,0,2,2,0,3,2,-2,7.0,7.0
7333,1984-1985,3,Fortuna Sittard,MVV Maastricht,1,2,2,0,3,3,-1,9.0,4.0
7334,1984-1985,3,Go Ahead Eagles,PEC Zwolle '82,4,0,1,3,0,4,4,6.0,3.0
7335,1984-1985,3,AFC Ajax,SBV Excelsior,3,0,1,3,0,3,3,12.0,5.0
7336,1984-1985,3,FC Groningen,SBV Haarlem,3,1,1,3,0,4,2,10.0,7.0
7337,1984-1985,3,FC Utrecht,PSV,2,2,3,1,1,4,0,8.0,11.0
7338,1984-1985,3,Roda JC Kerkrade,NAC Breda,4,2,1,3,0,6,2,6.0,4.0
7339,1984-1985,3,Feyenoord,FC Volendam,0,0,3,1,1,0,0,10.0,6.0
7340,1984-1985,3,FC Den Bosch '67,FC Twente,3,0,1,3,0,3,3,7.0,9.0
7341,1984-1985,4,SBV Excelsior,AZ '67 Alkmaar,3,2,1,3,0,5,1,5.0,4.0
7342,1984-1985,4,FC Twente,Go Ahead Eagles,4,1,1,3,0,5,3,12.0,6.0
7343,1984-1985,4,FC Volendam,Roda JC Kerkrade,2,1,1,3,0,3,1,8.0,6.0
7344,1984-1985,4,SBV Haarlem,FC Utrecht,1,1,3,1,1,2,0,8.0,6.0
7345,1984-1985,4,MVV Maastricht,FC Den Bosch '67,0,3,2,0,3,3,-3,4.0,10.0
7346,1984-1985,4,PEC Zwolle '82,FC Groningen,1,4,2,0,3,5,-3,3.0,10.0
7347,1984-1985,4,PSV,Feyenoord,5,1,1,3,0,6,4,11.0,7.0
7348,1984-1985,4,Sparta Rotterdam,Fortuna Sittard,3,2,1,3,0,5,1,7.0,6.0
7349,1984-1985,4,NAC Breda,AFC Ajax,1,2,2,0,3,3,-1,1.0,15.0
7350,1984-1985,5,Fortuna Sittard,SBV Excelsior,1,1,3,1,1,2,0,4.0,6.0
7351,1984-1985,5,Go Ahead Eagles,MVV Maastricht,3,2,1,3,0,5,1,6.0,4.0
7352,1984-1985,5,AZ '67 Alkmaar,AFC Ajax,1,2,2,0,3,3,-1,1.0,15.0
7353,1984-1985,5,FC Den Bosch '67,Sparta Rotterdam,3,0,1,3,0,3,3,10.0,7.0
7354,1984-1985,5,FC Groningen,FC Twente,4,2,1,3,0,6,2,10.0,9.0
7355,1984-1985,5,FC Utrecht,PEC Zwolle '82,4,0,1,3,0,4,4,9.0,3.0
7356,1984-1985,5,FC Volendam,NAC Breda,2,1,1,3,0,3,1,11.0,1.0
7357,1984-1985,5,Feyenoord,SBV Haarlem,4,1,1,3,0,5,3,7.0,5.0
7358,1984-1985,5,Roda JC Kerkrade,PSV,1,3,2,0,3,4,-2,6.0,11.0
7359,1984-1985,6,SBV Haarlem,Roda JC Kerkrade,1,2,2,0,3,3,-1,2.0,6.0
7360,1984-1985,6,MVV Maastricht,FC Groningen,0,3,2,0,3,3,-3,3.0,12.0
7361,1984-1985,6,NAC Breda,AZ '67 Alkmaar,0,0,3,1,1,0,0,1.0,1.0
7362,1984-1985,6,PEC Zwolle '82,Feyenoord,1,5,2,0,3,6,-4,0.0,10.0
7363,1984-1985,6,PSV,FC Volendam,5,0,1,3,0,5,5,13.0,10.0
7364,1984-1985,6,SBV Excelsior,FC Den Bosch '67,1,1,3,1,1,2,0,6.0,11.0
7365,1984-1985,6,FC Twente,FC Utrecht,0,2,2,0,3,2,-2,6.0,11.0
7366,1984-1985,6,Sparta Rotterdam,Go Ahead Eagles,2,1,1,3,0,3,1,10.0,6.0
7367,1984-1985,6,AFC Ajax,Fortuna Sittard,1,0,1,3,0,1,1,15.0,4.0
7368,1984-1985,7,Fortuna Sittard,AZ '67 Alkmaar,0,4,2,0,3,4,-4,1.0,4.0
7369,1984-1985,7,Go Ahead Eagles,SBV Excelsior,3,2,1,3,0,5,1,9.0,5.0
7370,1984-1985,7,PSV,NAC Breda,4,1,1,3,0,5,3,13.0,1.0
7371,1984-1985,7,FC Groningen,Sparta Rotterdam,0,1,2,0,3,1,-1,12.0,12.0
7372,1984-1985,7,FC Utrecht,MVV Maastricht,0,1,2,0,3,1,-1,8.0,6.0
7373,1984-1985,7,FC Volendam,SBV Haarlem,2,1,1,3,0,3,1,10.0,1.0
7374,1984-1985,7,Feyenoord,FC Twente,5,3,1,3,0,8,2,10.0,3.0
7375,1984-1985,7,Roda JC Kerkrade,PEC Zwolle '82,2,0,1,3,0,2,2,9.0,0.0
7376,1984-1985,7,FC Den Bosch '67,AFC Ajax,1,1,3,1,1,2,0,11.0,13.0
7377,1984-1985,8,AZ '67 Alkmaar,FC Den Bosch '67,1,1,3,1,1,2,0,5.0,9.0
7378,1984-1985,8,SBV Haarlem,PSV,1,2,2,0,3,3,-1,1.0,15.0
7379,1984-1985,8,NAC Breda,Fortuna Sittard,0,2,2,0,3,2,-2,1.0,4.0
7380,1984-1985,8,PEC Zwolle '82,FC Volendam,0,0,3,1,1,0,0,1.0,10.0
7381,1984-1985,8,AFC Ajax,Go Ahead Eagles,7,2,1,3,0,9,5,13.0,6.0
7382,1984-1985,8,SBV Excelsior,FC Groningen,3,1,1,3,0,4,2,8.0,9.0
7383,1984-1985,8,FC Twente,Roda JC Kerkrade,3,2,1,3,0,5,1,6.0,6.0
7384,1984-1985,8,MVV Maastricht,Feyenoord,0,4,2,0,3,4,-4,3.0,12.0
7385,1984-1985,8,Sparta Rotterdam,FC Utrecht,1,0,1,3,0,1,1,12.0,7.0
7386,1984-1985,9,AFC Ajax,SBV Haarlem,4,3,1,3,0,7,1,13.0,0.0
7387,1984-1985,9,AZ '67 Alkmaar,PSV,2,2,3,1,1,4,0,6.0,13.0
7388,1984-1985,9,SBV Excelsior,PEC Zwolle '82,5,0,1,3,0,5,5,8.0,1.0
7389,1984-1985,9,Fortuna Sittard,FC Volendam,0,3,2,0,3,3,-3,4.0,10.0
7390,1984-1985,9,NAC Breda,MVV Maastricht,1,1,3,1,1,2,0,2.0,4.0
7391,1984-1985,9,FC Den Bosch '67,Roda JC Kerkrade,0,0,3,1,1,0,0,7.0,7.0
7392,1984-1985,9,Sparta Rotterdam,FC Twente,2,2,3,1,1,4,0,10.0,4.0
7393,1984-1985,9,FC Groningen,FC Utrecht,3,0,1,3,0,3,3,9.0,6.0
7394,1984-1985,9,Go Ahead Eagles,Feyenoord,2,0,1,3,0,2,2,9.0,12.0
7395,1984-1985,10,Go Ahead Eagles,AZ '67 Alkmaar,5,1,1,3,0,6,4,9.0,6.0
7396,1984-1985,10,SBV Haarlem,NAC Breda,1,3,2,0,3,4,-2,0.0,5.0
7397,1984-1985,10,PSV,PEC Zwolle '82,4,1,1,3,0,5,3,13.0,1.0
7398,1984-1985,10,Roda JC Kerkrade,MVV Maastricht,2,2,3,1,1,4,0,8.0,5.0
7399,1984-1985,10,FC Den Bosch '67,Fortuna Sittard,2,4,2,0,3,6,-2,4.0,6.0
7400,1984-1985,10,FC Groningen,AFC Ajax,2,2,3,1,1,4,0,7.0,11.0
7401,1984-1985,10,FC Utrecht,SBV Excelsior,4,1,1,3,0,5,3,6.0,7.0
7402,1984-1985,10,FC Volendam,FC Twente,1,1,3,1,1,2,0,8.0,5.0
7403,1984-1985,10,Feyenoord,Sparta Rotterdam,5,0,1,3,0,5,5,12.0,10.0
7404,1984-1985,11,AZ '67 Alkmaar,FC Groningen,1,1,3,1,1,2,0,6.0,5.0
7405,1984-1985,11,Fortuna Sittard,Go Ahead Eagles,1,0,1,3,0,1,1,9.0,9.0
7406,1984-1985,11,MVV Maastricht,FC Volendam,5,1,1,3,0,6,4,8.0,8.0
7407,1984-1985,11,NAC Breda,FC Den Bosch '67,0,0,3,1,1,0,0,5.0,4.0
7408,1984-1985,11,PEC Zwolle '82,SBV Haarlem,2,1,1,3,0,3,1,4.0,0.0
7409,1984-1985,11,Sparta Rotterdam,Roda JC Kerkrade,0,0,3,1,1,0,0,8.0,6.0
7410,1984-1985,11,AFC Ajax,FC Utrecht,1,0,1,3,0,1,1,11.0,3.0
7411,1984-1985,11,SBV Excelsior,Feyenoord,2,4,2,0,3,6,-2,6.0,12.0
7412,1984-1985,11,FC Twente,PSV,0,0,3,1,1,0,0,6.0,11.0
7413,1984-1985,12,Feyenoord,FC Groningen,2,2,3,1,1,4,0,10.0,6.0
7414,1984-1985,12,MVV Maastricht,Sparta Rotterdam,3,1,1,3,0,4,2,8.0,5.0
7415,1984-1985,12,NAC Breda,FC Utrecht,2,0,1,3,0,2,2,8.0,3.0
7416,1984-1985,12,PEC Zwolle '82,AFC Ajax,1,1,3,1,1,2,0,5.0,11.0
7417,1984-1985,12,PSV,Fortuna Sittard,1,1,3,1,1,2,0,9.0,10.0
7418,1984-1985,12,FC Twente,SBV Excelsior,1,0,1,3,0,1,1,9.0,6.0
7419,1984-1985,12,FC Volendam,FC Den Bosch '67,0,1,2,0,3,1,-1,5.0,6.0
7420,1984-1985,12,SBV Haarlem,AZ '67 Alkmaar,1,1,3,1,1,2,0,1.0,4.0
7421,1984-1985,12,Roda JC Kerkrade,Go Ahead Eagles,0,0,3,1,1,0,0,4.0,7.0
7422,1984-1985,13,SBV Haarlem,FC Twente,1,2,2,0,3,3,-1,1.0,9.0
7423,1984-1985,13,PSV,MVV Maastricht,6,2,1,3,0,8,4,9.0,8.0
7424,1984-1985,13,FC Groningen,Fortuna Sittard,2,0,1,3,0,2,2,9.0,7.0
7425,1984-1985,13,FC Utrecht,AZ '67 Alkmaar,2,0,1,3,0,2,2,6.0,3.0
7426,1984-1985,13,FC Volendam,Sparta Rotterdam,4,1,1,3,0,5,3,7.0,2.0
7427,1984-1985,13,Feyenoord,AFC Ajax,1,3,2,0,3,4,-2,7.0,11.0
7428,1984-1985,13,PEC Zwolle '82,NAC Breda,4,2,1,3,0,6,2,7.0,8.0
7429,1984-1985,13,Roda JC Kerkrade,SBV Excelsior,1,1,3,1,1,2,0,5.0,4.0
7430,1984-1985,13,Go Ahead Eagles,FC Den Bosch '67,0,3,2,0,3,3,-3,7.0,8.0
7431,1984-1985,14,FC Twente,AFC Ajax,1,1,3,1,1,2,0,9.0,9.0
7432,1984-1985,14,FC Volendam,Go Ahead Eagles,0,3,2,0,3,3,-3,4.0,7.0
7433,1984-1985,14,Feyenoord,FC Utrecht,2,0,1,3,0,2,2,10.0,6.0
7434,1984-1985,14,SBV Haarlem,Fortuna Sittard,2,1,1,3,0,3,1,4.0,7.0
7435,1984-1985,14,MVV Maastricht,SBV Excelsior,2,2,3,1,1,4,0,8.0,2.0
7436,1984-1985,14,NAC Breda,Sparta Rotterdam,0,1,2,0,3,1,-1,7.0,4.0
7437,1984-1985,14,PEC Zwolle '82,AZ '67 Alkmaar,3,3,3,1,1,6,0,8.0,3.0
7438,1984-1985,14,PSV,FC Den Bosch '67,0,0,3,1,1,0,0,9.0,8.0
7439,1984-1985,14,Roda JC Kerkrade,FC Groningen,1,2,2,0,3,3,-1,4.0,9.0
7440,1984-1985,15,NAC Breda,Go Ahead Eagles,0,1,2,0,3,1,-1,4.0,7.0
7441,1984-1985,15,AFC Ajax,Roda JC Kerkrade,7,0,1,3,0,7,7,11.0,3.0
7442,1984-1985,15,AZ '67 Alkmaar,Feyenoord,2,5,2,0,3,7,-3,3.0,10.0
7443,1984-1985,15,SBV Excelsior,FC Volendam,1,2,2,0,3,3,-1,2.0,6.0
7444,1984-1985,15,FC Den Bosch '67,FC Groningen,0,0,3,1,1,0,0,9.0,9.0
7445,1984-1985,15,FC Twente,PEC Zwolle '82,6,0,1,3,0,6,6,11.0,8.0
7446,1984-1985,15,Fortuna Sittard,FC Utrecht,1,0,1,3,0,1,1,7.0,3.0
7447,1984-1985,15,MVV Maastricht,SBV Haarlem,0,2,2,0,3,2,-2,7.0,7.0
7448,1984-1985,15,Sparta Rotterdam,PSV,2,2,3,1,1,4,0,5.0,7.0
7449,1984-1985,16,SBV Haarlem,Sparta Rotterdam,0,0,3,1,1,0,0,8.0,5.0
7450,1984-1985,16,PEC Zwolle '82,MVV Maastricht,0,0,3,1,1,0,0,6.0,5.0
7451,1984-1985,16,PSV,SBV Excelsior,2,0,1,3,0,2,2,9.0,2.0
7452,1984-1985,16,FC Groningen,Go Ahead Eagles,2,0,1,3,0,2,2,11.0,7.0
7453,1984-1985,16,FC Twente,NAC Breda,2,0,1,3,0,2,2,13.0,3.0
7454,1984-1985,16,FC Utrecht,FC Den Bosch '67,3,2,1,3,0,5,1,6.0,8.0
7455,1984-1985,16,FC Volendam,AFC Ajax,1,3,2,0,3,4,-2,6.0,11.0
7456,1984-1985,16,Feyenoord,Fortuna Sittard,4,0,1,3,0,4,4,10.0,4.0
7457,1984-1985,16,Roda JC Kerkrade,AZ '67 Alkmaar,4,2,1,3,0,6,2,5.0,2.0
7458,1984-1985,17,AZ '67 Alkmaar,FC Volendam,3,0,1,3,0,3,3,4.0,6.0
7459,1984-1985,17,Go Ahead Eagles,FC Utrecht,3,1,1,3,0,4,2,9.0,6.0
7460,1984-1985,17,NAC Breda,FC Groningen,1,2,2,0,3,3,-1,0.0,13.0
7461,1984-1985,17,AFC Ajax,PSV,1,4,2,0,3,5,-3,10.0,11.0
7462,1984-1985,17,SBV Excelsior,SBV Haarlem,0,1,2,0,3,1,-1,2.0,10.0
7463,1984-1985,17,FC Den Bosch '67,Feyenoord,1,2,2,0,3,3,-1,5.0,12.0
7464,1984-1985,17,Fortuna Sittard,Roda JC Kerkrade,0,0,3,1,1,0,0,4.0,5.0
7465,1984-1985,17,MVV Maastricht,FC Twente,3,0,1,3,0,3,3,5.0,10.0
7466,1984-1985,17,Sparta Rotterdam,PEC Zwolle '82,2,2,3,1,1,4,0,6.0,6.0
7467,1984-1985,18,AZ '67 Alkmaar,MVV Maastricht,2,0,1,3,0,2,2,7.0,5.0
7468,1984-1985,18,AFC Ajax,Sparta Rotterdam,4,0,1,3,0,4,4,10.0,6.0
7469,1984-1985,18,FC Groningen,PSV,0,1,2,0,3,1,-1,10.0,11.0
7470,1984-1985,18,FC Utrecht,FC Volendam,1,1,3,1,1,2,0,4.0,4.0
7471,1984-1985,18,FC Den Bosch '67,PEC Zwolle '82,2,0,1,3,0,2,2,5.0,3.0
7472,1984-1985,18,SBV Excelsior,NAC Breda,1,0,1,3,0,1,1,4.0,0.0
7473,1984-1985,18,Go Ahead Eagles,SBV Haarlem,0,4,2,0,3,4,-4,9.0,13.0
7474,1984-1985,18,Feyenoord,Roda JC Kerkrade,2,1,1,3,0,3,1,15.0,4.0
7475,1984-1985,18,Fortuna Sittard,FC Twente,2,0,1,3,0,2,2,7.0,7.0
7476,1984-1985,19,SBV Haarlem,FC Den Bosch '67,2,1,1,3,0,3,1,13.0,4.0
7477,1984-1985,19,NAC Breda,Feyenoord,1,3,2,0,3,4,-2,0.0,15.0
7478,1984-1985,19,PEC Zwolle '82,Fortuna Sittard,0,2,2,0,3,2,-2,2.0,10.0
7479,1984-1985,19,PSV,Go Ahead Eagles,3,1,1,3,0,4,2,13.0,6.0
7480,1984-1985,19,Sparta Rotterdam,SBV Excelsior,4,0,1,3,0,4,4,6.0,3.0
7481,1984-1985,19,FC Twente,AZ '67 Alkmaar,2,2,3,1,1,4,0,7.0,7.0
7482,1984-1985,19,FC Volendam,FC Groningen,0,3,2,0,3,3,-3,4.0,10.0
7483,1984-1985,19,MVV Maastricht,AFC Ajax,1,3,2,0,3,4,-2,4.0,12.0
7484,1984-1985,19,Roda JC Kerkrade,FC Utrecht,3,0,1,3,0,3,3,7.0,4.0
7485,1984-1985,20,SBV Haarlem,FC Groningen,1,0,1,3,0,1,1,13.0,9.0
7486,1984-1985,20,NAC Breda,Roda JC Kerkrade,2,0,1,3,0,2,2,3.0,7.0
7487,1984-1985,20,PEC Zwolle '82,Go Ahead Eagles,1,0,1,3,0,1,1,5.0,3.0
7488,1984-1985,20,PSV,FC Utrecht,1,1,3,1,1,2,0,13.0,5.0
7489,1984-1985,20,SBV Excelsior,AFC Ajax,0,1,2,0,3,1,-1,3.0,12.0
7490,1984-1985,20,FC Twente,FC Den Bosch '67,0,0,3,1,1,0,0,5.0,4.0
7491,1984-1985,20,FC Volendam,Feyenoord,2,4,2,0,3,6,-2,1.0,15.0
7492,1984-1985,20,MVV Maastricht,Fortuna Sittard,1,0,1,3,0,1,1,7.0,7.0
7493,1984-1985,20,Sparta Rotterdam,AZ '67 Alkmaar,5,2,1,3,0,7,3,8.0,7.0
7494,1984-1985,21,AZ '67 Alkmaar,SBV Excelsior,1,1,3,1,1,2,0,8.0,4.0
7495,1984-1985,21,Go Ahead Eagles,FC Twente,2,1,1,3,0,3,1,6.0,2.0
7496,1984-1985,21,AFC Ajax,NAC Breda,6,1,1,3,0,7,5,12.0,3.0
7497,1984-1985,21,FC Den Bosch '67,MVV Maastricht,0,2,2,0,3,2,-2,4.0,9.0
7498,1984-1985,21,FC Groningen,PEC Zwolle '82,1,0,1,3,0,1,1,9.0,4.0
7499,1984-1985,21,FC Utrecht,SBV Haarlem,0,2,2,0,3,2,-2,2.0,15.0
7500,1984-1985,21,Feyenoord,PSV,2,2,3,1,1,4,0,13.0,11.0
7501,1984-1985,21,Fortuna Sittard,Sparta Rotterdam,3,0,1,3,0,3,3,10.0,7.0
7502,1984-1985,21,Roda JC Kerkrade,FC Volendam,1,0,1,3,0,1,1,7.0,1.0
7503,1984-1985,22,NAC Breda,FC Volendam,1,0,1,3,0,1,1,6.0,1.0
7504,1984-1985,22,PEC Zwolle '82,FC Utrecht,0,2,2,0,3,2,-2,3.0,5.0
7505,1984-1985,22,PSV,Roda JC Kerkrade,1,0,1,3,0,1,1,11.0,6.0
7506,1984-1985,22,AFC Ajax,AZ '67 Alkmaar,4,2,1,3,0,6,2,15.0,5.0
7507,1984-1985,22,SBV Excelsior,Fortuna Sittard,1,1,3,1,1,2,0,5.0,10.0
7508,1984-1985,22,FC Twente,FC Groningen,1,2,2,0,3,3,-1,2.0,9.0
7509,1984-1985,22,SBV Haarlem,Feyenoord,2,3,2,0,3,5,-1,12.0,13.0
7510,1984-1985,22,Sparta Rotterdam,FC Den Bosch '67,2,1,1,3,0,3,1,9.0,4.0
7511,1984-1985,22,MVV Maastricht,Go Ahead Eagles,0,0,3,1,1,0,0,7.0,4.0
7512,1984-1985,23,AZ '67 Alkmaar,NAC Breda,1,0,1,3,0,1,1,5.0,6.0
7513,1984-1985,23,Go Ahead Eagles,Sparta Rotterdam,1,2,2,0,3,3,-1,4.0,12.0
7514,1984-1985,23,FC Den Bosch '67,SBV Excelsior,0,0,3,1,1,0,0,2.0,3.0
7515,1984-1985,23,FC Groningen,MVV Maastricht,1,1,3,1,1,2,0,10.0,8.0
7516,1984-1985,23,FC Utrecht,FC Twente,3,1,1,3,0,4,2,7.0,2.0
7517,1984-1985,23,FC Volendam,PSV,0,5,2,0,3,5,-5,0.0,11.0
7518,1984-1985,23,Feyenoord,PEC Zwolle '82,6,0,1,3,0,6,6,13.0,3.0
7519,1984-1985,23,Fortuna Sittard,AFC Ajax,0,2,2,0,3,2,-2,7.0,15.0
7520,1984-1985,23,Roda JC Kerkrade,SBV Haarlem,0,0,3,1,1,0,0,7.0,10.0
7521,1984-1985,24,AZ '67 Alkmaar,Fortuna Sittard,2,1,1,3,0,3,1,7.0,4.0
7522,1984-1985,24,SBV Haarlem,FC Volendam,1,0,1,3,0,1,1,10.0,0.0
7523,1984-1985,24,NAC Breda,PSV,0,0,3,1,1,0,0,7.0,9.0
7524,1984-1985,24,PEC Zwolle '82,Roda JC Kerkrade,3,4,2,0,3,7,-1,3.0,7.0
7525,1984-1985,24,SBV Excelsior,Go Ahead Eagles,1,1,3,1,1,2,0,4.0,5.0
7526,1984-1985,24,FC Twente,Feyenoord,2,2,3,1,1,4,0,2.0,11.0
7527,1984-1985,24,MVV Maastricht,FC Utrecht,2,1,1,3,0,3,1,11.0,7.0
7528,1984-1985,24,AFC Ajax,FC Den Bosch '67,2,2,3,1,1,4,0,13.0,3.0
7529,1984-1985,24,Sparta Rotterdam,FC Groningen,2,0,1,3,0,2,2,12.0,7.0
7530,1984-1985,25,Fortuna Sittard,NAC Breda,7,2,1,3,0,9,5,7.0,4.0
7531,1984-1985,25,PSV,SBV Haarlem,7,1,1,3,0,8,6,11.0,7.0
7532,1984-1985,25,FC Groningen,SBV Excelsior,2,0,1,3,0,2,2,10.0,4.0
7533,1984-1985,25,FC Utrecht,Sparta Rotterdam,1,0,1,3,0,1,1,9.0,9.0
7534,1984-1985,25,FC Volendam,PEC Zwolle '82,2,1,1,3,0,3,1,3.0,0.0
7535,1984-1985,25,Go Ahead Eagles,AFC Ajax,0,2,2,0,3,2,-2,5.0,13.0
7536,1984-1985,25,Roda JC Kerkrade,FC Twente,5,1,1,3,0,6,4,10.0,1.0
7537,1984-1985,25,FC Den Bosch '67,AZ '67 Alkmaar,2,2,3,1,1,4,0,3.0,8.0
7538,1984-1985,25,Feyenoord,MVV Maastricht,3,1,1,3,0,4,2,11.0,8.0
7539,1984-1985,26,FC Twente,Sparta Rotterdam,1,6,2,0,3,7,-5,1.0,12.0
7540,1984-1985,26,FC Utrecht,FC Groningen,2,0,1,3,0,2,2,12.0,7.0
7541,1984-1985,26,Feyenoord,Go Ahead Eagles,1,0,1,3,0,1,1,13.0,2.0
7542,1984-1985,26,MVV Maastricht,NAC Breda,0,1,2,0,3,1,-1,5.0,7.0
7543,1984-1985,26,PEC Zwolle '82,SBV Excelsior,2,2,3,1,1,4,0,1.0,4.0
7544,1984-1985,26,PSV,AZ '67 Alkmaar,7,2,1,3,0,9,5,13.0,7.0
7545,1984-1985,26,SBV Haarlem,AFC Ajax,1,0,1,3,0,1,1,7.0,10.0
7546,1984-1985,26,FC Volendam,Fortuna Sittard,0,3,2,0,3,3,-3,3.0,7.0
7547,1984-1985,26,Roda JC Kerkrade,FC Den Bosch '67,1,1,3,1,1,2,0,8.0,4.0
7548,1984-1985,27,AZ '67 Alkmaar,Go Ahead Eagles,3,3,3,1,1,6,0,8.0,2.0
7549,1984-1985,27,Fortuna Sittard,FC Den Bosch '67,0,2,2,0,3,2,-2,6.0,7.0
7550,1984-1985,27,MVV Maastricht,Roda JC Kerkrade,0,1,2,0,3,1,-1,4.0,11.0
7551,1984-1985,27,NAC Breda,SBV Haarlem,1,2,2,0,3,3,-1,4.0,10.0
7552,1984-1985,27,PEC Zwolle '82,PSV,1,1,3,1,1,2,0,2.0,11.0
7553,1984-1985,27,AFC Ajax,FC Groningen,1,3,2,0,3,4,-2,7.0,7.0
7554,1984-1985,27,SBV Excelsior,FC Utrecht,1,0,1,3,0,1,1,6.0,9.0
7555,1984-1985,27,FC Twente,FC Volendam,3,0,1,3,0,3,3,4.0,3.0
7556,1984-1985,27,Sparta Rotterdam,Feyenoord,3,1,1,3,0,4,2,12.0,10.0
7557,1984-1985,28,FC Utrecht,AFC Ajax,0,1,2,0,3,1,-1,6.0,7.0
7558,1984-1985,28,FC Groningen,AZ '67 Alkmaar,2,6,2,0,3,8,-4,6.0,8.0
7559,1984-1985,28,FC Volendam,MVV Maastricht,0,1,2,0,3,1,-1,3.0,6.0
7560,1984-1985,28,Feyenoord,SBV Excelsior,2,1,1,3,0,3,1,10.0,5.0
7561,1984-1985,28,Go Ahead Eagles,Fortuna Sittard,0,1,2,0,3,1,-1,2.0,9.0
7562,1984-1985,28,PSV,FC Twente,2,2,3,1,1,4,0,9.0,5.0
7563,1984-1985,28,SBV Haarlem,PEC Zwolle '82,4,2,1,3,0,6,2,12.0,2.0
7564,1984-1985,28,FC Den Bosch '67,NAC Breda,4,1,1,3,0,5,3,9.0,4.0
7565,1984-1985,28,Roda JC Kerkrade,Sparta Rotterdam,5,3,1,3,0,8,2,13.0,9.0
7566,1984-1985,29,FC Groningen,Feyenoord,1,1,3,1,1,2,0,7.0,10.0
7567,1984-1985,29,AFC Ajax,PEC Zwolle '82,2,1,1,3,0,3,1,9.0,2.0
7568,1984-1985,29,AZ '67 Alkmaar,SBV Haarlem,1,1,3,1,1,2,0,6.0,10.0
7569,1984-1985,29,SBV Excelsior,FC Twente,1,2,2,0,3,3,-1,4.0,7.0
7570,1984-1985,29,FC Den Bosch '67,FC Volendam,0,0,3,1,1,0,0,9.0,4.0
7571,1984-1985,29,FC Utrecht,NAC Breda,2,0,1,3,0,2,2,9.0,3.0
7572,1984-1985,29,Fortuna Sittard,PSV,2,1,1,3,0,3,1,12.0,8.0
7573,1984-1985,29,Go Ahead Eagles,Roda JC Kerkrade,3,1,1,3,0,4,2,4.0,10.0
7574,1984-1985,29,Sparta Rotterdam,MVV Maastricht,1,0,1,3,0,1,1,9.0,3.0
7575,1984-1985,30,NAC Breda,PEC Zwolle '82,7,3,1,3,0,10,4,6.0,2.0
7576,1984-1985,30,AZ '67 Alkmaar,FC Utrecht,1,0,1,3,0,1,1,8.0,6.0
7577,1984-1985,30,Fortuna Sittard,FC Groningen,2,2,3,1,1,4,0,10.0,5.0
7578,1984-1985,30,MVV Maastricht,PSV,1,1,3,1,1,2,0,4.0,6.0
7579,1984-1985,30,AFC Ajax,Feyenoord,4,2,1,3,0,6,2,9.0,7.0
7580,1984-1985,30,SBV Excelsior,Roda JC Kerkrade,4,0,1,3,0,4,4,7.0,7.0
7581,1984-1985,30,FC Den Bosch '67,Go Ahead Eagles,3,0,1,3,0,3,3,11.0,4.0
7582,1984-1985,30,FC Twente,SBV Haarlem,3,1,1,3,0,4,2,10.0,10.0
7583,1984-1985,30,Sparta Rotterdam,FC Volendam,3,0,1,3,0,3,3,12.0,1.0
7584,1984-1985,31,Fortuna Sittard,SBV Haarlem,1,1,3,1,1,2,0,8.0,8.0
7585,1984-1985,31,AZ '67 Alkmaar,PEC Zwolle '82,3,1,1,3,0,4,2,11.0,1.0
7586,1984-1985,31,Go Ahead Eagles,FC Volendam,0,0,3,1,1,0,0,5.0,2.0
7587,1984-1985,31,Sparta Rotterdam,NAC Breda,5,1,1,3,0,6,4,12.0,3.0
7588,1984-1985,31,SBV Excelsior,MVV Maastricht,1,0,1,3,0,1,1,9.0,4.0
7589,1984-1985,31,FC Den Bosch '67,PSV,2,1,1,3,0,3,1,13.0,3.0
7590,1984-1985,31,FC Groningen,Roda JC Kerkrade,2,2,3,1,1,4,0,6.0,7.0
7591,1984-1985,31,FC Utrecht,Feyenoord,2,3,2,0,3,5,-1,3.0,7.0
7592,1984-1985,31,AFC Ajax,FC Twente,4,4,3,1,1,8,0,10.0,11.0
7593,1984-1985,32,FC Groningen,FC Den Bosch '67,1,1,3,1,1,2,0,4.0,11.0
7594,1984-1985,32,FC Utrecht,Fortuna Sittard,2,1,1,3,0,3,1,6.0,8.0
7595,1984-1985,32,FC Volendam,SBV Excelsior,1,3,2,0,3,4,-2,2.0,9.0
7596,1984-1985,32,Feyenoord,AZ '67 Alkmaar,1,1,3,1,1,2,0,8.0,11.0
7597,1984-1985,32,Go Ahead Eagles,NAC Breda,4,0,1,3,0,4,4,7.0,3.0
7598,1984-1985,32,SBV Haarlem,MVV Maastricht,1,1,3,1,1,2,0,6.0,5.0
7599,1984-1985,32,PEC Zwolle '82,FC Twente,1,1,3,1,1,2,0,1.0,9.0
7600,1984-1985,32,PSV,Sparta Rotterdam,0,0,3,1,1,0,0,3.0,10.0
7601,1984-1985,32,Roda JC Kerkrade,AFC Ajax,2,3,2,0,3,5,-1,4.0,13.0
7602,1984-1985,33,AFC Ajax,FC Volendam,5,2,1,3,0,7,3,13.0,2.0
7603,1984-1985,33,AZ '67 Alkmaar,Roda JC Kerkrade,1,1,3,1,1,2,0,9.0,2.0
7604,1984-1985,33,SBV Excelsior,PSV,2,0,1,3,0,2,2,12.0,2.0
7605,1984-1985,33,FC Den Bosch '67,FC Utrecht,2,2,3,1,1,4,0,9.0,7.0
7606,1984-1985,33,Fortuna Sittard,Feyenoord,3,2,1,3,0,5,1,8.0,5.0
7607,1984-1985,33,Go Ahead Eagles,FC Groningen,2,2,3,1,1,4,0,8.0,5.0
7608,1984-1985,33,MVV Maastricht,PEC Zwolle '82,2,1,1,3,0,3,1,5.0,1.0
7609,1984-1985,33,NAC Breda,FC Twente,2,1,1,3,0,3,1,6.0,8.0
7610,1984-1985,33,Sparta Rotterdam,SBV Haarlem,4,1,1,3,0,5,3,13.0,3.0
7611,1984-1985,34,FC Volendam,AZ '67 Alkmaar,5,2,1,3,0,7,3,4.0,8.0
7612,1984-1985,34,Feyenoord,FC Den Bosch '67,3,1,1,3,0,4,2,7.0,8.0
7613,1984-1985,34,PEC Zwolle '82,Sparta Rotterdam,1,1,3,1,1,2,0,2.0,11.0
7614,1984-1985,34,FC Groningen,NAC Breda,2,1,1,3,0,3,1,7.0,6.0
7615,1984-1985,34,FC Twente,MVV Maastricht,3,1,1,3,0,4,2,8.0,5.0
7616,1984-1985,34,FC Utrecht,Go Ahead Eagles,2,0,1,3,0,2,2,7.0,5.0
7617,1984-1985,34,SBV Haarlem,SBV Excelsior,5,5,3,1,1,10,0,3.0,13.0
7618,1984-1985,34,PSV,AFC Ajax,4,0,1,3,0,4,4,5.0,10.0
7619,1984-1985,34,Roda JC Kerkrade,Fortuna Sittard,2,3,2,0,3,5,-1,2.0,8.0
7620,1985-1986,1,AZ '67 Alkmaar,FC Den Bosch '67,1,4,2,0,3,5,-3,5.0,8.0
7621,1985-1986,1,MVV Maastricht,Fortuna Sittard,1,1,3,1,1,2,0,5.0,8.0
7622,1985-1986,1,PSV,SBV Haarlem,1,0,1,3,0,1,1,7.0,3.0
7623,1985-1986,1,Roda JC Kerkrade,NEC Nijmegen,6,1,1,3,0,7,5,5.0,2.0
7624,1985-1986,1,SBV Excelsior,AFC Ajax,2,3,2,0,3,5,-1,10.0,10.0
7625,1985-1986,1,FC Groningen,FC Utrecht,0,0,3,1,1,0,0,7.0,8.0
7626,1985-1986,1,Heracles Almelo,Go Ahead Eagles,1,0,1,3,0,1,1,8.0,5.0
7627,1985-1986,1,VVV-Venlo,Feyenoord,0,1,2,0,3,1,-1,3.0,10.0
7628,1985-1986,1,Sparta Rotterdam,FC Twente,2,0,1,3,0,2,2,11.0,5.0
7629,1985-1986,2,FC Den Bosch '67,PSV,2,0,1,3,0,2,2,8.0,7.0
7630,1985-1986,2,FC Twente,SBV Excelsior,1,1,3,1,1,2,0,5.0,8.0
7631,1985-1986,2,FC Utrecht,VVV-Venlo,2,0,1,3,0,2,2,11.0,3.0
7632,1985-1986,2,Feyenoord,Heracles Almelo,5,1,1,3,0,6,4,10.0,5.0
7633,1985-1986,2,Fortuna Sittard,AZ '67 Alkmaar,1,1,3,1,1,2,0,8.0,3.0
7634,1985-1986,2,Go Ahead Eagles,Roda JC Kerkrade,3,1,1,3,0,4,2,7.0,4.0
7635,1985-1986,2,SBV Haarlem,FC Groningen,0,3,2,0,3,3,-3,2.0,9.0
7636,1985-1986,2,NEC Nijmegen,Sparta Rotterdam,1,0,1,3,0,1,1,4.0,8.0
7637,1985-1986,2,AFC Ajax,MVV Maastricht,2,1,1,3,0,3,1,12.0,5.0
7638,1985-1986,3,Go Ahead Eagles,NEC Nijmegen,3,1,1,3,0,4,2,7.0,3.0
7639,1985-1986,3,MVV Maastricht,FC Twente,0,0,3,1,1,0,0,5.0,5.0
7640,1985-1986,3,PSV,Fortuna Sittard,2,1,1,3,0,3,1,9.0,8.0
7641,1985-1986,3,Roda JC Kerkrade,Feyenoord,2,0,1,3,0,2,2,7.0,9.0
7642,1985-1986,3,VVV-Venlo,SBV Haarlem,1,1,3,1,1,2,0,4.0,2.0
7643,1985-1986,3,AZ '67 Alkmaar,AFC Ajax,1,2,2,0,3,3,-1,2.0,12.0
7644,1985-1986,3,SBV Excelsior,Sparta Rotterdam,1,3,2,0,3,4,-2,5.0,10.0
7645,1985-1986,3,FC Groningen,FC Den Bosch '67,1,0,1,3,0,1,1,11.0,7.0
7646,1985-1986,3,Heracles Almelo,FC Utrecht,2,3,2,0,3,5,-1,5.0,11.0
7647,1985-1986,4,AFC Ajax,PSV,2,4,2,0,3,6,-2,9.0,12.0
7648,1985-1986,4,FC Den Bosch '67,VVV-Venlo,4,0,1,3,0,4,4,9.0,1.0
7649,1985-1986,4,FC Twente,AZ '67 Alkmaar,2,1,1,3,0,3,1,8.0,1.0
7650,1985-1986,4,FC Utrecht,Roda JC Kerkrade,2,0,1,3,0,2,2,13.0,6.0
7651,1985-1986,4,Feyenoord,Go Ahead Eagles,5,0,1,3,0,5,5,12.0,6.0
7652,1985-1986,4,Fortuna Sittard,FC Groningen,2,1,1,3,0,3,1,8.0,10.0
7653,1985-1986,4,SBV Haarlem,Heracles Almelo,5,2,1,3,0,7,3,5.0,4.0
7654,1985-1986,4,NEC Nijmegen,SBV Excelsior,0,1,2,0,3,1,-1,3.0,5.0
7655,1985-1986,4,Sparta Rotterdam,MVV Maastricht,1,0,1,3,0,1,1,10.0,2.0
7656,1985-1986,5,AZ '67 Alkmaar,Sparta Rotterdam,0,1,2,0,3,1,-1,1.0,12.0
7657,1985-1986,5,Go Ahead Eagles,FC Utrecht,4,3,1,3,0,7,1,9.0,10.0
7658,1985-1986,5,MVV Maastricht,SBV Excelsior,2,1,1,3,0,3,1,5.0,4.0
7659,1985-1986,5,PSV,FC Twente,4,0,1,3,0,4,4,12.0,5.0
7660,1985-1986,5,Heracles Almelo,FC Den Bosch '67,0,3,2,0,3,3,-3,3.0,12.0
7661,1985-1986,5,VVV-Venlo,Fortuna Sittard,0,3,2,0,3,3,-3,1.0,8.0
7662,1985-1986,5,FC Groningen,AFC Ajax,2,1,1,3,0,3,1,10.0,9.0
7663,1985-1986,5,Feyenoord,NEC Nijmegen,1,0,1,3,0,1,1,12.0,3.0
7664,1985-1986,5,Roda JC Kerkrade,SBV Haarlem,0,0,3,1,1,0,0,7.0,5.0
7665,1985-1986,6,Fortuna Sittard,Heracles Almelo,1,0,1,3,0,1,1,10.0,0.0
7666,1985-1986,6,NEC Nijmegen,MVV Maastricht,1,1,3,1,1,2,0,4.0,5.0
7667,1985-1986,6,AFC Ajax,VVV-Venlo,7,1,1,3,0,8,6,9.0,1.0
7668,1985-1986,6,SBV Excelsior,AZ '67 Alkmaar,1,0,1,3,0,1,1,7.0,1.0
7669,1985-1986,6,FC Den Bosch '67,Roda JC Kerkrade,2,2,3,1,1,4,0,10.0,5.0
7670,1985-1986,6,FC Twente,FC Groningen,1,0,1,3,0,1,1,8.0,9.0
7671,1985-1986,6,FC Utrecht,Feyenoord,0,2,2,0,3,2,-2,9.0,12.0
7672,1985-1986,6,SBV Haarlem,Go Ahead Eagles,2,1,1,3,0,3,1,8.0,9.0
7673,1985-1986,6,Sparta Rotterdam,PSV,1,1,3,1,1,2,0,10.0,10.0
7674,1985-1986,7,AZ '67 Alkmaar,MVV Maastricht,2,1,1,3,0,3,1,3.0,5.0
7675,1985-1986,7,Go Ahead Eagles,FC Den Bosch '67,2,1,1,3,0,3,1,9.0,7.0
7676,1985-1986,7,PSV,SBV Excelsior,4,0,1,3,0,4,4,13.0,6.0
7677,1985-1986,7,VVV-Venlo,FC Twente,1,1,3,1,1,2,0,2.0,8.0
7678,1985-1986,7,FC Groningen,Sparta Rotterdam,2,2,3,1,1,4,0,7.0,11.0
7679,1985-1986,7,FC Utrecht,NEC Nijmegen,4,1,1,3,0,5,3,9.0,1.0
7680,1985-1986,7,Feyenoord,SBV Haarlem,2,0,1,3,0,2,2,12.0,8.0
7681,1985-1986,7,Roda JC Kerkrade,Fortuna Sittard,2,3,2,0,3,5,-1,5.0,12.0
7682,1985-1986,7,Heracles Almelo,AFC Ajax,1,8,2,0,3,9,-7,0.0,9.0
7683,1985-1986,8,MVV Maastricht,PSV,0,6,2,0,3,6,-6,4.0,13.0
7684,1985-1986,8,Fortuna Sittard,Go Ahead Eagles,4,0,1,3,0,4,4,15.0,6.0
7685,1985-1986,8,NEC Nijmegen,AZ '67 Alkmaar,1,1,3,1,1,2,0,2.0,4.0
7686,1985-1986,8,AFC Ajax,Roda JC Kerkrade,6,0,1,3,0,6,6,9.0,2.0
7687,1985-1986,8,SBV Excelsior,FC Groningen,1,2,2,0,3,3,-1,6.0,7.0
7688,1985-1986,8,FC Den Bosch '67,Feyenoord,1,1,3,1,1,2,0,8.0,13.0
7689,1985-1986,8,FC Twente,Heracles Almelo,0,3,2,0,3,3,-3,7.0,3.0
7690,1985-1986,8,SBV Haarlem,FC Utrecht,3,0,1,3,0,3,3,10.0,6.0
7691,1985-1986,8,Sparta Rotterdam,VVV-Venlo,1,3,2,0,3,4,-2,8.0,4.0
7692,1985-1986,9,PSV,AZ '67 Alkmaar,4,0,1,3,0,4,4,13.0,4.0
7693,1985-1986,9,Heracles Almelo,Sparta Rotterdam,0,0,3,1,1,0,0,4.0,6.0
7694,1985-1986,9,VVV-Venlo,SBV Excelsior,1,0,1,3,0,1,1,7.0,3.0
7695,1985-1986,9,FC Groningen,MVV Maastricht,3,1,1,3,0,4,2,10.0,4.0
7696,1985-1986,9,FC Utrecht,FC Den Bosch '67,1,1,3,1,1,2,0,4.0,6.0
7697,1985-1986,9,Feyenoord,Fortuna Sittard,3,1,1,3,0,4,2,13.0,12.0
7698,1985-1986,9,Go Ahead Eagles,AFC Ajax,1,2,2,0,3,3,-1,6.0,12.0
7699,1985-1986,9,SBV Haarlem,NEC Nijmegen,4,1,1,3,0,5,3,10.0,2.0
7700,1985-1986,9,Roda JC Kerkrade,FC Twente,5,0,1,3,0,5,5,5.0,4.0
7701,1985-1986,10,AZ '67 Alkmaar,FC Groningen,1,1,3,1,1,2,0,5.0,8.0
7702,1985-1986,10,MVV Maastricht,VVV-Venlo,3,1,1,3,0,4,2,4.0,7.0
7703,1985-1986,10,NEC Nijmegen,PSV,2,5,2,0,3,7,-3,2.0,13.0
7704,1985-1986,10,AFC Ajax,Feyenoord,1,2,2,0,3,3,-1,12.0,13.0
7705,1985-1986,10,SBV Excelsior,Heracles Almelo,3,0,1,3,0,3,3,6.0,4.0
7706,1985-1986,10,FC Den Bosch '67,SBV Haarlem,3,0,1,3,0,3,3,6.0,9.0
7707,1985-1986,10,FC Twente,Go Ahead Eagles,0,0,3,1,1,0,0,5.0,4.0
7708,1985-1986,10,Fortuna Sittard,FC Utrecht,1,1,3,1,1,2,0,10.0,5.0
7709,1985-1986,10,Sparta Rotterdam,Roda JC Kerkrade,2,4,2,0,3,6,-2,3.0,7.0
7710,1985-1986,11,Go Ahead Eagles,Sparta Rotterdam,0,0,3,1,1,0,0,5.0,3.0
7711,1985-1986,11,Heracles Almelo,MVV Maastricht,0,2,2,0,3,2,-2,4.0,6.0
7712,1985-1986,11,VVV-Venlo,AZ '67 Alkmaar,4,0,1,3,0,4,4,10.0,5.0
7713,1985-1986,11,FC Den Bosch '67,NEC Nijmegen,2,0,1,3,0,2,2,8.0,1.0
7714,1985-1986,11,FC Groningen,PSV,1,6,2,0,3,7,-5,8.0,15.0
7715,1985-1986,11,FC Utrecht,AFC Ajax,1,0,1,3,0,1,1,8.0,9.0
7716,1985-1986,11,Feyenoord,FC Twente,2,1,1,3,0,3,1,13.0,2.0
7717,1985-1986,11,SBV Haarlem,Fortuna Sittard,0,0,3,1,1,0,0,7.0,8.0
7718,1985-1986,11,Roda JC Kerkrade,SBV Excelsior,3,1,1,3,0,4,2,9.0,3.0
7719,1985-1986,12,AZ '67 Alkmaar,Heracles Almelo,2,0,1,3,0,2,2,5.0,4.0
7720,1985-1986,12,MVV Maastricht,Roda JC Kerkrade,1,1,3,1,1,2,0,7.0,10.0
7721,1985-1986,12,NEC Nijmegen,FC Groningen,2,1,1,3,0,3,1,4.0,7.0
7722,1985-1986,12,PSV,VVV-Venlo,3,0,1,3,0,3,3,15.0,9.0
7723,1985-1986,12,AFC Ajax,SBV Haarlem,5,1,1,3,0,6,4,9.0,7.0
7724,1985-1986,12,SBV Excelsior,Go Ahead Eagles,0,1,2,0,3,1,-1,3.0,5.0
7725,1985-1986,12,FC Twente,FC Utrecht,2,1,1,3,0,3,1,4.0,5.0
7726,1985-1986,12,Fortuna Sittard,FC Den Bosch '67,0,2,2,0,3,2,-2,5.0,11.0
7727,1985-1986,12,Sparta Rotterdam,Feyenoord,2,5,2,0,3,7,-3,2.0,13.0
7728,1985-1986,13,Fortuna Sittard,NEC Nijmegen,0,2,2,0,3,2,-2,2.0,6.0
7729,1985-1986,13,Go Ahead Eagles,MVV Maastricht,3,1,1,3,0,4,2,8.0,7.0
7730,1985-1986,13,Heracles Almelo,PSV,0,2,2,0,3,2,-2,1.0,15.0
7731,1985-1986,13,VVV-Venlo,FC Groningen,0,1,2,0,3,1,-1,6.0,7.0
7732,1985-1986,13,FC Den Bosch '67,AFC Ajax,0,3,2,0,3,3,-3,10.0,9.0
7733,1985-1986,13,FC Utrecht,Sparta Rotterdam,2,0,1,3,0,2,2,8.0,2.0
7734,1985-1986,13,Feyenoord,SBV Excelsior,2,1,1,3,0,3,1,15.0,3.0
7735,1985-1986,13,SBV Haarlem,FC Twente,3,0,1,3,0,3,3,7.0,4.0
7736,1985-1986,13,Roda JC Kerkrade,AZ '67 Alkmaar,6,0,1,3,0,6,6,13.0,4.0
7737,1985-1986,14,AZ '67 Alkmaar,Go Ahead Eagles,2,1,1,3,0,3,1,7.0,8.0
7738,1985-1986,14,MVV Maastricht,Feyenoord,1,1,3,1,1,2,0,8.0,13.0
7739,1985-1986,14,NEC Nijmegen,VVV-Venlo,1,0,1,3,0,1,1,9.0,3.0
7740,1985-1986,14,PSV,Roda JC Kerkrade,5,0,1,3,0,5,5,15.0,10.0
7741,1985-1986,14,AFC Ajax,Fortuna Sittard,4,1,1,3,0,5,3,9.0,2.0
7742,1985-1986,14,SBV Excelsior,FC Utrecht,0,1,2,0,3,1,-1,3.0,10.0
7743,1985-1986,14,FC Twente,FC Den Bosch '67,2,1,1,3,0,3,1,7.0,9.0
7744,1985-1986,14,FC Groningen,Heracles Almelo,1,0,1,3,0,1,1,7.0,0.0
7745,1985-1986,14,Sparta Rotterdam,SBV Haarlem,0,4,2,0,3,4,-4,1.0,7.0
7746,1985-1986,15,AFC Ajax,NEC Nijmegen,2,0,1,3,0,2,2,12.0,9.0
7747,1985-1986,15,FC Den Bosch '67,Sparta Rotterdam,0,0,3,1,1,0,0,7.0,2.0
7748,1985-1986,15,FC Utrecht,MVV Maastricht,3,0,1,3,0,3,3,12.0,5.0
7749,1985-1986,15,Feyenoord,AZ '67 Alkmaar,3,4,2,0,3,7,-1,10.0,9.0
7750,1985-1986,15,Fortuna Sittard,FC Twente,2,1,1,3,0,3,1,4.0,6.0
7751,1985-1986,15,Go Ahead Eagles,PSV,1,3,2,0,3,4,-2,7.0,15.0
7752,1985-1986,15,SBV Haarlem,SBV Excelsior,2,3,2,0,3,5,-1,7.0,3.0
7753,1985-1986,15,Roda JC Kerkrade,FC Groningen,2,0,1,3,0,2,2,10.0,6.0
7754,1985-1986,15,Heracles Almelo,VVV-Venlo,0,2,2,0,3,2,-2,0.0,6.0
7755,1985-1986,16,MVV Maastricht,SBV Haarlem,0,2,2,0,3,2,-2,2.0,9.0
7756,1985-1986,16,Heracles Almelo,NEC Nijmegen,2,2,3,1,1,4,0,1.0,10.0
7757,1985-1986,16,VVV-Venlo,Roda JC Kerkrade,2,1,1,3,0,3,1,6.0,7.0
7758,1985-1986,16,SBV Excelsior,FC Den Bosch '67,1,1,3,1,1,2,0,4.0,5.0
7759,1985-1986,16,FC Groningen,Go Ahead Eagles,3,1,1,3,0,4,2,9.0,6.0
7760,1985-1986,16,FC Twente,AFC Ajax,1,8,2,0,3,9,-7,6.0,15.0
7761,1985-1986,16,PSV,Feyenoord,5,0,1,3,0,5,5,15.0,7.0
7762,1985-1986,16,Sparta Rotterdam,Fortuna Sittard,2,2,3,1,1,4,0,2.0,4.0
7763,1985-1986,16,AZ '67 Alkmaar,FC Utrecht,4,1,1,3,0,5,3,12.0,9.0
7764,1985-1986,17,Go Ahead Eagles,VVV-Venlo,2,1,1,3,0,3,1,6.0,6.0
7765,1985-1986,17,AFC Ajax,Sparta Rotterdam,9,0,1,3,0,9,9,15.0,2.0
7766,1985-1986,17,FC Den Bosch '67,MVV Maastricht,4,3,1,3,0,7,1,5.0,1.0
7767,1985-1986,17,FC Utrecht,PSV,0,3,2,0,3,3,-3,9.0,15.0
7768,1985-1986,17,Feyenoord,FC Groningen,4,1,1,3,0,5,3,7.0,9.0
7769,1985-1986,17,Fortuna Sittard,SBV Excelsior,3,0,1,3,0,3,3,7.0,4.0
7770,1985-1986,17,SBV Haarlem,AZ '67 Alkmaar,2,3,2,0,3,5,-1,9.0,12.0
7771,1985-1986,17,NEC Nijmegen,FC Twente,0,2,2,0,3,2,-2,7.0,6.0
7772,1985-1986,17,Roda JC Kerkrade,Heracles Almelo,4,1,1,3,0,5,3,9.0,1.0
7773,1985-1986,18,Go Ahead Eagles,Heracles Almelo,2,2,3,1,1,4,0,4.0,2.0
7774,1985-1986,18,AFC Ajax,SBV Excelsior,3,0,1,3,0,3,3,15.0,4.0
7775,1985-1986,18,FC Den Bosch '67,AZ '67 Alkmaar,0,0,3,1,1,0,0,6.0,13.0
7776,1985-1986,18,FC Twente,Sparta Rotterdam,2,2,3,1,1,4,0,7.0,3.0
7777,1985-1986,18,FC Utrecht,FC Groningen,1,0,1,3,0,1,1,9.0,6.0
7778,1985-1986,18,Feyenoord,VVV-Venlo,2,3,2,0,3,5,-1,4.0,9.0
7779,1985-1986,18,Fortuna Sittard,MVV Maastricht,3,2,1,3,0,5,1,10.0,1.0
7780,1985-1986,18,SBV Haarlem,PSV,0,2,2,0,3,2,-2,6.0,15.0
7781,1985-1986,18,NEC Nijmegen,Roda JC Kerkrade,1,2,2,0,3,3,-1,4.0,9.0
7782,1985-1986,19,AZ '67 Alkmaar,Fortuna Sittard,1,1,3,1,1,2,0,11.0,11.0
7783,1985-1986,19,MVV Maastricht,AFC Ajax,1,4,2,0,3,5,-3,0.0,15.0
7784,1985-1986,19,PSV,FC Den Bosch '67,2,1,1,3,0,3,1,15.0,6.0
7785,1985-1986,19,SBV Excelsior,FC Twente,2,2,3,1,1,4,0,5.0,5.0
7786,1985-1986,19,FC Groningen,SBV Haarlem,3,0,1,3,0,3,3,6.0,3.0
7787,1985-1986,19,Roda JC Kerkrade,Go Ahead Eagles,5,0,1,3,0,5,5,12.0,4.0
7788,1985-1986,19,Heracles Almelo,Feyenoord,2,5,2,0,3,7,-3,2.0,6.0
7789,1985-1986,19,Sparta Rotterdam,NEC Nijmegen,3,2,1,3,0,5,1,6.0,1.0
7790,1985-1986,19,VVV-Venlo,FC Utrecht,1,0,1,3,0,1,1,12.0,6.0
7791,1985-1986,20,AFC Ajax,AZ '67 Alkmaar,8,2,1,3,0,10,6,15.0,8.0
7792,1985-1986,20,FC Den Bosch '67,FC Groningen,1,0,1,3,0,1,1,8.0,6.0
7793,1985-1986,20,FC Utrecht,Heracles Almelo,0,2,2,0,3,2,-2,3.0,5.0
7794,1985-1986,20,Feyenoord,Roda JC Kerkrade,1,0,1,3,0,1,1,9.0,9.0
7795,1985-1986,20,SBV Haarlem,VVV-Venlo,6,3,1,3,0,9,3,6.0,9.0
7796,1985-1986,20,NEC Nijmegen,Go Ahead Eagles,0,3,2,0,3,3,-3,1.0,7.0
7797,1985-1986,20,Sparta Rotterdam,SBV Excelsior,3,1,1,3,0,4,2,8.0,2.0
7798,1985-1986,20,FC Twente,MVV Maastricht,4,1,1,3,0,5,3,8.0,0.0
7799,1985-1986,20,Fortuna Sittard,PSV,2,2,3,1,1,4,0,9.0,13.0
7800,1985-1986,21,AZ '67 Alkmaar,FC Twente,1,0,1,3,0,1,1,8.0,8.0
7801,1985-1986,21,MVV Maastricht,Sparta Rotterdam,4,2,1,3,0,6,2,3.0,7.0
7802,1985-1986,21,SBV Excelsior,NEC Nijmegen,3,0,1,3,0,3,3,4.0,0.0
7803,1985-1986,21,FC Groningen,Fortuna Sittard,3,0,1,3,0,3,3,6.0,8.0
7804,1985-1986,21,Go Ahead Eagles,Feyenoord,1,3,2,0,3,4,-2,7.0,12.0
7805,1985-1986,21,PSV,AFC Ajax,1,1,3,1,1,2,0,11.0,13.0
7806,1985-1986,21,Roda JC Kerkrade,FC Utrecht,3,3,3,1,1,6,0,10.0,4.0
7807,1985-1986,21,Heracles Almelo,SBV Haarlem,2,2,3,1,1,4,0,5.0,4.0
7808,1985-1986,21,VVV-Venlo,FC Den Bosch '67,3,1,1,3,0,4,2,9.0,7.0
7809,1985-1986,22,Fortuna Sittard,VVV-Venlo,1,1,3,1,1,2,0,6.0,10.0
7810,1985-1986,22,SBV Haarlem,Roda JC Kerkrade,0,0,3,1,1,0,0,5.0,8.0
7811,1985-1986,22,AFC Ajax,FC Groningen,1,0,1,3,0,1,1,13.0,6.0
7812,1985-1986,22,SBV Excelsior,MVV Maastricht,1,0,1,3,0,1,1,7.0,3.0
7813,1985-1986,22,FC Den Bosch '67,Heracles Almelo,4,0,1,3,0,4,4,7.0,5.0
7814,1985-1986,22,FC Twente,PSV,1,3,2,0,3,4,-2,5.0,11.0
7815,1985-1986,22,FC Utrecht,Go Ahead Eagles,0,0,3,1,1,0,0,5.0,5.0
7816,1985-1986,22,Sparta Rotterdam,AZ '67 Alkmaar,0,0,3,1,1,0,0,8.0,6.0
7817,1985-1986,22,NEC Nijmegen,Feyenoord,3,1,1,3,0,4,2,3.0,9.0
7818,1985-1986,23,AZ '67 Alkmaar,SBV Excelsior,1,0,1,3,0,1,1,8.0,7.0
7819,1985-1986,23,Go Ahead Eagles,SBV Haarlem,0,0,3,1,1,0,0,5.0,6.0
7820,1985-1986,23,MVV Maastricht,NEC Nijmegen,0,1,2,0,3,1,-1,3.0,6.0
7821,1985-1986,23,PSV,Sparta Rotterdam,1,1,3,1,1,2,0,9.0,8.0
7822,1985-1986,23,Heracles Almelo,Fortuna Sittard,0,3,2,0,3,3,-3,4.0,6.0
7823,1985-1986,23,FC Groningen,FC Twente,5,1,1,3,0,6,4,9.0,4.0
7824,1985-1986,23,Feyenoord,FC Utrecht,2,0,1,3,0,2,2,12.0,2.0
7825,1985-1986,23,Roda JC Kerkrade,FC Den Bosch '67,0,0,3,1,1,0,0,6.0,7.0
7826,1985-1986,23,VVV-Venlo,AFC Ajax,1,4,2,0,3,5,-3,7.0,13.0
7827,1985-1986,24,MVV Maastricht,AZ '67 Alkmaar,0,0,3,1,1,0,0,4.0,8.0
7828,1985-1986,24,AFC Ajax,Heracles Almelo,7,0,1,3,0,7,7,13.0,4.0
7829,1985-1986,24,SBV Excelsior,PSV,0,1,2,0,3,1,-1,6.0,9.0
7830,1985-1986,24,FC Den Bosch '67,Go Ahead Eagles,1,0,1,3,0,1,1,10.0,5.0
7831,1985-1986,24,Fortuna Sittard,Roda JC Kerkrade,2,1,1,3,0,3,1,8.0,3.0
7832,1985-1986,24,Sparta Rotterdam,FC Groningen,3,3,3,1,1,6,0,6.0,7.0
7833,1985-1986,24,FC Twente,VVV-Venlo,1,0,1,3,0,1,1,6.0,4.0
7834,1985-1986,24,NEC Nijmegen,FC Utrecht,1,2,2,0,3,3,-1,6.0,5.0
7835,1985-1986,24,SBV Haarlem,Feyenoord,1,1,3,1,1,2,0,7.0,10.0
7836,1985-1986,25,AZ '67 Alkmaar,NEC Nijmegen,1,0,1,3,0,1,1,11.0,6.0
7837,1985-1986,25,FC Groningen,SBV Excelsior,2,0,1,3,0,2,2,10.0,6.0
7838,1985-1986,25,FC Utrecht,SBV Haarlem,0,0,3,1,1,0,0,6.0,5.0
7839,1985-1986,25,Feyenoord,FC Den Bosch '67,1,1,3,1,1,2,0,8.0,8.0
7840,1985-1986,25,Go Ahead Eagles,Fortuna Sittard,1,0,1,3,0,1,1,5.0,7.0
7841,1985-1986,25,PSV,MVV Maastricht,3,0,1,3,0,3,3,11.0,4.0
7842,1985-1986,25,Roda JC Kerkrade,AFC Ajax,2,1,1,3,0,3,1,6.0,10.0
7843,1985-1986,25,Heracles Almelo,FC Twente,0,0,3,1,1,0,0,2.0,4.0
7844,1985-1986,25,VVV-Venlo,Sparta Rotterdam,0,1,2,0,3,1,-1,4.0,6.0
7845,1985-1986,26,AFC Ajax,Go Ahead Eagles,5,0,1,3,0,5,5,12.0,5.0
7846,1985-1986,26,AZ '67 Alkmaar,PSV,0,1,2,0,3,1,-1,8.0,13.0
7847,1985-1986,26,SBV Excelsior,VVV-Venlo,0,0,3,1,1,0,0,4.0,2.0
7848,1985-1986,26,FC Den Bosch '67,FC Utrecht,1,1,3,1,1,2,0,9.0,6.0
7849,1985-1986,26,FC Twente,Roda JC Kerkrade,1,1,3,1,1,2,0,5.0,6.0
7850,1985-1986,26,MVV Maastricht,FC Groningen,0,0,3,1,1,0,0,2.0,8.0
7851,1985-1986,26,NEC Nijmegen,SBV Haarlem,0,2,2,0,3,2,-2,6.0,7.0
7852,1985-1986,26,Sparta Rotterdam,Heracles Almelo,6,1,1,3,0,7,5,9.0,1.0
7853,1985-1986,26,Fortuna Sittard,Feyenoord,1,1,3,1,1,2,0,8.0,6.0
7854,1985-1986,27,FC Groningen,AZ '67 Alkmaar,1,0,1,3,0,1,1,11.0,7.0
7855,1985-1986,27,FC Utrecht,Fortuna Sittard,1,0,1,3,0,1,1,8.0,7.0
7856,1985-1986,27,Feyenoord,AFC Ajax,3,1,1,3,0,4,2,9.0,9.0
7857,1985-1986,27,Go Ahead Eagles,FC Twente,3,3,3,1,1,6,0,5.0,6.0
7858,1985-1986,27,SBV Haarlem,FC Den Bosch '67,4,1,1,3,0,5,3,9.0,6.0
7859,1985-1986,27,PSV,NEC Nijmegen,2,0,1,3,0,2,2,13.0,3.0
7860,1985-1986,27,Heracles Almelo,SBV Excelsior,1,2,2,0,3,3,-1,1.0,4.0
7861,1985-1986,27,Roda JC Kerkrade,Sparta Rotterdam,2,0,1,3,0,2,2,8.0,8.0
7862,1985-1986,27,VVV-Venlo,MVV Maastricht,1,0,1,3,0,1,1,4.0,2.0
7863,1985-1986,28,AZ '67 Alkmaar,VVV-Venlo,0,0,3,1,1,0,0,5.0,5.0
7864,1985-1986,28,SBV Excelsior,Roda JC Kerkrade,0,1,2,0,3,1,-1,4.0,10.0
7865,1985-1986,28,FC Twente,Feyenoord,0,4,2,0,3,4,-4,6.0,9.0
7866,1985-1986,28,Fortuna Sittard,SBV Haarlem,4,0,1,3,0,4,4,7.0,8.0
7867,1985-1986,28,MVV Maastricht,Heracles Almelo,1,0,1,3,0,1,1,5.0,1.0
7868,1985-1986,28,NEC Nijmegen,FC Den Bosch '67,1,2,2,0,3,3,-1,0.0,8.0
7869,1985-1986,28,PSV,FC Groningen,0,0,3,1,1,0,0,13.0,9.0
7870,1985-1986,28,Sparta Rotterdam,Go Ahead Eagles,2,1,1,3,0,3,1,10.0,4.0
7871,1985-1986,28,AFC Ajax,FC Utrecht,3,0,1,3,0,3,3,9.0,8.0
7872,1985-1986,29,Go Ahead Eagles,SBV Excelsior,4,0,1,3,0,4,4,7.0,4.0
7873,1985-1986,29,Heracles Almelo,AZ '67 Alkmaar,1,1,3,1,1,2,0,2.0,5.0
7874,1985-1986,29,VVV-Venlo,PSV,0,3,2,0,3,3,-3,5.0,13.0
7875,1985-1986,29,FC Den Bosch '67,Fortuna Sittard,2,2,3,1,1,4,0,6.0,5.0
7876,1985-1986,29,FC Groningen,NEC Nijmegen,2,0,1,3,0,2,2,11.0,0.0
7877,1985-1986,29,FC Utrecht,FC Twente,2,2,3,1,1,4,0,6.0,4.0
7878,1985-1986,29,Feyenoord,Sparta Rotterdam,4,3,1,3,0,7,1,11.0,9.0
7879,1985-1986,29,SBV Haarlem,AFC Ajax,1,2,2,0,3,3,-1,7.0,9.0
7880,1985-1986,29,Roda JC Kerkrade,MVV Maastricht,3,0,1,3,0,3,3,13.0,4.0
7881,1985-1986,30,MVV Maastricht,Go Ahead Eagles,0,2,2,0,3,2,-2,4.0,7.0
7882,1985-1986,30,NEC Nijmegen,Fortuna Sittard,0,0,3,1,1,0,0,1.0,6.0
7883,1985-1986,30,AFC Ajax,FC Den Bosch '67,4,1,1,3,0,5,3,12.0,5.0
7884,1985-1986,30,AZ '67 Alkmaar,Roda JC Kerkrade,4,3,1,3,0,7,1,5.0,10.0
7885,1985-1986,30,SBV Excelsior,Feyenoord,2,1,1,3,0,3,1,7.0,10.0
7886,1985-1986,30,FC Groningen,VVV-Venlo,3,4,2,0,3,7,-1,8.0,8.0
7887,1985-1986,30,FC Twente,SBV Haarlem,0,0,3,1,1,0,0,4.0,7.0
7888,1985-1986,30,PSV,Heracles Almelo,5,0,1,3,0,5,5,13.0,1.0
7889,1985-1986,30,Sparta Rotterdam,FC Utrecht,3,2,1,3,0,5,1,9.0,5.0
7890,1985-1986,31,Go Ahead Eagles,AZ '67 Alkmaar,1,1,3,1,1,2,0,8.0,6.0
7891,1985-1986,31,VVV-Venlo,NEC Nijmegen,0,3,2,0,3,3,-3,7.0,4.0
7892,1985-1986,31,FC Den Bosch '67,FC Twente,2,1,1,3,0,3,1,7.0,3.0
7893,1985-1986,31,FC Utrecht,SBV Excelsior,0,0,3,1,1,0,0,5.0,7.0
7894,1985-1986,31,Feyenoord,MVV Maastricht,1,2,2,0,3,3,-1,9.0,6.0
7895,1985-1986,31,Fortuna Sittard,AFC Ajax,1,4,2,0,3,5,-3,5.0,12.0
7896,1985-1986,31,SBV Haarlem,Sparta Rotterdam,1,2,2,0,3,3,-1,4.0,9.0
7897,1985-1986,31,Roda JC Kerkrade,PSV,1,4,2,0,3,5,-3,9.0,13.0
7898,1985-1986,31,Heracles Almelo,FC Groningen,0,4,2,0,3,4,-4,1.0,10.0
7899,1985-1986,32,MVV Maastricht,FC Utrecht,2,1,1,3,0,3,1,9.0,2.0
7900,1985-1986,32,PSV,Go Ahead Eagles,8,2,1,3,0,10,6,13.0,7.0
7901,1985-1986,32,VVV-Venlo,Heracles Almelo,3,1,1,3,0,4,2,7.0,1.0
7902,1985-1986,32,AZ '67 Alkmaar,Feyenoord,2,2,3,1,1,4,0,7.0,7.0
7903,1985-1986,32,SBV Excelsior,SBV Haarlem,0,0,3,1,1,0,0,5.0,2.0
7904,1985-1986,32,FC Groningen,Roda JC Kerkrade,3,2,1,3,0,5,1,10.0,6.0
7905,1985-1986,32,FC Twente,Fortuna Sittard,3,1,1,3,0,4,2,5.0,5.0
7906,1985-1986,32,NEC Nijmegen,AFC Ajax,0,0,3,1,1,0,0,5.0,13.0
7907,1985-1986,32,Sparta Rotterdam,FC Den Bosch '67,3,0,1,3,0,3,3,12.0,7.0
7908,1985-1986,33,AFC Ajax,FC Twente,6,0,1,3,0,6,6,13.0,5.0
7909,1985-1986,33,FC Den Bosch '67,SBV Excelsior,0,0,3,1,1,0,0,5.0,6.0
7910,1985-1986,33,Feyenoord,PSV,2,3,2,0,3,5,-1,4.0,15.0
7911,1985-1986,33,Fortuna Sittard,Sparta Rotterdam,0,0,3,1,1,0,0,3.0,10.0
7912,1985-1986,33,Go Ahead Eagles,FC Groningen,2,1,1,3,0,3,1,10.0,9.0
7913,1985-1986,33,SBV Haarlem,MVV Maastricht,1,1,3,1,1,2,0,3.0,7.0
7914,1985-1986,33,NEC Nijmegen,Heracles Almelo,3,0,1,3,0,3,3,8.0,1.0
7915,1985-1986,33,Roda JC Kerkrade,VVV-Venlo,3,1,1,3,0,4,2,6.0,6.0
7916,1985-1986,33,FC Utrecht,AZ '67 Alkmaar,1,2,2,0,3,3,-1,2.0,9.0
7917,1985-1986,34,AZ '67 Alkmaar,SBV Haarlem,1,1,3,1,1,2,0,9.0,4.0
7918,1985-1986,34,SBV Excelsior,Fortuna Sittard,3,0,1,3,0,3,3,9.0,2.0
7919,1985-1986,34,FC Groningen,Feyenoord,4,1,1,3,0,5,3,9.0,1.0
7920,1985-1986,34,FC Twente,NEC Nijmegen,1,2,2,0,3,3,-1,4.0,11.0
7921,1985-1986,34,MVV Maastricht,FC Den Bosch '67,2,1,1,3,0,3,1,10.0,4.0
7922,1985-1986,34,PSV,FC Utrecht,1,1,3,1,1,2,0,13.0,2.0
7923,1985-1986,34,Heracles Almelo,Roda JC Kerkrade,1,8,2,0,3,9,-7,0.0,6.0
7924,1985-1986,34,Sparta Rotterdam,AFC Ajax,3,1,1,3,0,4,2,13.0,10.0
7925,1985-1986,34,VVV-Venlo,Go Ahead Eagles,1,2,2,0,3,3,-1,6.0,10.0
7926,1986-1987,1,Fortuna Sittard,SBV Haarlem,0,0,3,1,1,0,0,2.0,4.0
7927,1986-1987,1,Go Ahead Eagles,SBV Excelsior,1,0,1,3,0,1,1,10.0,6.0
7928,1986-1987,1,Sparta Rotterdam,PSV,1,1,3,1,1,2,0,11.0,11.0
7929,1986-1987,1,VVV-Venlo,FC Den Bosch '67,0,0,3,1,1,0,0,4.0,5.0
7930,1986-1987,1,AZ Alkmaar,FC Groningen,0,4,2,0,3,4,-4,,12.0
7931,1986-1987,1,FC Utrecht,FC Twente,1,2,2,0,3,3,-1,2.0,6.0
7932,1986-1987,1,Feyenoord,PEC Zwolle '82,3,2,1,3,0,5,1,4.0,2.0
7933,1986-1987,1,FC Den Haag,BV Veendam,0,1,2,0,3,1,-1,0.0,
7934,1986-1987,1,Roda JC Kerkrade,AFC Ajax,1,1,3,1,1,2,0,7.0,8.0
7935,1986-1987,2,SBV Excelsior,Sparta Rotterdam,0,2,2,0,3,2,-2,5.0,11.0
7936,1986-1987,2,FC Den Haag,Go Ahead Eagles,0,1,2,0,3,1,-1,0.0,12.0
7937,1986-1987,2,FC Twente,AZ Alkmaar,1,0,1,3,0,1,1,9.0,
7938,1986-1987,2,SBV Haarlem,BV Veendam,0,0,3,1,1,0,0,5.0,
7939,1986-1987,2,PEC Zwolle '82,FC Utrecht,2,4,2,0,3,6,-2,2.0,4.0
7940,1986-1987,2,Roda JC Kerkrade,Fortuna Sittard,2,0,1,3,0,2,2,10.0,2.0
7941,1986-1987,2,AFC Ajax,FC Groningen,0,0,3,1,1,0,0,6.0,10.0
7942,1986-1987,2,FC Den Bosch '67,Feyenoord,2,1,1,3,0,3,1,5.0,4.0
7943,1986-1987,2,PSV,VVV-Venlo,3,0,1,3,0,3,3,11.0,4.0
7944,1986-1987,3,PEC Zwolle '82,FC Den Bosch '67,0,1,2,0,3,1,-1,1.0,8.0
7945,1986-1987,3,PSV,Go Ahead Eagles,2,0,1,3,0,2,2,11.0,12.0
7946,1986-1987,3,SBV Excelsior,BV Veendam,1,0,1,3,0,1,1,7.0,
7947,1986-1987,3,FC Den Haag,Fortuna Sittard,0,4,2,0,3,4,-4,0.0,5.0
7948,1986-1987,3,FC Groningen,FC Utrecht,3,0,1,3,0,3,3,10.0,4.0
7949,1986-1987,3,FC Twente,Feyenoord,2,2,3,1,1,4,0,7.0,4.0
7950,1986-1987,3,SBV Haarlem,AFC Ajax,0,3,2,0,3,3,-3,4.0,8.0
7951,1986-1987,3,Roda JC Kerkrade,AZ Alkmaar,1,0,1,3,0,1,1,13.0,
7952,1986-1987,3,Sparta Rotterdam,VVV-Venlo,4,0,1,3,0,4,4,11.0,1.0
7953,1986-1987,4,AFC Ajax,FC Den Haag,2,3,2,0,3,5,-1,5.0,3.0
7954,1986-1987,4,AZ Alkmaar,SBV Haarlem,0,1,2,0,3,1,-1,,6.0
7955,1986-1987,4,FC Den Bosch '67,FC Twente,0,0,3,1,1,0,0,8.0,8.0
7956,1986-1987,4,FC Utrecht,Roda JC Kerkrade,0,1,2,0,3,1,-1,4.0,13.0
7957,1986-1987,4,Feyenoord,FC Groningen,1,1,3,1,1,2,0,5.0,11.0
7958,1986-1987,4,Fortuna Sittard,SBV Excelsior,3,0,1,3,0,3,3,7.0,6.0
7959,1986-1987,4,Go Ahead Eagles,Sparta Rotterdam,0,3,2,0,3,3,-3,9.0,13.0
7960,1986-1987,4,BV Veendam,PSV,0,3,2,0,3,3,-3,,11.0
7961,1986-1987,4,VVV-Venlo,PEC Zwolle '82,1,1,3,1,1,2,0,2.0,2.0
7962,1986-1987,5,Fortuna Sittard,Sparta Rotterdam,3,2,1,3,0,5,1,10.0,10.0
7963,1986-1987,5,PEC Zwolle '82,FC Groningen,2,1,1,3,0,3,1,4.0,8.0
7964,1986-1987,5,VVV-Venlo,FC Twente,1,1,3,1,1,2,0,3.0,9.0
7965,1986-1987,5,AFC Ajax,PSV,3,0,1,3,0,3,3,8.0,10.0
7966,1986-1987,5,AZ Alkmaar,SBV Excelsior,3,0,1,3,0,3,3,3.0,3.0
7967,1986-1987,5,FC Den Bosch '67,Roda JC Kerkrade,0,0,3,1,1,0,0,9.0,11.0
7968,1986-1987,5,FC Utrecht,FC Den Haag,2,2,3,1,1,4,0,4.0,4.0
7969,1986-1987,5,Feyenoord,SBV Haarlem,2,1,1,3,0,3,1,8.0,5.0
7970,1986-1987,5,BV Veendam,Go Ahead Eagles,3,2,1,3,0,5,1,7.0,6.0
7971,1986-1987,6,SBV Excelsior,AFC Ajax,0,2,2,0,3,2,-2,3.0,10.0
7972,1986-1987,6,FC Den Haag,AZ Alkmaar,2,0,1,3,0,2,2,7.0,3.0
7973,1986-1987,6,FC Groningen,FC Den Bosch '67,0,1,2,0,3,1,-1,5.0,11.0
7974,1986-1987,6,FC Twente,PEC Zwolle '82,2,2,3,1,1,4,0,7.0,5.0
7975,1986-1987,6,Go Ahead Eagles,VVV-Venlo,1,1,3,1,1,2,0,4.0,3.0
7976,1986-1987,6,SBV Haarlem,FC Utrecht,2,1,1,3,0,3,1,7.0,4.0
7977,1986-1987,6,PSV,Fortuna Sittard,2,1,1,3,0,3,1,12.0,9.0
7978,1986-1987,6,Roda JC Kerkrade,Feyenoord,0,4,2,0,3,4,-4,10.0,8.0
7979,1986-1987,6,Sparta Rotterdam,BV Veendam,3,3,3,1,1,6,0,10.0,5.0
7980,1986-1987,7,Go Ahead Eagles,Fortuna Sittard,0,0,3,1,1,0,0,2.0,10.0
7981,1986-1987,7,SBV Haarlem,FC Den Bosch '67,1,3,2,0,3,4,-2,6.0,11.0
7982,1986-1987,7,PSV,AZ Alkmaar,3,0,1,3,0,3,3,12.0,3.0
7983,1986-1987,7,BV Veendam,VVV-Venlo,1,1,3,1,1,2,0,5.0,4.0
7984,1986-1987,7,FC Den Haag,Feyenoord,2,2,3,1,1,4,0,8.0,9.0
7985,1986-1987,7,FC Groningen,FC Twente,4,2,1,3,0,6,2,7.0,4.0
7986,1986-1987,7,Roda JC Kerkrade,PEC Zwolle '82,2,5,2,0,3,7,-3,7.0,8.0
7987,1986-1987,7,Sparta Rotterdam,AFC Ajax,2,6,2,0,3,8,-4,7.0,12.0
7988,1986-1987,7,SBV Excelsior,FC Utrecht,2,4,2,0,3,6,-2,3.0,4.0
7989,1986-1987,8,Fortuna Sittard,BV Veendam,1,1,3,1,1,2,0,8.0,6.0
7990,1986-1987,8,PEC Zwolle '82,SBV Haarlem,4,0,1,3,0,4,4,11.0,6.0
7991,1986-1987,8,VVV-Venlo,FC Groningen,4,2,1,3,0,6,2,7.0,4.0
7992,1986-1987,8,AFC Ajax,Go Ahead Eagles,3,2,1,3,0,5,1,12.0,2.0
7993,1986-1987,8,AZ Alkmaar,Sparta Rotterdam,0,2,2,0,3,2,-2,3.0,7.0
7994,1986-1987,8,FC Den Bosch '67,FC Den Haag,3,1,1,3,0,4,2,11.0,8.0
7995,1986-1987,8,FC Twente,Roda JC Kerkrade,2,3,2,0,3,5,-1,3.0,7.0
7996,1986-1987,8,FC Utrecht,PSV,1,4,2,0,3,5,-3,4.0,12.0
7997,1986-1987,8,Feyenoord,SBV Excelsior,5,1,1,3,0,6,4,11.0,0.0
7998,1986-1987,9,Fortuna Sittard,VVV-Venlo,0,0,3,1,1,0,0,6.0,7.0
7999,1986-1987,9,Go Ahead Eagles,AZ Alkmaar,1,1,3,1,1,2,0,3.0,4.0
8000,1986-1987,9,SBV Haarlem,FC Twente,0,3,2,0,3,3,-3,3.0,5.0
8001,1986-1987,9,SBV Excelsior,FC Den Bosch '67,1,2,2,0,3,3,-1,0.0,13.0
8002,1986-1987,9,FC Den Haag,PEC Zwolle '82,2,2,3,1,1,4,0,6.0,11.0
8003,1986-1987,9,PSV,Feyenoord,0,0,3,1,1,0,0,10.0,11.0
8004,1986-1987,9,Roda JC Kerkrade,FC Groningen,3,2,1,3,0,5,1,7.0,3.0
8005,1986-1987,9,Sparta Rotterdam,FC Utrecht,3,0,1,3,0,3,3,7.0,4.0
8006,1986-1987,9,BV Veendam,AFC Ajax,0,1,2,0,3,1,-1,6.0,15.0
8007,1986-1987,10,PEC Zwolle '82,SBV Excelsior,2,3,2,0,3,5,-1,8.0,3.0
8008,1986-1987,10,VVV-Venlo,Roda JC Kerkrade,0,4,2,0,3,4,-4,6.0,9.0
8009,1986-1987,10,AFC Ajax,Fortuna Sittard,6,2,1,3,0,8,4,15.0,3.0
8010,1986-1987,10,AZ Alkmaar,BV Veendam,0,0,3,1,1,0,0,2.0,4.0
8011,1986-1987,10,FC Den Bosch '67,PSV,1,2,2,0,3,3,-1,12.0,13.0
8012,1986-1987,10,FC Groningen,SBV Haarlem,3,1,1,3,0,4,2,6.0,3.0
8013,1986-1987,10,FC Twente,FC Den Haag,0,0,3,1,1,0,0,5.0,6.0
8014,1986-1987,10,FC Utrecht,Go Ahead Eagles,2,0,1,3,0,2,2,6.0,3.0
8015,1986-1987,10,Feyenoord,Sparta Rotterdam,3,2,1,3,0,5,1,11.0,7.0
8016,1986-1987,11,Fortuna Sittard,AZ Alkmaar,2,1,1,3,0,3,1,6.0,2.0
8017,1986-1987,11,SBV Haarlem,Roda JC Kerkrade,3,1,1,3,0,4,2,3.0,9.0
8018,1986-1987,11,PSV,PEC Zwolle '82,3,1,1,3,0,4,2,13.0,7.0
8019,1986-1987,11,AFC Ajax,VVV-Venlo,4,0,1,3,0,4,4,15.0,5.0
8020,1986-1987,11,SBV Excelsior,FC Twente,1,1,3,1,1,2,0,4.0,5.0
8021,1986-1987,11,FC Den Haag,FC Groningen,1,1,3,1,1,2,0,4.0,7.0
8022,1986-1987,11,Go Ahead Eagles,Feyenoord,0,2,2,0,3,2,-2,2.0,11.0
8023,1986-1987,11,Sparta Rotterdam,FC Den Bosch '67,3,1,1,3,0,4,2,9.0,9.0
8024,1986-1987,11,BV Veendam,FC Utrecht,2,2,3,1,1,4,0,4.0,7.0
8025,1986-1987,12,PEC Zwolle '82,Sparta Rotterdam,1,1,3,1,1,2,0,5.0,10.0
8026,1986-1987,12,VVV-Venlo,SBV Haarlem,3,1,1,3,0,4,2,7.0,3.0
8027,1986-1987,12,AZ Alkmaar,AFC Ajax,1,6,2,0,3,7,-5,2.0,15.0
8028,1986-1987,12,FC Den Bosch '67,Go Ahead Eagles,0,1,2,0,3,1,-1,6.0,4.0
8029,1986-1987,12,FC Groningen,SBV Excelsior,6,0,1,3,0,6,6,7.0,4.0
8030,1986-1987,12,FC Twente,PSV,0,3,2,0,3,3,-3,5.0,13.0
8031,1986-1987,12,FC Utrecht,Fortuna Sittard,4,1,1,3,0,5,3,7.0,5.0
8032,1986-1987,12,Feyenoord,BV Veendam,3,2,1,3,0,5,1,13.0,3.0
8033,1986-1987,12,Roda JC Kerkrade,FC Den Haag,0,0,3,1,1,0,0,10.0,4.0
8034,1986-1987,13,AFC Ajax,FC Utrecht,3,0,1,3,0,3,3,15.0,7.0
8035,1986-1987,13,AZ Alkmaar,VVV-Venlo,2,1,1,3,0,3,1,5.0,4.0
8036,1986-1987,13,SBV Excelsior,Roda JC Kerkrade,1,1,3,1,1,2,0,5.0,8.0
8037,1986-1987,13,FC Den Haag,SBV Haarlem,4,0,1,3,0,4,4,7.0,3.0
8038,1986-1987,13,Fortuna Sittard,Feyenoord,1,1,3,1,1,2,0,5.0,11.0
8039,1986-1987,13,PSV,FC Groningen,6,1,1,3,0,7,5,13.0,7.0
8040,1986-1987,13,Sparta Rotterdam,FC Twente,0,1,2,0,3,1,-1,7.0,8.0
8041,1986-1987,13,BV Veendam,FC Den Bosch '67,1,2,2,0,3,3,-1,2.0,6.0
8042,1986-1987,13,Go Ahead Eagles,PEC Zwolle '82,0,3,2,0,3,3,-3,4.0,5.0
8043,1986-1987,14,SBV Haarlem,SBV Excelsior,0,1,2,0,3,1,-1,3.0,8.0
8044,1986-1987,14,PEC Zwolle '82,BV Veendam,1,1,3,1,1,2,0,5.0,3.0
8045,1986-1987,14,Roda JC Kerkrade,PSV,0,4,2,0,3,4,-4,5.0,15.0
8046,1986-1987,14,FC Den Bosch '67,Fortuna Sittard,3,1,1,3,0,4,2,6.0,4.0
8047,1986-1987,14,FC Groningen,Sparta Rotterdam,1,1,3,1,1,2,0,8.0,5.0
8048,1986-1987,14,FC Twente,Go Ahead Eagles,1,1,3,1,1,2,0,6.0,4.0
8049,1986-1987,14,FC Utrecht,AZ Alkmaar,0,0,3,1,1,0,0,8.0,5.0
8050,1986-1987,14,Feyenoord,AFC Ajax,2,3,2,0,3,5,-1,10.0,15.0
8051,1986-1987,14,VVV-Venlo,FC Den Haag,1,2,2,0,3,3,-1,3.0,9.0
8052,1986-1987,15,Fortuna Sittard,PEC Zwolle '82,2,5,2,0,3,7,-3,4.0,8.0
8053,1986-1987,15,Go Ahead Eagles,FC Groningen,1,0,1,3,0,1,1,7.0,5.0
8054,1986-1987,15,PSV,SBV Haarlem,5,0,1,3,0,5,5,15.0,3.0
8055,1986-1987,15,BV Veendam,FC Twente,0,2,2,0,3,2,-2,2.0,8.0
8056,1986-1987,15,AFC Ajax,FC Den Bosch '67,3,1,1,3,0,4,2,15.0,6.0
8057,1986-1987,15,AZ Alkmaar,Feyenoord,2,0,1,3,0,2,2,7.0,7.0
8058,1986-1987,15,SBV Excelsior,FC Den Haag,0,2,2,0,3,2,-2,5.0,11.0
8059,1986-1987,15,FC Utrecht,VVV-Venlo,1,2,2,0,3,3,-1,5.0,6.0
8060,1986-1987,15,Sparta Rotterdam,Roda JC Kerkrade,1,1,3,1,1,2,0,6.0,3.0
8061,1986-1987,16,SBV Haarlem,Sparta Rotterdam,1,0,1,3,0,1,1,3.0,3.0
8062,1986-1987,16,PEC Zwolle '82,AFC Ajax,0,1,2,0,3,1,-1,8.0,15.0
8063,1986-1987,16,SBV Excelsior,VVV-Venlo,1,2,2,0,3,3,-1,4.0,9.0
8064,1986-1987,16,FC Den Bosch '67,AZ Alkmaar,2,2,3,1,1,4,0,7.0,8.0
8065,1986-1987,16,FC Den Haag,PSV,2,6,2,0,3,8,-4,10.0,15.0
8066,1986-1987,16,FC Groningen,BV Veendam,1,1,3,1,1,2,0,5.0,2.0
8067,1986-1987,16,FC Twente,Fortuna Sittard,1,0,1,3,0,1,1,10.0,1.0
8068,1986-1987,16,Feyenoord,FC Utrecht,1,1,3,1,1,2,0,5.0,5.0
8069,1986-1987,16,Roda JC Kerkrade,Go Ahead Eagles,4,0,1,3,0,4,4,6.0,7.0
8070,1986-1987,17,VVV-Venlo,Feyenoord,3,0,1,3,0,3,3,9.0,2.0
8071,1986-1987,17,Fortuna Sittard,FC Groningen,2,2,3,1,1,4,0,2.0,3.0
8072,1986-1987,17,PSV,SBV Excelsior,7,0,1,3,0,7,7,15.0,4.0
8073,1986-1987,17,AFC Ajax,FC Twente,4,0,1,3,0,4,4,15.0,10.0
8074,1986-1987,17,AZ Alkmaar,PEC Zwolle '82,1,3,2,0,3,4,-2,8.0,10.0
8075,1986-1987,17,FC Utrecht,FC Den Bosch '67,1,1,3,1,1,2,0,3.0,8.0
8076,1986-1987,17,Go Ahead Eagles,SBV Haarlem,1,2,2,0,3,3,-1,4.0,6.0
8077,1986-1987,17,Sparta Rotterdam,FC Den Haag,2,0,1,3,0,2,2,5.0,9.0
8078,1986-1987,17,BV Veendam,Roda JC Kerkrade,0,3,2,0,3,3,-3,2.0,8.0
8079,1986-1987,18,SBV Haarlem,Fortuna Sittard,1,1,3,1,1,2,0,7.0,2.0
8080,1986-1987,18,PEC Zwolle '82,Feyenoord,0,0,3,1,1,0,0,8.0,2.0
8081,1986-1987,18,PSV,Sparta Rotterdam,3,1,1,3,0,4,2,15.0,5.0
8082,1986-1987,18,AFC Ajax,Roda JC Kerkrade,2,0,1,3,0,2,2,15.0,7.0
8083,1986-1987,18,SBV Excelsior,Go Ahead Eagles,1,1,3,1,1,2,0,4.0,5.0
8084,1986-1987,18,FC Den Bosch '67,VVV-Venlo,1,1,3,1,1,2,0,6.0,10.0
8085,1986-1987,18,FC Groningen,AZ Alkmaar,0,0,3,1,1,0,0,4.0,6.0
8086,1986-1987,18,FC Twente,FC Utrecht,0,1,2,0,3,1,-1,7.0,6.0
8087,1986-1987,18,BV Veendam,FC Den Haag,2,2,3,1,1,4,0,3.0,7.0
8088,1986-1987,19,BV Veendam,SBV Haarlem,0,0,3,1,1,0,0,3.0,8.0
8089,1986-1987,19,AZ Alkmaar,FC Twente,1,1,3,1,1,2,0,6.0,7.0
8090,1986-1987,19,FC Groningen,AFC Ajax,0,3,2,0,3,3,-3,3.0,15.0
8091,1986-1987,19,FC Utrecht,PEC Zwolle '82,3,2,1,3,0,5,1,8.0,7.0
8092,1986-1987,19,Feyenoord,FC Den Bosch '67,3,2,1,3,0,5,1,5.0,3.0
8093,1986-1987,19,Fortuna Sittard,Roda JC Kerkrade,0,2,2,0,3,2,-2,2.0,10.0
8094,1986-1987,19,Go Ahead Eagles,FC Den Haag,2,0,1,3,0,2,2,7.0,4.0
8095,1986-1987,19,Sparta Rotterdam,SBV Excelsior,2,2,3,1,1,4,0,5.0,2.0
8096,1986-1987,19,VVV-Venlo,PSV,0,0,3,1,1,0,0,11.0,13.0
8097,1986-1987,20,AFC Ajax,SBV Haarlem,6,0,1,3,0,6,6,15.0,8.0
8098,1986-1987,20,AZ Alkmaar,Roda JC Kerkrade,2,1,1,3,0,3,1,6.0,9.0
8099,1986-1987,20,FC Den Bosch '67,PEC Zwolle '82,5,2,1,3,0,7,3,6.0,4.0
8100,1986-1987,20,Go Ahead Eagles,PSV,0,2,2,0,3,2,-2,4.0,13.0
8101,1986-1987,20,VVV-Venlo,Sparta Rotterdam,1,1,3,1,1,2,0,9.0,5.0
8102,1986-1987,20,FC Utrecht,FC Groningen,1,0,1,3,0,1,1,11.0,3.0
8103,1986-1987,20,Feyenoord,FC Twente,5,0,1,3,0,5,5,8.0,4.0
8104,1986-1987,20,Fortuna Sittard,FC Den Haag,4,0,1,3,0,4,4,5.0,1.0
8105,1986-1987,20,BV Veendam,SBV Excelsior,2,3,2,0,3,5,-1,3.0,5.0
8106,1986-1987,21,FC Twente,FC Den Bosch '67,0,1,2,0,3,1,-1,1.0,8.0
8107,1986-1987,21,PEC Zwolle '82,VVV-Venlo,1,1,3,1,1,2,0,5.0,7.0
8108,1986-1987,21,PSV,BV Veendam,4,0,1,3,0,4,4,13.0,2.0
8109,1986-1987,21,SBV Excelsior,Fortuna Sittard,3,2,1,3,0,5,1,8.0,5.0
8110,1986-1987,21,FC Den Haag,AFC Ajax,0,2,2,0,3,2,-2,1.0,15.0
8111,1986-1987,21,FC Groningen,Feyenoord,1,0,1,3,0,1,1,5.0,7.0
8112,1986-1987,21,SBV Haarlem,AZ Alkmaar,1,1,3,1,1,2,0,6.0,6.0
8113,1986-1987,21,Sparta Rotterdam,Go Ahead Eagles,1,1,3,1,1,2,0,6.0,5.0
8114,1986-1987,21,Roda JC Kerkrade,FC Utrecht,2,1,1,3,0,3,1,9.0,10.0
8115,1986-1987,22,SBV Excelsior,AZ Alkmaar,2,3,2,0,3,5,-1,8.0,9.0
8116,1986-1987,22,FC Den Haag,FC Utrecht,3,2,1,3,0,5,1,4.0,9.0
8117,1986-1987,22,SBV Haarlem,Feyenoord,1,0,1,3,0,1,1,6.0,7.0
8118,1986-1987,22,Roda JC Kerkrade,FC Den Bosch '67,2,1,1,3,0,3,1,9.0,7.0
8119,1986-1987,22,Sparta Rotterdam,Fortuna Sittard,1,1,3,1,1,2,0,4.0,5.0
8120,1986-1987,22,PSV,AFC Ajax,1,0,1,3,0,1,1,13.0,12.0
8121,1986-1987,22,FC Twente,VVV-Venlo,0,0,3,1,1,0,0,2.0,5.0
8122,1986-1987,22,Go Ahead Eagles,BV Veendam,0,0,3,1,1,0,0,6.0,3.0
8123,1986-1987,22,FC Groningen,PEC Zwolle '82,3,0,1,3,0,3,3,7.0,2.0
8124,1986-1987,23,PEC Zwolle '82,FC Twente,0,1,2,0,3,1,-1,1.0,5.0
8125,1986-1987,23,VVV-Venlo,Go Ahead Eagles,1,0,1,3,0,1,1,7.0,5.0
8126,1986-1987,23,AFC Ajax,SBV Excelsior,3,0,1,3,0,3,3,12.0,7.0
8127,1986-1987,23,FC Den Bosch '67,FC Groningen,1,1,3,1,1,2,0,7.0,7.0
8128,1986-1987,23,FC Utrecht,SBV Haarlem,2,1,1,3,0,3,1,9.0,5.0
8129,1986-1987,23,Feyenoord,Roda JC Kerkrade,3,2,1,3,0,5,1,9.0,9.0
8130,1986-1987,23,Fortuna Sittard,PSV,0,1,2,0,3,1,-1,4.0,13.0
8131,1986-1987,23,BV Veendam,Sparta Rotterdam,1,1,3,1,1,2,0,3.0,5.0
8132,1986-1987,23,AZ Alkmaar,FC Den Haag,2,2,3,1,1,4,0,9.0,4.0
8133,1986-1987,24,AFC Ajax,Sparta Rotterdam,3,0,1,3,0,3,3,12.0,4.0
8134,1986-1987,24,VVV-Venlo,BV Veendam,4,2,1,3,0,6,2,9.0,2.0
8135,1986-1987,24,FC Den Bosch '67,SBV Haarlem,1,1,3,1,1,2,0,8.0,5.0
8136,1986-1987,24,FC Twente,FC Groningen,0,0,3,1,1,0,0,5.0,8.0
8137,1986-1987,24,FC Utrecht,SBV Excelsior,5,3,1,3,0,8,2,9.0,6.0
8138,1986-1987,24,Feyenoord,FC Den Haag,4,0,1,3,0,4,4,9.0,4.0
8139,1986-1987,24,Fortuna Sittard,Go Ahead Eagles,2,0,1,3,0,2,2,7.0,2.0
8140,1986-1987,24,PEC Zwolle '82,Roda JC Kerkrade,0,1,2,0,3,1,-1,1.0,9.0
8141,1986-1987,24,AZ Alkmaar,PSV,0,0,3,1,1,0,0,9.0,13.0
8142,1986-1987,25,SBV Haarlem,PEC Zwolle '82,1,1,3,1,1,2,0,6.0,2.0
8143,1986-1987,25,BV Veendam,Fortuna Sittard,2,2,3,1,1,4,0,3.0,5.0
8144,1986-1987,25,SBV Excelsior,Feyenoord,1,6,2,0,3,7,-5,3.0,9.0
8145,1986-1987,25,FC Den Haag,FC Den Bosch '67,2,2,3,1,1,4,0,5.0,6.0
8146,1986-1987,25,FC Groningen,VVV-Venlo,0,0,3,1,1,0,0,9.0,9.0
8147,1986-1987,25,Go Ahead Eagles,AFC Ajax,1,1,3,1,1,2,0,3.0,10.0
8148,1986-1987,25,PSV,FC Utrecht,5,0,1,3,0,5,5,13.0,6.0
8149,1986-1987,25,Roda JC Kerkrade,FC Twente,1,1,3,1,1,2,0,10.0,6.0
8150,1986-1987,25,Sparta Rotterdam,AZ Alkmaar,1,1,3,1,1,2,0,4.0,7.0
8151,1986-1987,26,PEC Zwolle '82,FC Den Haag,1,1,3,1,1,2,0,2.0,6.0
8152,1986-1987,26,VVV-Venlo,Fortuna Sittard,1,1,3,1,1,2,0,9.0,6.0
8153,1986-1987,26,AFC Ajax,BV Veendam,4,0,1,3,0,4,4,10.0,3.0
8154,1986-1987,26,AZ Alkmaar,Go Ahead Eagles,1,0,1,3,0,1,1,9.0,2.0
8155,1986-1987,26,FC Den Bosch '67,SBV Excelsior,1,1,3,1,1,2,0,4.0,1.0
8156,1986-1987,26,FC Groningen,Roda JC Kerkrade,1,4,2,0,3,5,-3,6.0,10.0
8157,1986-1987,26,FC Twente,SBV Haarlem,2,3,2,0,3,5,-1,6.0,8.0
8158,1986-1987,26,FC Utrecht,Sparta Rotterdam,3,0,1,3,0,3,3,9.0,3.0
8159,1986-1987,26,Feyenoord,PSV,1,1,3,1,1,2,0,10.0,11.0
8160,1986-1987,27,Sparta Rotterdam,Feyenoord,1,2,2,0,3,3,-1,2.0,13.0
8161,1986-1987,27,SBV Haarlem,FC Groningen,1,0,1,3,0,1,1,8.0,3.0
8162,1986-1987,27,Fortuna Sittard,AFC Ajax,1,3,2,0,3,4,-2,5.0,13.0
8163,1986-1987,27,SBV Excelsior,PEC Zwolle '82,2,2,3,1,1,4,0,2.0,3.0
8164,1986-1987,27,FC Den Haag,FC Twente,0,1,2,0,3,1,-1,3.0,8.0
8165,1986-1987,27,Go Ahead Eagles,FC Utrecht,0,3,2,0,3,3,-3,1.0,12.0
8166,1986-1987,27,PSV,FC Den Bosch '67,6,1,1,3,0,7,5,11.0,4.0
8167,1986-1987,27,Roda JC Kerkrade,VVV-Venlo,1,1,3,1,1,2,0,8.0,9.0
8168,1986-1987,27,BV Veendam,AZ Alkmaar,3,1,1,3,0,4,2,5.0,6.0
8169,1986-1987,28,VVV-Venlo,AFC Ajax,3,0,1,3,0,3,3,9.0,10.0
8170,1986-1987,28,PEC Zwolle '82,PSV,2,0,1,3,0,2,2,6.0,8.0
8171,1986-1987,28,AZ Alkmaar,Fortuna Sittard,0,0,3,1,1,0,0,6.0,6.0
8172,1986-1987,28,FC Den Bosch '67,Sparta Rotterdam,0,0,3,1,1,0,0,4.0,2.0
8173,1986-1987,28,FC Groningen,FC Den Haag,1,0,1,3,0,1,1,5.0,2.0
8174,1986-1987,28,FC Twente,SBV Excelsior,2,2,3,1,1,4,0,6.0,3.0
8175,1986-1987,28,FC Utrecht,BV Veendam,7,1,1,3,0,8,6,12.0,4.0
8176,1986-1987,28,Feyenoord,Go Ahead Eagles,1,1,3,1,1,2,0,11.0,2.0
8177,1986-1987,28,Roda JC Kerkrade,SBV Haarlem,1,0,1,3,0,1,1,11.0,8.0
8178,1986-1987,29,AFC Ajax,AZ Alkmaar,2,0,1,3,0,2,2,10.0,5.0
8179,1986-1987,29,Fortuna Sittard,FC Utrecht,1,0,1,3,0,1,1,6.0,9.0
8180,1986-1987,29,Go Ahead Eagles,FC Den Bosch '67,0,0,3,1,1,0,0,3.0,4.0
8181,1986-1987,29,SBV Haarlem,VVV-Venlo,2,0,1,3,0,2,2,10.0,6.0
8182,1986-1987,29,PSV,FC Twente,4,0,1,3,0,4,4,10.0,5.0
8183,1986-1987,29,SBV Excelsior,FC Groningen,0,0,3,1,1,0,0,4.0,5.0
8184,1986-1987,29,FC Den Haag,Roda JC Kerkrade,2,0,1,3,0,2,2,5.0,8.0
8185,1986-1987,29,Sparta Rotterdam,PEC Zwolle '82,2,1,1,3,0,3,1,5.0,6.0
8186,1986-1987,29,BV Veendam,Feyenoord,1,1,3,1,1,2,0,5.0,9.0
8187,1986-1987,30,PEC Zwolle '82,Go Ahead Eagles,1,1,3,1,1,2,0,6.0,3.0
8188,1986-1987,30,VVV-Venlo,AZ Alkmaar,2,2,3,1,1,4,0,6.0,5.0
8189,1986-1987,30,FC Den Bosch '67,BV Veendam,1,3,2,0,3,4,-2,3.0,7.0
8190,1986-1987,30,FC Groningen,PSV,0,2,2,0,3,2,-2,4.0,10.0
8191,1986-1987,30,FC Twente,Sparta Rotterdam,3,2,1,3,0,5,1,7.0,4.0
8192,1986-1987,30,FC Utrecht,AFC Ajax,2,1,1,3,0,3,1,12.0,9.0
8193,1986-1987,30,Feyenoord,Fortuna Sittard,1,1,3,1,1,2,0,7.0,6.0
8194,1986-1987,30,SBV Haarlem,FC Den Haag,1,1,3,1,1,2,0,10.0,5.0
8195,1986-1987,30,Roda JC Kerkrade,SBV Excelsior,3,0,1,3,0,3,3,10.0,4.0
8196,1986-1987,31,AZ Alkmaar,FC Utrecht,1,1,3,1,1,2,0,3.0,10.0
8197,1986-1987,31,FC Den Haag,VVV-Venlo,1,1,3,1,1,2,0,5.0,6.0
8198,1986-1987,31,Go Ahead Eagles,FC Twente,0,2,2,0,3,2,-2,3.0,10.0
8199,1986-1987,31,PSV,Roda JC Kerkrade,3,0,1,3,0,3,3,12.0,7.0
8200,1986-1987,31,BV Veendam,PEC Zwolle '82,1,4,2,0,3,5,-3,7.0,8.0
8201,1986-1987,31,AFC Ajax,Feyenoord,1,3,2,0,3,4,-2,6.0,9.0
8202,1986-1987,31,SBV Excelsior,SBV Haarlem,2,2,3,1,1,4,0,4.0,8.0
8203,1986-1987,31,Fortuna Sittard,FC Den Bosch '67,5,1,1,3,0,6,4,8.0,2.0
8204,1986-1987,31,Sparta Rotterdam,FC Groningen,2,1,1,3,0,3,1,7.0,4.0
8205,1986-1987,32,FC Groningen,Go Ahead Eagles,0,0,3,1,1,0,0,5.0,4.0
8206,1986-1987,32,PEC Zwolle '82,Fortuna Sittard,3,1,1,3,0,4,2,10.0,8.0
8207,1986-1987,32,FC Den Bosch '67,AFC Ajax,1,4,2,0,3,5,-3,2.0,6.0
8208,1986-1987,32,FC Den Haag,SBV Excelsior,5,2,1,3,0,7,3,8.0,3.0
8209,1986-1987,32,FC Twente,BV Veendam,3,0,1,3,0,3,3,10.0,4.0
8210,1986-1987,32,Feyenoord,AZ Alkmaar,8,0,1,3,0,8,8,9.0,3.0
8211,1986-1987,32,SBV Haarlem,PSV,0,3,2,0,3,3,-3,5.0,12.0
8212,1986-1987,32,Roda JC Kerkrade,Sparta Rotterdam,1,2,2,0,3,3,-1,6.0,10.0
8213,1986-1987,32,VVV-Venlo,FC Utrecht,3,2,1,3,0,5,1,8.0,7.0
8214,1986-1987,33,AFC Ajax,PEC Zwolle '82,5,2,1,3,0,7,3,9.0,7.0
8215,1986-1987,33,AZ Alkmaar,FC Den Bosch '67,2,1,1,3,0,3,1,5.0,1.0
8216,1986-1987,33,FC Utrecht,Feyenoord,4,2,1,3,0,6,2,7.0,8.0
8217,1986-1987,33,Fortuna Sittard,FC Twente,1,0,1,3,0,1,1,10.0,9.0
8218,1986-1987,33,Go Ahead Eagles,Roda JC Kerkrade,2,2,3,1,1,4,0,4.0,4.0
8219,1986-1987,33,PSV,FC Den Haag,7,3,1,3,0,10,4,15.0,8.0
8220,1986-1987,33,Sparta Rotterdam,SBV Haarlem,0,1,2,0,3,1,-1,9.0,8.0
8221,1986-1987,33,BV Veendam,FC Groningen,2,3,2,0,3,5,-1,4.0,5.0
8222,1986-1987,33,VVV-Venlo,SBV Excelsior,6,2,1,3,0,8,4,8.0,2.0
8223,1986-1987,34,SBV Excelsior,PSV,2,3,2,0,3,5,-1,1.0,15.0
8224,1986-1987,34,FC Groningen,Fortuna Sittard,0,1,2,0,3,1,-1,4.0,10.0
8225,1986-1987,34,Feyenoord,VVV-Venlo,1,1,3,1,1,2,0,8.0,9.0
8226,1986-1987,34,Roda JC Kerkrade,BV Veendam,1,1,3,1,1,2,0,5.0,4.0
8227,1986-1987,34,FC Den Bosch '67,FC Utrecht,0,1,2,0,3,1,-1,0.0,10.0
8228,1986-1987,34,FC Den Haag,Sparta Rotterdam,1,3,2,0,3,4,-2,5.0,9.0
8229,1986-1987,34,FC Twente,AFC Ajax,2,1,1,3,0,3,1,12.0,6.0
8230,1986-1987,34,SBV Haarlem,Go Ahead Eagles,3,2,1,3,0,5,1,8.0,3.0
8231,1986-1987,34,PEC Zwolle '82,AZ Alkmaar,3,1,1,3,0,4,2,10.0,5.0
8232,1987-1988,1,PEC Zwolle '82,VVV-Venlo,2,0,1,3,0,2,2,12.0,8.0
8233,1987-1988,1,SBV Haarlem,FC Volendam,4,1,1,3,0,5,3,10.0,4.0
8234,1987-1988,1,AZ Alkmaar,AFC Ajax,1,2,2,0,3,3,-1,4.0,9.0
8235,1987-1988,1,Drechtsteden '79,FC Twente,4,1,1,3,0,5,3,4.0,9.0
8236,1987-1988,1,FC Groningen,Fortuna Sittard,1,2,2,0,3,3,-1,4.0,12.0
8237,1987-1988,1,PSV,FC Den Bosch '67,6,1,1,3,0,7,5,15.0,0.0
8238,1987-1988,1,Sparta Rotterdam,FC Utrecht,6,2,1,3,0,8,4,12.0,7.0
8239,1987-1988,1,Willem II,Feyenoord,2,3,2,0,3,5,-1,1.0,10.0
8240,1987-1988,1,Roda JC Kerkrade,FC Den Haag,2,1,1,3,0,3,1,5.0,4.0
8241,1987-1988,2,AFC Ajax,Roda JC Kerkrade,1,0,1,3,0,1,1,12.0,5.0
8242,1987-1988,2,FC Den Bosch '67,Willem II,3,1,1,3,0,4,2,3.0,0.0
8243,1987-1988,2,FC Den Haag,Sparta Rotterdam,1,1,3,1,1,2,0,4.0,10.0
8244,1987-1988,2,FC Twente,PSV,2,3,2,0,3,5,-1,6.0,15.0
8245,1987-1988,2,FC Utrecht,Drechtsteden '79,2,0,1,3,0,2,2,9.0,4.0
8246,1987-1988,2,FC Volendam,FC Groningen,1,1,3,1,1,2,0,4.0,5.0
8247,1987-1988,2,Feyenoord,PEC Zwolle '82,0,1,2,0,3,1,-1,7.0,12.0
8248,1987-1988,2,Fortuna Sittard,AZ Alkmaar,3,0,1,3,0,3,3,12.0,3.0
8249,1987-1988,2,VVV-Venlo,SBV Haarlem,1,3,2,0,3,4,-2,7.0,12.0
8250,1987-1988,3,AZ Alkmaar,FC Volendam,1,1,3,1,1,2,0,4.0,5.0
8251,1987-1988,3,PEC Zwolle '82,Willem II,1,4,2,0,3,5,-3,9.0,3.0
8252,1987-1988,3,Drechtsteden '79,FC Den Haag,0,3,2,0,3,3,-3,3.0,4.0
8253,1987-1988,3,FC Groningen,VVV-Venlo,1,2,2,0,3,3,-1,4.0,7.0
8254,1987-1988,3,FC Twente,FC Den Bosch '67,1,1,3,1,1,2,0,4.0,4.0
8255,1987-1988,3,SBV Haarlem,Feyenoord,1,2,2,0,3,3,-1,12.0,7.0
8256,1987-1988,3,PSV,FC Utrecht,9,0,1,3,0,9,9,15.0,9.0
8257,1987-1988,3,Sparta Rotterdam,AFC Ajax,2,0,1,3,0,2,2,10.0,9.0
8258,1987-1988,3,Roda JC Kerkrade,Fortuna Sittard,0,2,2,0,3,2,-2,5.0,15.0
8259,1987-1988,4,FC Den Bosch '67,PEC Zwolle '82,1,1,3,1,1,2,0,5.0,10.0
8260,1987-1988,4,FC Utrecht,FC Twente,3,2,1,3,0,5,1,9.0,4.0
8261,1987-1988,4,FC Volendam,Roda JC Kerkrade,5,4,1,3,0,9,1,8.0,4.0
8262,1987-1988,4,Fortuna Sittard,Sparta Rotterdam,1,3,2,0,3,4,-2,12.0,13.0
8263,1987-1988,4,VVV-Venlo,AZ Alkmaar,2,0,1,3,0,2,2,7.0,1.0
8264,1987-1988,4,Willem II,SBV Haarlem,2,2,3,1,1,4,0,4.0,10.0
8265,1987-1988,4,AFC Ajax,Drechtsteden '79,5,3,1,3,0,8,2,9.0,3.0
8266,1987-1988,4,Feyenoord,FC Groningen,3,2,1,3,0,5,1,10.0,1.0
8267,1987-1988,4,FC Den Haag,PSV,1,1,3,1,1,2,0,5.0,13.0
8268,1987-1988,5,SBV Haarlem,PEC Zwolle '82,0,2,2,0,3,2,-2,7.0,10.0
8269,1987-1988,5,AZ Alkmaar,Feyenoord,2,2,3,1,1,4,0,2.0,10.0
8270,1987-1988,5,Drechtsteden '79,Fortuna Sittard,1,5,2,0,3,6,-4,3.0,12.0
8271,1987-1988,5,FC Groningen,Willem II,1,4,2,0,3,5,-3,1.0,7.0
8272,1987-1988,5,FC Twente,FC Den Haag,4,1,1,3,0,5,3,4.0,5.0
8273,1987-1988,5,FC Utrecht,FC Den Bosch '67,2,2,3,1,1,4,0,7.0,6.0
8274,1987-1988,5,PSV,AFC Ajax,4,2,1,3,0,6,2,13.0,9.0
8275,1987-1988,5,Roda JC Kerkrade,VVV-Venlo,0,0,3,1,1,0,0,4.0,7.0
8276,1987-1988,5,Sparta Rotterdam,FC Volendam,4,0,1,3,0,4,4,13.0,5.0
8277,1987-1988,6,PEC Zwolle '82,FC Groningen,1,0,1,3,0,1,1,10.0,1.0
8278,1987-1988,6,VVV-Venlo,Sparta Rotterdam,2,1,1,3,0,3,1,10.0,10.0
8279,1987-1988,6,Willem II,AZ Alkmaar,3,0,1,3,0,3,3,10.0,2.0
8280,1987-1988,6,AFC Ajax,FC Twente,6,1,1,3,0,7,5,9.0,4.0
8281,1987-1988,6,FC Den Bosch '67,SBV Haarlem,0,1,2,0,3,1,-1,6.0,7.0
8282,1987-1988,6,FC Den Haag,FC Utrecht,1,1,3,1,1,2,0,6.0,8.0
8283,1987-1988,6,FC Volendam,Drechtsteden '79,1,1,3,1,1,2,0,6.0,1.0
8284,1987-1988,6,Feyenoord,Roda JC Kerkrade,2,0,1,3,0,2,2,10.0,1.0
8285,1987-1988,6,Fortuna Sittard,PSV,2,4,2,0,3,6,-2,9.0,13.0
8286,1987-1988,7,AZ Alkmaar,PEC Zwolle '82,2,2,3,1,1,4,0,3.0,8.0
8287,1987-1988,7,PSV,FC Volendam,4,1,1,3,0,5,3,13.0,5.0
8288,1987-1988,7,Drechtsteden '79,VVV-Venlo,3,3,3,1,1,6,0,2.0,11.0
8289,1987-1988,7,FC Den Haag,FC Den Bosch '67,2,3,2,0,3,5,-1,5.0,6.0
8290,1987-1988,7,FC Groningen,SBV Haarlem,4,0,1,3,0,4,4,3.0,4.0
8291,1987-1988,7,FC Twente,Fortuna Sittard,0,1,2,0,3,1,-1,4.0,9.0
8292,1987-1988,7,FC Utrecht,AFC Ajax,2,1,1,3,0,3,1,8.0,6.0
8293,1987-1988,7,Roda JC Kerkrade,Willem II,2,1,1,3,0,3,1,4.0,10.0
8294,1987-1988,7,Sparta Rotterdam,Feyenoord,1,1,3,1,1,2,0,10.0,11.0
8295,1987-1988,8,PEC Zwolle '82,Roda JC Kerkrade,0,3,2,0,3,3,-3,8.0,7.0
8296,1987-1988,8,Willem II,Sparta Rotterdam,3,0,1,3,0,3,3,10.0,7.0
8297,1987-1988,8,AFC Ajax,FC Den Haag,4,2,1,3,0,6,2,9.0,2.0
8298,1987-1988,8,FC Den Bosch '67,FC Groningen,2,3,2,0,3,5,-1,5.0,6.0
8299,1987-1988,8,FC Volendam,FC Twente,1,3,2,0,3,4,-2,4.0,6.0
8300,1987-1988,8,Feyenoord,Drechtsteden '79,8,2,1,3,0,10,6,11.0,2.0
8301,1987-1988,8,Fortuna Sittard,FC Utrecht,1,1,3,1,1,2,0,7.0,9.0
8302,1987-1988,8,VVV-Venlo,PSV,0,1,2,0,3,1,-1,8.0,13.0
8303,1987-1988,8,SBV Haarlem,AZ Alkmaar,0,2,2,0,3,2,-2,4.0,5.0
8304,1987-1988,9,AZ Alkmaar,FC Groningen,5,1,1,3,0,6,4,8.0,6.0
8305,1987-1988,9,Drechtsteden '79,Willem II,1,2,2,0,3,3,-1,2.0,12.0
8306,1987-1988,9,FC Utrecht,FC Volendam,0,0,3,1,1,0,0,7.0,2.0
8307,1987-1988,9,AFC Ajax,FC Den Bosch '67,4,0,1,3,0,4,4,9.0,4.0
8308,1987-1988,9,FC Den Haag,Fortuna Sittard,3,1,1,3,0,4,2,4.0,7.0
8309,1987-1988,9,FC Twente,VVV-Venlo,1,1,3,1,1,2,0,7.0,6.0
8310,1987-1988,9,PSV,Feyenoord,3,1,1,3,0,4,2,15.0,8.0
8311,1987-1988,9,Roda JC Kerkrade,SBV Haarlem,4,1,1,3,0,5,3,10.0,3.0
8312,1987-1988,9,Sparta Rotterdam,PEC Zwolle '82,0,0,3,1,1,0,0,5.0,8.0
8313,1987-1988,10,SBV Haarlem,Sparta Rotterdam,1,0,1,3,0,1,1,6.0,2.0
8314,1987-1988,10,PEC Zwolle '82,Drechtsteden '79,2,1,1,3,0,3,1,8.0,2.0
8315,1987-1988,10,FC Den Bosch '67,AZ Alkmaar,2,1,1,3,0,3,1,6.0,7.0
8316,1987-1988,10,FC Groningen,Roda JC Kerkrade,2,2,3,1,1,4,0,7.0,10.0
8317,1987-1988,10,FC Volendam,FC Den Haag,1,5,2,0,3,6,-4,2.0,7.0
8318,1987-1988,10,Feyenoord,FC Twente,3,3,3,1,1,6,0,8.0,5.0
8319,1987-1988,10,Fortuna Sittard,AFC Ajax,3,3,3,1,1,6,0,5.0,10.0
8320,1987-1988,10,VVV-Venlo,FC Utrecht,3,0,1,3,0,3,3,8.0,6.0
8321,1987-1988,10,Willem II,PSV,0,6,2,0,3,6,-6,9.0,15.0
8322,1987-1988,11,FC Twente,Willem II,1,0,1,3,0,1,1,8.0,6.0
8323,1987-1988,11,PSV,PEC Zwolle '82,5,1,1,3,0,6,4,15.0,5.0
8324,1987-1988,11,AFC Ajax,FC Volendam,2,1,1,3,0,3,1,10.0,1.0
8325,1987-1988,11,Drechtsteden '79,SBV Haarlem,2,2,3,1,1,4,0,2.0,4.0
8326,1987-1988,11,FC Den Haag,VVV-Venlo,0,0,3,1,1,0,0,7.0,6.0
8327,1987-1988,11,FC Utrecht,Feyenoord,0,1,2,0,3,1,-1,5.0,8.0
8328,1987-1988,11,Fortuna Sittard,FC Den Bosch '67,3,2,1,3,0,5,1,8.0,6.0
8329,1987-1988,11,Roda JC Kerkrade,AZ Alkmaar,3,0,1,3,0,3,3,13.0,7.0
8330,1987-1988,11,Sparta Rotterdam,FC Groningen,1,2,2,0,3,3,-1,2.0,10.0
8331,1987-1988,12,PEC Zwolle '82,FC Twente,1,2,2,0,3,3,-1,4.0,11.0
8332,1987-1988,12,AZ Alkmaar,Sparta Rotterdam,1,1,3,1,1,2,0,7.0,2.0
8333,1987-1988,12,FC Den Bosch '67,Roda JC Kerkrade,1,0,1,3,0,1,1,6.0,10.0
8334,1987-1988,12,FC Groningen,Drechtsteden '79,1,1,3,1,1,2,0,8.0,2.0
8335,1987-1988,12,FC Volendam,Fortuna Sittard,0,2,2,0,3,2,-2,1.0,8.0
8336,1987-1988,12,Willem II,FC Utrecht,1,0,1,3,0,1,1,9.0,2.0
8337,1987-1988,12,SBV Haarlem,PSV,1,2,2,0,3,3,-1,4.0,15.0
8338,1987-1988,12,VVV-Venlo,AFC Ajax,3,1,1,3,0,4,2,8.0,10.0
8339,1987-1988,12,Feyenoord,FC Den Haag,3,1,1,3,0,4,2,10.0,7.0
8340,1987-1988,13,FC Utrecht,PEC Zwolle '82,2,2,3,1,1,4,0,2.0,5.0
8341,1987-1988,13,Fortuna Sittard,VVV-Venlo,1,1,3,1,1,2,0,8.0,9.0
8342,1987-1988,13,PSV,FC Groningen,4,1,1,3,0,5,3,15.0,5.0
8343,1987-1988,13,AFC Ajax,Feyenoord,3,1,1,3,0,4,2,10.0,7.0
8344,1987-1988,13,Drechtsteden '79,AZ Alkmaar,1,1,3,1,1,2,0,3.0,5.0
8345,1987-1988,13,FC Den Haag,Willem II,0,0,3,1,1,0,0,8.0,7.0
8346,1987-1988,13,FC Twente,SBV Haarlem,1,2,2,0,3,3,-1,8.0,7.0
8347,1987-1988,13,FC Volendam,FC Den Bosch '67,0,3,2,0,3,3,-3,1.0,9.0
8348,1987-1988,13,Sparta Rotterdam,Roda JC Kerkrade,1,0,1,3,0,1,1,5.0,7.0
8349,1987-1988,14,VVV-Venlo,FC Volendam,1,2,2,0,3,3,-1,8.0,3.0
8350,1987-1988,14,AZ Alkmaar,PSV,0,4,2,0,3,4,-4,2.0,15.0
8351,1987-1988,14,FC Den Bosch '67,Sparta Rotterdam,0,0,3,1,1,0,0,10.0,5.0
8352,1987-1988,14,FC Groningen,FC Twente,0,0,3,1,1,0,0,6.0,8.0
8353,1987-1988,14,Feyenoord,Fortuna Sittard,2,1,1,3,0,3,1,10.0,8.0
8354,1987-1988,14,SBV Haarlem,FC Utrecht,0,1,2,0,3,1,-1,7.0,4.0
8355,1987-1988,14,Roda JC Kerkrade,Drechtsteden '79,4,1,1,3,0,5,3,7.0,3.0
8356,1987-1988,14,Willem II,AFC Ajax,0,1,2,0,3,1,-1,4.0,10.0
8357,1987-1988,14,PEC Zwolle '82,FC Den Haag,1,0,1,3,0,1,1,7.0,5.0
8358,1987-1988,15,AFC Ajax,PEC Zwolle '82,6,4,1,3,0,10,2,12.0,4.0
8359,1987-1988,15,Fortuna Sittard,Willem II,2,2,3,1,1,4,0,8.0,5.0
8360,1987-1988,15,PSV,Roda JC Kerkrade,2,1,1,3,0,3,1,15.0,6.0
8361,1987-1988,15,VVV-Venlo,FC Den Bosch '67,1,0,1,3,0,1,1,8.0,7.0
8362,1987-1988,15,FC Den Haag,SBV Haarlem,0,3,2,0,3,3,-3,2.0,7.0
8363,1987-1988,15,FC Twente,AZ Alkmaar,5,0,1,3,0,5,5,10.0,2.0
8364,1987-1988,15,FC Utrecht,FC Groningen,2,2,3,1,1,4,0,5.0,6.0
8365,1987-1988,15,FC Volendam,Feyenoord,1,2,2,0,3,3,-1,3.0,12.0
8366,1987-1988,15,Drechtsteden '79,Sparta Rotterdam,1,2,2,0,3,3,-1,3.0,8.0
8367,1987-1988,16,PEC Zwolle '82,Fortuna Sittard,0,0,3,1,1,0,0,5.0,6.0
8368,1987-1988,16,Willem II,FC Volendam,3,0,1,3,0,3,3,8.0,3.0
8369,1987-1988,16,AZ Alkmaar,FC Utrecht,3,1,1,3,0,4,2,5.0,5.0
8370,1987-1988,16,Drechtsteden '79,FC Den Bosch '67,1,4,2,0,3,5,-3,2.0,10.0
8371,1987-1988,16,FC Groningen,FC Den Haag,2,1,1,3,0,3,1,6.0,1.0
8372,1987-1988,16,SBV Haarlem,AFC Ajax,0,0,3,1,1,0,0,7.0,10.0
8373,1987-1988,16,Roda JC Kerkrade,FC Twente,0,1,2,0,3,1,-1,3.0,10.0
8374,1987-1988,16,Sparta Rotterdam,PSV,0,2,2,0,3,2,-2,8.0,15.0
8375,1987-1988,16,Feyenoord,VVV-Venlo,0,2,2,0,3,2,-2,9.0,10.0
8376,1987-1988,17,AFC Ajax,FC Groningen,2,1,1,3,0,3,1,13.0,5.0
8377,1987-1988,17,FC Den Bosch '67,Feyenoord,3,1,1,3,0,4,2,10.0,6.0
8378,1987-1988,17,FC Den Haag,AZ Alkmaar,4,1,1,3,0,5,3,4.0,4.0
8379,1987-1988,17,FC Twente,Sparta Rotterdam,1,0,1,3,0,1,1,10.0,7.0
8380,1987-1988,17,FC Utrecht,Roda JC Kerkrade,4,1,1,3,0,5,3,8.0,3.0
8381,1987-1988,17,FC Volendam,PEC Zwolle '82,3,1,1,3,0,4,2,6.0,5.0
8382,1987-1988,17,Fortuna Sittard,SBV Haarlem,1,2,2,0,3,3,-1,3.0,10.0
8383,1987-1988,17,PSV,Drechtsteden '79,7,0,1,3,0,7,7,15.0,1.0
8384,1987-1988,17,VVV-Venlo,Willem II,1,1,3,1,1,2,0,8.0,6.0
8385,1987-1988,18,VVV-Venlo,PEC Zwolle '82,5,0,1,3,0,5,5,10.0,4.0
8386,1987-1988,18,Fortuna Sittard,FC Groningen,4,2,1,3,0,6,2,5.0,5.0
8387,1987-1988,18,AFC Ajax,AZ Alkmaar,3,0,1,3,0,3,3,13.0,3.0
8388,1987-1988,18,FC Den Bosch '67,PSV,0,2,2,0,3,2,-2,7.0,15.0
8389,1987-1988,18,FC Den Haag,Roda JC Kerkrade,5,0,1,3,0,5,5,6.0,3.0
8390,1987-1988,18,FC Twente,Drechtsteden '79,7,1,1,3,0,8,6,13.0,0.0
8391,1987-1988,18,FC Utrecht,Sparta Rotterdam,0,0,3,1,1,0,0,8.0,5.0
8392,1987-1988,18,FC Volendam,SBV Haarlem,0,0,3,1,1,0,0,7.0,8.0
8393,1987-1988,18,Feyenoord,Willem II,3,2,1,3,0,5,1,9.0,5.0
8394,1987-1988,19,PEC Zwolle '82,Feyenoord,1,1,3,1,1,2,0,2.0,7.0
8395,1987-1988,19,AZ Alkmaar,Fortuna Sittard,1,1,3,1,1,2,0,4.0,6.0
8396,1987-1988,19,SBV Haarlem,VVV-Venlo,1,0,1,3,0,1,1,11.0,10.0
8397,1987-1988,19,PSV,FC Twente,2,2,3,1,1,4,0,13.0,13.0
8398,1987-1988,19,Drechtsteden '79,FC Utrecht,1,2,2,0,3,3,-1,0.0,8.0
8399,1987-1988,19,FC Groningen,FC Volendam,0,1,2,0,3,1,-1,4.0,7.0
8400,1987-1988,19,Roda JC Kerkrade,AFC Ajax,0,3,2,0,3,3,-3,0.0,13.0
8401,1987-1988,19,Sparta Rotterdam,FC Den Haag,2,1,1,3,0,3,1,7.0,6.0
8402,1987-1988,19,Willem II,FC Den Bosch '67,1,0,1,3,0,1,1,8.0,6.0
8403,1987-1988,20,VVV-Venlo,FC Groningen,1,0,1,3,0,1,1,10.0,3.0
8404,1987-1988,20,Willem II,PEC Zwolle '82,3,1,1,3,0,4,2,10.0,2.0
8405,1987-1988,20,AFC Ajax,Sparta Rotterdam,4,0,1,3,0,4,4,13.0,4.0
8406,1987-1988,20,FC Volendam,AZ Alkmaar,1,1,3,1,1,2,0,8.0,5.0
8407,1987-1988,20,Fortuna Sittard,Roda JC Kerkrade,0,0,3,1,1,0,0,6.0,1.0
8408,1987-1988,20,FC Utrecht,PSV,0,0,3,1,1,0,0,8.0,11.0
8409,1987-1988,20,Feyenoord,SBV Haarlem,0,1,2,0,3,1,-1,4.0,11.0
8410,1987-1988,20,FC Den Bosch '67,FC Twente,2,1,1,3,0,3,1,9.0,10.0
8411,1987-1988,20,FC Den Haag,Drechtsteden '79,4,2,1,3,0,6,2,9.0,0.0
8412,1987-1988,21,PEC Zwolle '82,FC Den Bosch '67,3,2,1,3,0,5,1,4.0,6.0
8413,1987-1988,21,AZ Alkmaar,VVV-Venlo,0,0,3,1,1,0,0,3.0,8.0
8414,1987-1988,21,SBV Haarlem,Willem II,1,3,2,0,3,4,-2,10.0,10.0
8415,1987-1988,21,Drechtsteden '79,AFC Ajax,1,3,2,0,3,4,-2,0.0,15.0
8416,1987-1988,21,FC Groningen,Feyenoord,2,0,1,3,0,2,2,3.0,4.0
8417,1987-1988,21,FC Twente,FC Utrecht,1,0,1,3,0,1,1,10.0,8.0
8418,1987-1988,21,PSV,FC Den Haag,9,1,1,3,0,10,8,11.0,9.0
8419,1987-1988,21,Roda JC Kerkrade,FC Volendam,2,1,1,3,0,3,1,4.0,8.0
8420,1987-1988,21,Sparta Rotterdam,Fortuna Sittard,1,1,3,1,1,2,0,5.0,6.0
8421,1987-1988,22,PEC Zwolle '82,SBV Haarlem,0,1,2,0,3,1,-1,4.0,10.0
8422,1987-1988,22,VVV-Venlo,Roda JC Kerkrade,0,0,3,1,1,0,0,8.0,5.0
8423,1987-1988,22,Willem II,FC Groningen,3,1,1,3,0,4,2,12.0,3.0
8424,1987-1988,22,AFC Ajax,PSV,0,1,2,0,3,1,-1,12.0,11.0
8425,1987-1988,22,FC Den Haag,FC Twente,0,3,2,0,3,3,-3,6.0,10.0
8426,1987-1988,22,FC Volendam,Sparta Rotterdam,2,1,1,3,0,3,1,8.0,5.0
8427,1987-1988,22,Feyenoord,AZ Alkmaar,7,2,1,3,0,9,5,7.0,3.0
8428,1987-1988,22,Fortuna Sittard,Drechtsteden '79,4,1,1,3,0,5,3,9.0,0.0
8429,1987-1988,22,FC Den Bosch '67,FC Utrecht,1,0,1,3,0,1,1,6.0,5.0
8430,1987-1988,23,Roda JC Kerkrade,Feyenoord,1,1,3,1,1,2,0,6.0,5.0
8431,1987-1988,23,Drechtsteden '79,FC Volendam,0,1,2,0,3,1,-1,0.0,10.0
8432,1987-1988,23,AZ Alkmaar,Willem II,0,0,3,1,1,0,0,4.0,13.0
8433,1987-1988,23,SBV Haarlem,FC Den Bosch '67,2,1,1,3,0,3,1,12.0,6.0
8434,1987-1988,23,PSV,Fortuna Sittard,2,2,3,1,1,4,0,9.0,7.0
8435,1987-1988,23,FC Groningen,PEC Zwolle '82,3,1,1,3,0,4,2,6.0,4.0
8436,1987-1988,23,FC Twente,AFC Ajax,1,1,3,1,1,2,0,8.0,10.0
8437,1987-1988,23,FC Utrecht,FC Den Haag,1,1,3,1,1,2,0,5.0,4.0
8438,1987-1988,23,Sparta Rotterdam,VVV-Venlo,0,1,2,0,3,1,-1,4.0,8.0
8439,1987-1988,24,PEC Zwolle '82,AZ Alkmaar,1,2,2,0,3,3,-1,3.0,6.0
8440,1987-1988,24,Willem II,Roda JC Kerkrade,2,2,3,1,1,4,0,11.0,7.0
8441,1987-1988,24,AFC Ajax,FC Utrecht,1,0,1,3,0,1,1,10.0,2.0
8442,1987-1988,24,Fortuna Sittard,FC Twente,1,0,1,3,0,1,1,9.0,7.0
8443,1987-1988,24,SBV Haarlem,FC Groningen,0,1,2,0,3,1,-1,9.0,9.0
8444,1987-1988,24,VVV-Venlo,Drechtsteden '79,1,3,2,0,3,4,-2,8.0,3.0
8445,1987-1988,24,FC Den Bosch '67,FC Den Haag,1,0,1,3,0,1,1,9.0,4.0
8446,1987-1988,24,FC Volendam,PSV,1,6,2,0,3,7,-5,7.0,11.0
8447,1987-1988,24,Feyenoord,Sparta Rotterdam,5,1,1,3,0,6,4,7.0,1.0
8448,1987-1988,25,AZ Alkmaar,SBV Haarlem,2,2,3,1,1,4,0,6.0,7.0
8449,1987-1988,25,PSV,VVV-Venlo,5,0,1,3,0,5,5,13.0,5.0
8450,1987-1988,25,Drechtsteden '79,Feyenoord,1,1,3,1,1,2,0,4.0,8.0
8451,1987-1988,25,FC Den Haag,AFC Ajax,1,1,3,1,1,2,0,2.0,8.0
8452,1987-1988,25,FC Twente,FC Volendam,2,0,1,3,0,2,2,10.0,6.0
8453,1987-1988,25,FC Utrecht,Fortuna Sittard,2,1,1,3,0,3,1,4.0,8.0
8454,1987-1988,25,Roda JC Kerkrade,PEC Zwolle '82,2,0,1,3,0,2,2,9.0,3.0
8455,1987-1988,25,Sparta Rotterdam,Willem II,2,1,1,3,0,3,1,4.0,8.0
8456,1987-1988,25,FC Groningen,FC Den Bosch '67,1,2,2,0,3,3,-1,9.0,9.0
8457,1987-1988,26,PEC Zwolle '82,Sparta Rotterdam,2,1,1,3,0,3,1,3.0,3.0
8458,1987-1988,26,SBV Haarlem,Roda JC Kerkrade,2,1,1,3,0,3,1,10.0,6.0
8459,1987-1988,26,VVV-Venlo,FC Twente,0,0,3,1,1,0,0,5.0,8.0
8460,1987-1988,26,Willem II,Drechtsteden '79,2,0,1,3,0,2,2,8.0,4.0
8461,1987-1988,26,FC Den Bosch '67,AFC Ajax,0,2,2,0,3,2,-2,9.0,8.0
8462,1987-1988,26,FC Groningen,AZ Alkmaar,4,2,1,3,0,6,2,9.0,5.0
8463,1987-1988,26,FC Volendam,FC Utrecht,3,1,1,3,0,4,2,9.0,4.0
8464,1987-1988,26,Feyenoord,PSV,2,1,1,3,0,3,1,11.0,10.0
8465,1987-1988,26,Fortuna Sittard,FC Den Haag,2,1,1,3,0,3,1,10.0,2.0
8466,1987-1988,27,Roda JC Kerkrade,FC Groningen,2,1,1,3,0,3,1,8.0,9.0
8467,1987-1988,27,AZ Alkmaar,FC Den Bosch '67,0,1,2,0,3,1,-1,5.0,9.0
8468,1987-1988,27,PSV,Willem II,3,1,1,3,0,4,2,10.0,5.0
8469,1987-1988,27,AFC Ajax,Fortuna Sittard,4,0,1,3,0,4,4,11.0,7.0
8470,1987-1988,27,FC Den Haag,FC Volendam,1,3,2,0,3,4,-2,2.0,9.0
8471,1987-1988,27,FC Twente,Feyenoord,0,0,3,1,1,0,0,6.0,9.0
8472,1987-1988,27,Sparta Rotterdam,SBV Haarlem,1,0,1,3,0,1,1,6.0,7.0
8473,1987-1988,27,FC Utrecht,VVV-Venlo,1,0,1,3,0,1,1,7.0,4.0
8474,1987-1988,27,Drechtsteden '79,PEC Zwolle '82,2,2,3,1,1,4,0,5.0,4.0
8475,1987-1988,28,AZ Alkmaar,Roda JC Kerkrade,4,1,1,3,0,5,3,7.0,7.0
8476,1987-1988,28,SBV Haarlem,Drechtsteden '79,2,0,1,3,0,2,2,7.0,5.0
8477,1987-1988,28,PEC Zwolle '82,PSV,0,6,2,0,3,6,-6,4.0,12.0
8478,1987-1988,28,Willem II,FC Twente,1,1,3,1,1,2,0,5.0,6.0
8479,1987-1988,28,FC Den Bosch '67,Fortuna Sittard,1,1,3,1,1,2,0,10.0,7.0
8480,1987-1988,28,FC Groningen,Sparta Rotterdam,0,0,3,1,1,0,0,7.0,7.0
8481,1987-1988,28,FC Volendam,AFC Ajax,1,2,2,0,3,3,-1,6.0,13.0
8482,1987-1988,28,VVV-Venlo,FC Den Haag,3,2,1,3,0,5,1,4.0,1.0
8483,1987-1988,28,Feyenoord,FC Utrecht,1,3,2,0,3,4,-2,8.0,9.0
8484,1987-1988,29,AFC Ajax,VVV-Venlo,1,0,1,3,0,1,1,13.0,4.0
8485,1987-1988,29,Drechtsteden '79,FC Groningen,0,4,2,0,3,4,-4,2.0,7.0
8486,1987-1988,29,FC Twente,PEC Zwolle '82,3,0,1,3,0,3,3,9.0,4.0
8487,1987-1988,29,FC Utrecht,Willem II,1,1,3,1,1,2,0,10.0,5.0
8488,1987-1988,29,Fortuna Sittard,FC Volendam,0,0,3,1,1,0,0,5.0,7.0
8489,1987-1988,29,PSV,SBV Haarlem,1,0,1,3,0,1,1,12.0,7.0
8490,1987-1988,29,Roda JC Kerkrade,FC Den Bosch '67,0,1,2,0,3,1,-1,6.0,10.0
8491,1987-1988,29,Sparta Rotterdam,AZ Alkmaar,0,1,2,0,3,1,-1,7.0,7.0
8492,1987-1988,29,FC Den Haag,Feyenoord,2,2,3,1,1,4,0,2.0,6.0
8493,1987-1988,30,AZ Alkmaar,Drechtsteden '79,2,1,1,3,0,3,1,9.0,1.0
8494,1987-1988,30,FC Den Bosch '67,FC Volendam,0,1,2,0,3,1,-1,7.0,10.0
8495,1987-1988,30,SBV Haarlem,FC Twente,1,5,2,0,3,6,-4,6.0,9.0
8496,1987-1988,30,PEC Zwolle '82,FC Utrecht,2,2,3,1,1,4,0,5.0,8.0
8497,1987-1988,30,Roda JC Kerkrade,Sparta Rotterdam,1,3,2,0,3,4,-2,3.0,7.0
8498,1987-1988,30,VVV-Venlo,Fortuna Sittard,3,1,1,3,0,4,2,7.0,5.0
8499,1987-1988,30,FC Groningen,PSV,2,0,1,3,0,2,2,10.0,9.0
8500,1987-1988,30,Feyenoord,AFC Ajax,1,3,2,0,3,4,-2,5.0,15.0
8501,1987-1988,30,Willem II,FC Den Haag,3,1,1,3,0,4,2,8.0,1.0
8502,1987-1988,31,Drechtsteden '79,Roda JC Kerkrade,4,4,3,1,1,8,0,2.0,4.0
8503,1987-1988,31,PSV,AZ Alkmaar,1,0,1,3,0,1,1,12.0,9.0
8504,1987-1988,31,AFC Ajax,Willem II,3,1,1,3,0,4,2,15.0,5.0
8505,1987-1988,31,FC Den Haag,PEC Zwolle '82,2,1,1,3,0,3,1,4.0,2.0
8506,1987-1988,31,FC Twente,FC Groningen,2,1,1,3,0,3,1,11.0,7.0
8507,1987-1988,31,FC Utrecht,SBV Haarlem,2,0,1,3,0,2,2,11.0,3.0
8508,1987-1988,31,FC Volendam,VVV-Venlo,3,3,3,1,1,6,0,8.0,7.0
8509,1987-1988,31,Fortuna Sittard,Feyenoord,1,2,2,0,3,3,-1,2.0,5.0
8510,1987-1988,31,Sparta Rotterdam,FC Den Bosch '67,3,1,1,3,0,4,2,10.0,7.0
8511,1987-1988,32,AZ Alkmaar,FC Twente,2,0,1,3,0,2,2,12.0,10.0
8512,1987-1988,32,Feyenoord,FC Volendam,1,2,2,0,3,3,-1,4.0,8.0
8513,1987-1988,32,PEC Zwolle '82,AFC Ajax,2,0,1,3,0,2,2,4.0,12.0
8514,1987-1988,32,Willem II,Fortuna Sittard,1,1,3,1,1,2,0,6.0,3.0
8515,1987-1988,32,FC Den Bosch '67,VVV-Venlo,0,0,3,1,1,0,0,5.0,8.0
8516,1987-1988,32,FC Groningen,FC Utrecht,2,0,1,3,0,2,2,10.0,8.0
8517,1987-1988,32,SBV Haarlem,FC Den Haag,5,1,1,3,0,6,4,6.0,4.0
8518,1987-1988,32,Roda JC Kerkrade,PSV,1,1,3,1,1,2,0,2.0,10.0
8519,1987-1988,32,Sparta Rotterdam,Drechtsteden '79,3,1,1,3,0,4,2,10.0,1.0
8520,1987-1988,33,AFC Ajax,SBV Haarlem,3,1,1,3,0,4,2,12.0,3.0
8521,1987-1988,33,FC Den Bosch '67,Drechtsteden '79,1,0,1,3,0,1,1,7.0,1.0
8522,1987-1988,33,FC Den Haag,FC Groningen,0,3,2,0,3,3,-3,4.0,12.0
8523,1987-1988,33,FC Twente,Roda JC Kerkrade,1,0,1,3,0,1,1,12.0,2.0
8524,1987-1988,33,FC Utrecht,AZ Alkmaar,3,2,1,3,0,5,1,8.0,9.0
8525,1987-1988,33,FC Volendam,Willem II,1,5,2,0,3,6,-4,8.0,8.0
8526,1987-1988,33,Fortuna Sittard,PEC Zwolle '82,0,2,2,0,3,2,-2,2.0,7.0
8527,1987-1988,33,PSV,Sparta Rotterdam,6,2,1,3,0,8,4,10.0,9.0
8528,1987-1988,33,VVV-Venlo,Feyenoord,2,0,1,3,0,2,2,8.0,4.0
8529,1987-1988,34,AZ Alkmaar,FC Den Haag,3,1,1,3,0,4,2,9.0,3.0
8530,1987-1988,34,Drechtsteden '79,PSV,0,4,2,0,3,4,-4,1.0,10.0
8531,1987-1988,34,FC Groningen,AFC Ajax,2,1,1,3,0,3,1,12.0,9.0
8532,1987-1988,34,Feyenoord,FC Den Bosch '67,1,4,2,0,3,5,-3,3.0,7.0
8533,1987-1988,34,SBV Haarlem,Fortuna Sittard,0,0,3,1,1,0,0,4.0,2.0
8534,1987-1988,34,PEC Zwolle '82,FC Volendam,0,0,3,1,1,0,0,8.0,8.0
8535,1987-1988,34,Roda JC Kerkrade,FC Utrecht,3,0,1,3,0,3,3,5.0,7.0
8536,1987-1988,34,Sparta Rotterdam,FC Twente,1,5,2,0,3,6,-4,9.0,12.0
8537,1987-1988,34,Willem II,VVV-Venlo,1,1,3,1,1,2,0,8.0,9.0
8538,1988-1989,1,MVV Maastricht,SBV Haarlem,1,1,3,1,1,2,0,11.0,5.0
8539,1988-1989,1,BV Veendam,PEC Zwolle '82,1,2,2,0,3,3,-1,1.0,10.0
8540,1988-1989,1,VVV-Venlo,Roda JC Kerkrade,2,2,3,1,1,4,0,7.0,6.0
8541,1988-1989,1,Willem II,Sparta Rotterdam,2,2,3,1,1,4,0,6.0,7.0
8542,1988-1989,1,BVV Den Bosch,FC Twente,1,1,3,1,1,2,0,,10.0
8543,1988-1989,1,FC Utrecht,FC Groningen,3,2,1,3,0,5,1,9.0,9.0
8544,1988-1989,1,FC Volendam,RKC Waalwijk,4,2,1,3,0,6,2,8.0,
8545,1988-1989,1,Feyenoord,PSV,2,2,3,1,1,4,0,4.0,11.0
8546,1988-1989,1,Fortuna Sittard,AFC Ajax,2,1,1,3,0,3,1,5.0,6.0
8547,1988-1989,2,AFC Ajax,BV Veendam,4,0,1,3,0,4,4,6.0,1.0
8548,1988-1989,2,FC Groningen,Fortuna Sittard,2,2,3,1,1,4,0,10.0,6.0
8549,1988-1989,2,FC Twente,VVV-Venlo,1,0,1,3,0,1,1,10.0,6.0
8550,1988-1989,2,SBV Haarlem,FC Utrecht,2,1,1,3,0,3,1,8.0,6.0
8551,1988-1989,2,PEC Zwolle '82,Willem II,3,2,1,3,0,5,1,13.0,6.0
8552,1988-1989,2,RKC Waalwijk,Feyenoord,1,1,3,1,1,2,0,,2.0
8553,1988-1989,2,Roda JC Kerkrade,FC Volendam,0,0,3,1,1,0,0,6.0,8.0
8554,1988-1989,2,Sparta Rotterdam,BVV Den Bosch,1,1,3,1,1,2,0,5.0,
8555,1988-1989,2,PSV,MVV Maastricht,3,1,1,3,0,4,2,11.0,8.0
8556,1988-1989,3,PSV,FC Volendam,2,0,1,3,0,2,2,13.0,5.0
8557,1988-1989,3,FC Groningen,MVV Maastricht,4,1,1,3,0,5,3,10.0,5.0
8558,1988-1989,3,FC Twente,Willem II,0,0,3,1,1,0,0,11.0,6.0
8559,1988-1989,3,FC Utrecht,Fortuna Sittard,3,1,1,3,0,4,2,9.0,5.0
8560,1988-1989,3,SBV Haarlem,Feyenoord,1,2,2,0,3,3,-1,5.0,5.0
8561,1988-1989,3,RKC Waalwijk,VVV-Venlo,6,0,1,3,0,6,6,,5.0
8562,1988-1989,3,Roda JC Kerkrade,BVV Den Bosch,3,2,1,3,0,5,1,8.0,
8563,1988-1989,3,Sparta Rotterdam,BV Veendam,3,1,1,3,0,4,2,5.0,1.0
8564,1988-1989,3,PEC Zwolle '82,AFC Ajax,4,1,1,3,0,5,3,13.0,6.0
8565,1988-1989,4,AFC Ajax,Sparta Rotterdam,2,1,1,3,0,3,1,6.0,5.0
8566,1988-1989,4,BVV Den Bosch,RKC Waalwijk,1,0,1,3,0,1,1,,
8567,1988-1989,4,FC Volendam,SBV Haarlem,4,0,1,3,0,4,4,8.0,5.0
8568,1988-1989,4,Feyenoord,FC Groningen,2,1,1,3,0,3,1,8.0,7.0
8569,1988-1989,4,Fortuna Sittard,PEC Zwolle '82,1,0,1,3,0,1,1,8.0,10.0
8570,1988-1989,4,MVV Maastricht,FC Utrecht,0,2,2,0,3,2,-2,4.0,9.0
8571,1988-1989,4,BV Veendam,FC Twente,0,3,2,0,3,3,-3,1.0,11.0
8572,1988-1989,4,VVV-Venlo,PSV,0,2,2,0,3,2,-2,2.0,13.0
8573,1988-1989,4,Willem II,Roda JC Kerkrade,1,0,1,3,0,1,1,6.0,8.0
8574,1988-1989,5,MVV Maastricht,Fortuna Sittard,2,1,1,3,0,3,1,4.0,7.0
8575,1988-1989,5,Roda JC Kerkrade,BV Veendam,2,0,1,3,0,2,2,8.0,0.0
8576,1988-1989,5,FC Groningen,FC Volendam,4,0,1,3,0,4,4,7.0,7.0
8577,1988-1989,5,FC Twente,AFC Ajax,2,1,1,3,0,3,1,11.0,6.0
8578,1988-1989,5,FC Utrecht,Feyenoord,3,1,1,3,0,4,2,12.0,8.0
8579,1988-1989,5,SBV Haarlem,VVV-Venlo,2,0,1,3,0,2,2,7.0,1.0
8580,1988-1989,5,PSV,BVV Den Bosch,5,2,1,3,0,7,3,13.0,5.0
8581,1988-1989,5,RKC Waalwijk,Willem II,3,1,1,3,0,4,2,7.0,5.0
8582,1988-1989,5,Sparta Rotterdam,PEC Zwolle '82,3,1,1,3,0,4,2,8.0,9.0
8583,1988-1989,6,Fortuna Sittard,Sparta Rotterdam,3,0,1,3,0,3,3,7.0,7.0
8584,1988-1989,6,PEC Zwolle '82,FC Twente,2,2,3,1,1,4,0,7.0,11.0
8585,1988-1989,6,BV Veendam,RKC Waalwijk,2,0,1,3,0,2,2,3.0,7.0
8586,1988-1989,6,VVV-Venlo,FC Groningen,1,1,3,1,1,2,0,1.0,8.0
8587,1988-1989,6,AFC Ajax,Roda JC Kerkrade,3,3,3,1,1,6,0,7.0,8.0
8588,1988-1989,6,BVV Den Bosch,SBV Haarlem,2,5,2,0,3,7,-3,4.0,9.0
8589,1988-1989,6,FC Volendam,FC Utrecht,4,0,1,3,0,4,4,7.0,9.0
8590,1988-1989,6,Feyenoord,MVV Maastricht,5,2,1,3,0,7,3,10.0,3.0
8591,1988-1989,6,Willem II,PSV,1,3,2,0,3,4,-2,4.0,15.0
8592,1988-1989,7,MVV Maastricht,FC Volendam,1,3,2,0,3,4,-2,3.0,9.0
8593,1988-1989,7,PSV,BV Veendam,3,1,1,3,0,4,2,15.0,3.0
8594,1988-1989,7,FC Groningen,BVV Den Bosch,4,0,1,3,0,4,4,10.0,3.0
8595,1988-1989,7,FC Twente,Sparta Rotterdam,2,0,1,3,0,2,2,11.0,6.0
8596,1988-1989,7,FC Utrecht,VVV-Venlo,0,0,3,1,1,0,0,10.0,2.0
8597,1988-1989,7,Feyenoord,Fortuna Sittard,4,2,1,3,0,6,2,12.0,6.0
8598,1988-1989,7,SBV Haarlem,Willem II,2,2,3,1,1,4,0,7.0,5.0
8599,1988-1989,7,RKC Waalwijk,AFC Ajax,3,1,1,3,0,4,2,9.0,4.0
8600,1988-1989,7,Roda JC Kerkrade,PEC Zwolle '82,2,1,1,3,0,3,1,10.0,4.0
8601,1988-1989,8,PEC Zwolle '82,RKC Waalwijk,3,0,1,3,0,3,3,4.0,6.0
8602,1988-1989,8,VVV-Venlo,MVV Maastricht,1,1,3,1,1,2,0,3.0,4.0
8603,1988-1989,8,Fortuna Sittard,FC Twente,0,0,3,1,1,0,0,7.0,11.0
8604,1988-1989,8,BV Veendam,SBV Haarlem,2,0,1,3,0,2,2,6.0,7.0
8605,1988-1989,8,Willem II,FC Groningen,2,3,2,0,3,5,-1,4.0,10.0
8606,1988-1989,8,AFC Ajax,PSV,2,0,1,3,0,2,2,7.0,12.0
8607,1988-1989,8,BVV Den Bosch,FC Utrecht,1,0,1,3,0,1,1,6.0,7.0
8608,1988-1989,8,Sparta Rotterdam,Roda JC Kerkrade,0,1,2,0,3,1,-1,3.0,10.0
8609,1988-1989,8,FC Volendam,Feyenoord,1,3,2,0,3,4,-2,9.0,12.0
8610,1988-1989,9,FC Utrecht,Willem II,0,2,2,0,3,2,-2,4.0,4.0
8611,1988-1989,9,FC Volendam,Fortuna Sittard,0,2,2,0,3,2,-2,6.0,7.0
8612,1988-1989,9,MVV Maastricht,BVV Den Bosch,0,2,2,0,3,2,-2,4.0,6.0
8613,1988-1989,9,PSV,PEC Zwolle '82,2,0,1,3,0,2,2,12.0,4.0
8614,1988-1989,9,RKC Waalwijk,Sparta Rotterdam,2,2,3,1,1,4,0,7.0,4.0
8615,1988-1989,9,Roda JC Kerkrade,FC Twente,1,1,3,1,1,2,0,11.0,9.0
8616,1988-1989,9,FC Groningen,BV Veendam,1,3,2,0,3,4,-2,10.0,9.0
8617,1988-1989,9,Feyenoord,VVV-Venlo,2,2,3,1,1,4,0,10.0,4.0
8618,1988-1989,9,SBV Haarlem,AFC Ajax,0,1,2,0,3,1,-1,7.0,7.0
8619,1988-1989,10,PEC Zwolle '82,SBV Haarlem,1,2,2,0,3,3,-1,4.0,7.0
8620,1988-1989,10,Fortuna Sittard,Roda JC Kerkrade,1,1,3,1,1,2,0,8.0,9.0
8621,1988-1989,10,VVV-Venlo,FC Volendam,1,2,2,0,3,3,-1,4.0,9.0
8622,1988-1989,10,Willem II,MVV Maastricht,2,2,3,1,1,4,0,5.0,2.0
8623,1988-1989,10,AFC Ajax,FC Groningen,3,0,1,3,0,3,3,10.0,7.0
8624,1988-1989,10,BVV Den Bosch,Feyenoord,2,0,1,3,0,2,2,9.0,10.0
8625,1988-1989,10,FC Twente,RKC Waalwijk,7,1,1,3,0,8,6,9.0,4.0
8626,1988-1989,10,Sparta Rotterdam,PSV,0,2,2,0,3,2,-2,1.0,12.0
8627,1988-1989,10,BV Veendam,FC Utrecht,1,0,1,3,0,1,1,12.0,1.0
8628,1988-1989,11,MVV Maastricht,BV Veendam,1,2,2,0,3,3,-1,2.0,12.0
8629,1988-1989,11,PSV,FC Twente,3,0,1,3,0,3,3,12.0,8.0
8630,1988-1989,11,VVV-Venlo,Fortuna Sittard,1,2,2,0,3,3,-1,3.0,8.0
8631,1988-1989,11,FC Groningen,PEC Zwolle '82,3,0,1,3,0,3,3,9.0,3.0
8632,1988-1989,11,FC Utrecht,AFC Ajax,1,1,3,1,1,2,0,2.0,10.0
8633,1988-1989,11,FC Volendam,BVV Den Bosch,2,0,1,3,0,2,2,9.0,9.0
8634,1988-1989,11,Feyenoord,Willem II,5,0,1,3,0,5,5,10.0,5.0
8635,1988-1989,11,SBV Haarlem,Sparta Rotterdam,2,0,1,3,0,2,2,7.0,1.0
8636,1988-1989,11,RKC Waalwijk,Roda JC Kerkrade,1,4,2,0,3,5,-3,4.0,11.0
8637,1988-1989,12,PEC Zwolle '82,FC Utrecht,2,1,1,3,0,3,1,6.0,1.0
8638,1988-1989,12,Fortuna Sittard,RKC Waalwijk,2,0,1,3,0,2,2,11.0,1.0
8639,1988-1989,12,Willem II,FC Volendam,2,4,2,0,3,6,-2,4.0,9.0
8640,1988-1989,12,AFC Ajax,MVV Maastricht,4,0,1,3,0,4,4,13.0,2.0
8641,1988-1989,12,BVV Den Bosch,VVV-Venlo,1,4,2,0,3,5,-3,9.0,5.0
8642,1988-1989,12,FC Twente,SBV Haarlem,0,0,3,1,1,0,0,6.0,7.0
8643,1988-1989,12,Roda JC Kerkrade,PSV,0,1,2,0,3,1,-1,8.0,12.0
8644,1988-1989,12,Sparta Rotterdam,FC Groningen,1,1,3,1,1,2,0,2.0,7.0
8645,1988-1989,12,BV Veendam,Feyenoord,1,2,2,0,3,3,-1,12.0,10.0
8646,1988-1989,13,MVV Maastricht,PEC Zwolle '82,4,2,1,3,0,6,2,4.0,3.0
8647,1988-1989,13,PSV,RKC Waalwijk,5,2,1,3,0,7,3,15.0,1.0
8648,1988-1989,13,VVV-Venlo,Willem II,1,1,3,1,1,2,0,5.0,5.0
8649,1988-1989,13,BVV Den Bosch,Fortuna Sittard,0,3,2,0,3,3,-3,6.0,13.0
8650,1988-1989,13,FC Groningen,FC Twente,2,0,1,3,0,2,2,7.0,5.0
8651,1988-1989,13,FC Utrecht,Sparta Rotterdam,2,2,3,1,1,4,0,2.0,3.0
8652,1988-1989,13,FC Volendam,BV Veendam,3,1,1,3,0,4,2,12.0,9.0
8653,1988-1989,13,Feyenoord,AFC Ajax,1,2,2,0,3,3,-1,7.0,13.0
8654,1988-1989,13,SBV Haarlem,Roda JC Kerkrade,1,0,1,3,0,1,1,10.0,5.0
8655,1988-1989,14,PEC Zwolle '82,Feyenoord,2,4,2,0,3,6,-2,3.0,9.0
8656,1988-1989,14,Fortuna Sittard,PSV,1,0,1,3,0,1,1,13.0,12.0
8657,1988-1989,14,BV Veendam,VVV-Venlo,0,0,3,1,1,0,0,7.0,5.0
8658,1988-1989,14,Willem II,BVV Den Bosch,1,3,2,0,3,4,-2,2.0,6.0
8659,1988-1989,14,AFC Ajax,FC Volendam,2,0,1,3,0,2,2,13.0,12.0
8660,1988-1989,14,FC Twente,FC Utrecht,0,0,3,1,1,0,0,5.0,3.0
8661,1988-1989,14,RKC Waalwijk,SBV Haarlem,3,1,1,3,0,4,2,3.0,10.0
8662,1988-1989,14,Roda JC Kerkrade,FC Groningen,1,1,3,1,1,2,0,5.0,8.0
8663,1988-1989,14,Sparta Rotterdam,MVV Maastricht,1,1,3,1,1,2,0,3.0,5.0
8664,1988-1989,15,VVV-Venlo,AFC Ajax,1,2,2,0,3,3,-1,5.0,13.0
8665,1988-1989,15,SBV Haarlem,PSV,2,0,1,3,0,2,2,10.0,9.0
8666,1988-1989,15,MVV Maastricht,FC Twente,0,1,2,0,3,1,-1,4.0,5.0
8667,1988-1989,15,Willem II,Fortuna Sittard,0,2,2,0,3,2,-2,1.0,15.0
8668,1988-1989,15,BVV Den Bosch,BV Veendam,1,1,3,1,1,2,0,4.0,5.0
8669,1988-1989,15,FC Utrecht,Roda JC Kerkrade,3,2,1,3,0,5,1,6.0,4.0
8670,1988-1989,15,FC Volendam,PEC Zwolle '82,1,1,3,1,1,2,0,10.0,4.0
8671,1988-1989,15,Feyenoord,Sparta Rotterdam,3,2,1,3,0,5,1,12.0,3.0
8672,1988-1989,15,FC Groningen,RKC Waalwijk,1,2,2,0,3,3,-1,8.0,6.0
8673,1988-1989,16,PEC Zwolle '82,VVV-Venlo,2,2,3,1,1,4,0,5.0,6.0
8674,1988-1989,16,BV Veendam,Willem II,1,1,3,1,1,2,0,3.0,2.0
8675,1988-1989,16,AFC Ajax,BVV Den Bosch,5,1,1,3,0,6,4,15.0,4.0
8676,1988-1989,16,FC Twente,Feyenoord,6,1,1,3,0,7,5,8.0,9.0
8677,1988-1989,16,SBV Haarlem,Fortuna Sittard,2,2,3,1,1,4,0,8.0,13.0
8678,1988-1989,16,RKC Waalwijk,FC Utrecht,5,3,1,3,0,8,2,9.0,5.0
8679,1988-1989,16,Roda JC Kerkrade,MVV Maastricht,1,1,3,1,1,2,0,2.0,5.0
8680,1988-1989,16,Sparta Rotterdam,FC Volendam,3,0,1,3,0,3,3,6.0,7.0
8681,1988-1989,16,PSV,FC Groningen,1,0,1,3,0,1,1,9.0,5.0
8682,1988-1989,17,MVV Maastricht,RKC Waalwijk,1,0,1,3,0,1,1,8.0,9.0
8683,1988-1989,17,Fortuna Sittard,BV Veendam,1,2,2,0,3,3,-1,10.0,6.0
8684,1988-1989,17,VVV-Venlo,Sparta Rotterdam,0,2,2,0,3,2,-2,3.0,8.0
8685,1988-1989,17,BVV Den Bosch,PEC Zwolle '82,4,0,1,3,0,4,4,7.0,2.0
8686,1988-1989,17,FC Groningen,SBV Haarlem,2,0,1,3,0,2,2,7.0,7.0
8687,1988-1989,17,FC Utrecht,PSV,1,3,2,0,3,4,-2,5.0,9.0
8688,1988-1989,17,FC Volendam,FC Twente,1,1,3,1,1,2,0,5.0,8.0
8689,1988-1989,17,Feyenoord,Roda JC Kerkrade,2,1,1,3,0,3,1,9.0,2.0
8690,1988-1989,17,Willem II,AFC Ajax,2,5,2,0,3,7,-3,2.0,15.0
8691,1988-1989,18,PEC Zwolle '82,BV Veendam,6,2,1,3,0,8,4,5.0,6.0
8692,1988-1989,18,AFC Ajax,Fortuna Sittard,2,0,1,3,0,2,2,15.0,7.0
8693,1988-1989,18,FC Groningen,FC Utrecht,4,2,1,3,0,6,2,7.0,4.0
8694,1988-1989,18,FC Twente,BVV Den Bosch,0,1,2,0,3,1,-1,8.0,10.0
8695,1988-1989,18,SBV Haarlem,MVV Maastricht,0,4,2,0,3,4,-4,4.0,8.0
8696,1988-1989,18,PSV,Feyenoord,1,0,1,3,0,1,1,9.0,9.0
8697,1988-1989,18,RKC Waalwijk,FC Volendam,5,1,1,3,0,6,4,12.0,2.0
8698,1988-1989,18,Roda JC Kerkrade,VVV-Venlo,2,1,1,3,0,3,1,5.0,2.0
8699,1988-1989,18,Sparta Rotterdam,Willem II,1,1,3,1,1,2,0,8.0,2.0
8700,1988-1989,19,Fortuna Sittard,FC Groningen,0,0,3,1,1,0,0,5.0,7.0
8701,1988-1989,19,MVV Maastricht,PSV,1,3,2,0,3,4,-2,7.0,12.0
8702,1988-1989,19,VVV-Venlo,FC Twente,1,1,3,1,1,2,0,2.0,8.0
8703,1988-1989,19,Willem II,PEC Zwolle '82,4,1,1,3,0,5,3,5.0,5.0
8704,1988-1989,19,BVV Den Bosch,Sparta Rotterdam,2,1,1,3,0,3,1,10.0,7.0
8705,1988-1989,19,FC Utrecht,SBV Haarlem,2,1,1,3,0,3,1,6.0,4.0
8706,1988-1989,19,FC Volendam,Roda JC Kerkrade,1,0,1,3,0,1,1,5.0,4.0
8707,1988-1989,19,Feyenoord,RKC Waalwijk,0,0,3,1,1,0,0,7.0,10.0
8708,1988-1989,19,BV Veendam,AFC Ajax,0,1,2,0,3,1,-1,5.0,15.0
8709,1988-1989,20,BV Veendam,Sparta Rotterdam,0,1,2,0,3,1,-1,4.0,10.0
8710,1988-1989,20,Fortuna Sittard,FC Utrecht,1,2,2,0,3,3,-1,2.0,6.0
8711,1988-1989,20,MVV Maastricht,FC Groningen,3,1,1,3,0,4,2,10.0,7.0
8712,1988-1989,20,VVV-Venlo,RKC Waalwijk,1,1,3,1,1,2,0,3.0,8.0
8713,1988-1989,20,Willem II,FC Twente,0,0,3,1,1,0,0,6.0,6.0
8714,1988-1989,20,AFC Ajax,PEC Zwolle '82,0,0,3,1,1,0,0,13.0,5.0
8715,1988-1989,20,BVV Den Bosch,Roda JC Kerkrade,0,1,2,0,3,1,-1,9.0,7.0
8716,1988-1989,20,FC Volendam,PSV,1,1,3,1,1,2,0,5.0,13.0
8717,1988-1989,20,Feyenoord,SBV Haarlem,3,0,1,3,0,3,3,7.0,1.0
8718,1988-1989,21,PEC Zwolle '82,Fortuna Sittard,2,0,1,3,0,2,2,7.0,1.0
8719,1988-1989,21,PSV,VVV-Venlo,5,2,1,3,0,7,3,13.0,2.0
8720,1988-1989,21,FC Groningen,Feyenoord,1,1,3,1,1,2,0,8.0,8.0
8721,1988-1989,21,FC Twente,BV Veendam,3,0,1,3,0,3,3,6.0,3.0
8722,1988-1989,21,FC Utrecht,MVV Maastricht,2,2,3,1,1,4,0,7.0,10.0
8723,1988-1989,21,SBV Haarlem,FC Volendam,3,0,1,3,0,3,3,3.0,5.0
8724,1988-1989,21,RKC Waalwijk,BVV Den Bosch,0,1,2,0,3,1,-1,5.0,12.0
8725,1988-1989,21,Roda JC Kerkrade,Willem II,2,0,1,3,0,2,2,9.0,5.0
8726,1988-1989,21,Sparta Rotterdam,AFC Ajax,3,2,1,3,0,5,1,10.0,10.0
8727,1988-1989,22,PEC Zwolle '82,Sparta Rotterdam,1,1,3,1,1,2,0,8.0,8.0
8728,1988-1989,22,Fortuna Sittard,MVV Maastricht,1,1,3,1,1,2,0,2.0,8.0
8729,1988-1989,22,BV Veendam,Roda JC Kerkrade,4,4,3,1,1,8,0,1.0,10.0
8730,1988-1989,22,VVV-Venlo,SBV Haarlem,1,1,3,1,1,2,0,3.0,4.0
8731,1988-1989,22,Willem II,RKC Waalwijk,3,0,1,3,0,3,3,8.0,5.0
8732,1988-1989,22,AFC Ajax,FC Twente,1,1,3,1,1,2,0,8.0,6.0
8733,1988-1989,22,BVV Den Bosch,PSV,2,2,3,1,1,4,0,10.0,11.0
8734,1988-1989,22,FC Volendam,FC Groningen,0,1,2,0,3,1,-1,4.0,8.0
8735,1988-1989,22,Feyenoord,FC Utrecht,3,3,3,1,1,6,0,6.0,8.0
8736,1988-1989,23,MVV Maastricht,Feyenoord,1,0,1,3,0,1,1,8.0,6.0
8737,1988-1989,23,PSV,Willem II,7,0,1,3,0,7,7,11.0,7.0
8738,1988-1989,23,FC Groningen,VVV-Venlo,7,3,1,3,0,10,4,8.0,3.0
8739,1988-1989,23,FC Twente,PEC Zwolle '82,3,1,1,3,0,4,2,9.0,5.0
8740,1988-1989,23,FC Utrecht,FC Volendam,2,0,1,3,0,2,2,11.0,4.0
8741,1988-1989,23,SBV Haarlem,BVV Den Bosch,0,0,3,1,1,0,0,5.0,8.0
8742,1988-1989,23,RKC Waalwijk,BV Veendam,0,1,2,0,3,1,-1,2.0,4.0
8743,1988-1989,23,Roda JC Kerkrade,AFC Ajax,0,0,3,1,1,0,0,8.0,6.0
8744,1988-1989,23,Sparta Rotterdam,Fortuna Sittard,1,0,1,3,0,1,1,10.0,2.0
8745,1988-1989,24,PEC Zwolle '82,Roda JC Kerkrade,0,1,2,0,3,1,-1,5.0,11.0
8746,1988-1989,24,Fortuna Sittard,Feyenoord,1,0,1,3,0,1,1,4.0,5.0
8747,1988-1989,24,BV Veendam,PSV,1,2,2,0,3,3,-1,4.0,11.0
8748,1988-1989,24,Willem II,SBV Haarlem,1,1,3,1,1,2,0,5.0,6.0
8749,1988-1989,24,AFC Ajax,RKC Waalwijk,3,2,1,3,0,5,1,6.0,1.0
8750,1988-1989,24,BVV Den Bosch,FC Groningen,1,1,3,1,1,2,0,6.0,8.0
8751,1988-1989,24,FC Volendam,MVV Maastricht,1,2,2,0,3,3,-1,1.0,11.0
8752,1988-1989,24,Sparta Rotterdam,FC Twente,1,1,3,1,1,2,0,11.0,9.0
8753,1988-1989,24,VVV-Venlo,FC Utrecht,2,1,1,3,0,3,1,5.0,8.0
8754,1988-1989,25,MVV Maastricht,VVV-Venlo,2,0,1,3,0,2,2,11.0,4.0
8755,1988-1989,25,FC Groningen,Willem II,5,3,1,3,0,8,2,11.0,4.0
8756,1988-1989,25,FC Twente,Fortuna Sittard,0,0,3,1,1,0,0,9.0,5.0
8757,1988-1989,25,FC Utrecht,BVV Den Bosch,1,2,2,0,3,3,-1,5.0,9.0
8758,1988-1989,25,Feyenoord,FC Volendam,4,0,1,3,0,4,4,5.0,0.0
8759,1988-1989,25,SBV Haarlem,BV Veendam,1,0,1,3,0,1,1,9.0,4.0
8760,1988-1989,25,PSV,AFC Ajax,1,4,2,0,3,5,-3,10.0,8.0
8761,1988-1989,25,RKC Waalwijk,PEC Zwolle '82,1,1,3,1,1,2,0,1.0,5.0
8762,1988-1989,25,Roda JC Kerkrade,Sparta Rotterdam,4,0,1,3,0,4,4,11.0,8.0
8763,1988-1989,26,BVV Den Bosch,MVV Maastricht,3,0,1,3,0,3,3,9.0,10.0
8764,1988-1989,26,FC Twente,Roda JC Kerkrade,0,0,3,1,1,0,0,7.0,9.0
8765,1988-1989,26,PEC Zwolle '82,PSV,0,5,2,0,3,5,-5,2.0,10.0
8766,1988-1989,26,AFC Ajax,SBV Haarlem,5,0,1,3,0,5,5,11.0,6.0
8767,1988-1989,26,Fortuna Sittard,FC Volendam,1,1,3,1,1,2,0,6.0,1.0
8768,1988-1989,26,Sparta Rotterdam,RKC Waalwijk,2,2,3,1,1,4,0,6.0,2.0
8769,1988-1989,26,VVV-Venlo,Feyenoord,1,1,3,1,1,2,0,5.0,5.0
8770,1988-1989,26,Willem II,FC Utrecht,2,0,1,3,0,2,2,7.0,4.0
8771,1988-1989,26,BV Veendam,FC Groningen,0,0,3,1,1,0,0,5.0,11.0
8772,1988-1989,27,MVV Maastricht,Willem II,0,2,2,0,3,2,-2,9.0,7.0
8773,1988-1989,27,PSV,Sparta Rotterdam,0,1,2,0,3,1,-1,9.0,8.0
8774,1988-1989,27,FC Groningen,AFC Ajax,1,4,2,0,3,5,-3,8.0,13.0
8775,1988-1989,27,FC Utrecht,BV Veendam,3,0,1,3,0,3,3,6.0,4.0
8776,1988-1989,27,FC Volendam,VVV-Venlo,1,1,3,1,1,2,0,2.0,5.0
8777,1988-1989,27,Feyenoord,BVV Den Bosch,3,0,1,3,0,3,3,7.0,8.0
8778,1988-1989,27,SBV Haarlem,PEC Zwolle '82,0,0,3,1,1,0,0,6.0,2.0
8779,1988-1989,27,RKC Waalwijk,FC Twente,1,1,3,1,1,2,0,3.0,7.0
8780,1988-1989,27,Roda JC Kerkrade,Fortuna Sittard,1,1,3,1,1,2,0,9.0,6.0
8781,1988-1989,28,PEC Zwolle '82,FC Groningen,1,3,2,0,3,4,-2,2.0,8.0
8782,1988-1989,28,Fortuna Sittard,VVV-Venlo,1,0,1,3,0,1,1,9.0,5.0
8783,1988-1989,28,BV Veendam,MVV Maastricht,4,1,1,3,0,5,3,4.0,6.0
8784,1988-1989,28,AFC Ajax,FC Utrecht,2,0,1,3,0,2,2,15.0,3.0
8785,1988-1989,28,BVV Den Bosch,FC Volendam,0,1,2,0,3,1,-1,7.0,5.0
8786,1988-1989,28,FC Twente,PSV,1,1,3,1,1,2,0,5.0,7.0
8787,1988-1989,28,Roda JC Kerkrade,RKC Waalwijk,3,1,1,3,0,4,2,11.0,3.0
8788,1988-1989,28,Sparta Rotterdam,SBV Haarlem,0,0,3,1,1,0,0,6.0,6.0
8789,1988-1989,28,Willem II,Feyenoord,1,2,2,0,3,3,-1,7.0,10.0
8790,1988-1989,29,Feyenoord,BV Veendam,2,2,3,1,1,4,0,11.0,5.0
8791,1988-1989,29,PSV,Roda JC Kerkrade,4,2,1,3,0,6,2,7.0,8.0
8792,1988-1989,29,VVV-Venlo,BVV Den Bosch,1,0,1,3,0,1,1,5.0,6.0
8793,1988-1989,29,FC Groningen,Sparta Rotterdam,2,1,1,3,0,3,1,10.0,5.0
8794,1988-1989,29,FC Utrecht,PEC Zwolle '82,5,1,1,3,0,6,4,6.0,2.0
8795,1988-1989,29,FC Volendam,Willem II,0,2,2,0,3,2,-2,5.0,9.0
8796,1988-1989,29,SBV Haarlem,FC Twente,2,1,1,3,0,3,1,8.0,4.0
8797,1988-1989,29,RKC Waalwijk,Fortuna Sittard,3,2,1,3,0,5,1,6.0,6.0
8798,1988-1989,29,MVV Maastricht,AFC Ajax,1,1,3,1,1,2,0,4.0,13.0
8799,1988-1989,30,AFC Ajax,Feyenoord,4,1,1,3,0,5,3,13.0,8.0
8800,1988-1989,30,PEC Zwolle '82,MVV Maastricht,3,0,1,3,0,3,3,4.0,1.0
8801,1988-1989,30,Sparta Rotterdam,FC Utrecht,3,0,1,3,0,3,3,8.0,6.0
8802,1988-1989,30,Fortuna Sittard,BVV Den Bosch,0,1,2,0,3,1,-1,5.0,6.0
8803,1988-1989,30,BV Veendam,FC Volendam,0,2,2,0,3,2,-2,5.0,8.0
8804,1988-1989,30,FC Twente,FC Groningen,4,0,1,3,0,4,4,6.0,7.0
8805,1988-1989,30,RKC Waalwijk,PSV,0,0,3,1,1,0,0,6.0,8.0
8806,1988-1989,30,Roda JC Kerkrade,SBV Haarlem,4,1,1,3,0,5,3,8.0,5.0
8807,1988-1989,30,Willem II,VVV-Venlo,5,1,1,3,0,6,4,12.0,5.0
8808,1988-1989,31,MVV Maastricht,Sparta Rotterdam,2,0,1,3,0,2,2,4.0,7.0
8809,1988-1989,31,PSV,Fortuna Sittard,1,0,1,3,0,1,1,8.0,4.0
8810,1988-1989,31,VVV-Venlo,BV Veendam,2,1,1,3,0,3,1,7.0,4.0
8811,1988-1989,31,BVV Den Bosch,Willem II,5,1,1,3,0,6,4,6.0,9.0
8812,1988-1989,31,FC Groningen,Roda JC Kerkrade,1,0,1,3,0,1,1,9.0,7.0
8813,1988-1989,31,FC Utrecht,FC Twente,2,0,1,3,0,2,2,9.0,5.0
8814,1988-1989,31,FC Volendam,AFC Ajax,1,0,1,3,0,1,1,10.0,10.0
8815,1988-1989,31,Feyenoord,PEC Zwolle '82,1,1,3,1,1,2,0,8.0,5.0
8816,1988-1989,31,SBV Haarlem,RKC Waalwijk,1,1,3,1,1,2,0,6.0,6.0
8817,1988-1989,32,Roda JC Kerkrade,FC Utrecht,0,0,3,1,1,0,0,7.0,7.0
8818,1988-1989,32,AFC Ajax,VVV-Venlo,1,0,1,3,0,1,1,10.0,6.0
8819,1988-1989,32,FC Twente,MVV Maastricht,0,0,3,1,1,0,0,5.0,5.0
8820,1988-1989,32,Fortuna Sittard,Willem II,2,2,3,1,1,4,0,4.0,7.0
8821,1988-1989,32,PEC Zwolle '82,FC Volendam,0,0,3,1,1,0,0,5.0,10.0
8822,1988-1989,32,PSV,SBV Haarlem,3,0,1,3,0,3,3,11.0,5.0
8823,1988-1989,32,RKC Waalwijk,FC Groningen,2,1,1,3,0,3,1,8.0,9.0
8824,1988-1989,32,Sparta Rotterdam,Feyenoord,1,3,2,0,3,4,-2,4.0,8.0
8825,1988-1989,32,BV Veendam,BVV Den Bosch,1,3,2,0,3,4,-2,4.0,9.0
8826,1988-1989,33,BVV Den Bosch,AFC Ajax,0,3,2,0,3,3,-3,9.0,10.0
8827,1988-1989,33,FC Groningen,PSV,1,2,2,0,3,3,-1,6.0,13.0
8828,1988-1989,33,FC Utrecht,RKC Waalwijk,1,2,2,0,3,3,-1,7.0,11.0
8829,1988-1989,33,FC Volendam,Sparta Rotterdam,3,1,1,3,0,4,2,10.0,3.0
8830,1988-1989,33,Feyenoord,FC Twente,1,1,3,1,1,2,0,6.0,5.0
8831,1988-1989,33,Fortuna Sittard,SBV Haarlem,1,1,3,1,1,2,0,2.0,5.0
8832,1988-1989,33,MVV Maastricht,Roda JC Kerkrade,2,1,1,3,0,3,1,8.0,4.0
8833,1988-1989,33,VVV-Venlo,PEC Zwolle '82,6,2,1,3,0,8,4,9.0,5.0
8834,1988-1989,33,Willem II,BV Veendam,1,1,3,1,1,2,0,8.0,2.0
8835,1988-1989,34,AFC Ajax,Willem II,1,0,1,3,0,1,1,12.0,5.0
8836,1988-1989,34,FC Twente,FC Volendam,3,0,1,3,0,3,3,8.0,10.0
8837,1988-1989,34,SBV Haarlem,FC Groningen,2,1,1,3,0,3,1,5.0,3.0
8838,1988-1989,34,PEC Zwolle '82,BVV Den Bosch,2,3,2,0,3,5,-1,5.0,12.0
8839,1988-1989,34,PSV,FC Utrecht,3,0,1,3,0,3,3,13.0,4.0
8840,1988-1989,34,RKC Waalwijk,MVV Maastricht,1,0,1,3,0,1,1,11.0,7.0
8841,1988-1989,34,Roda JC Kerkrade,Feyenoord,3,1,1,3,0,4,2,7.0,5.0
8842,1988-1989,34,Sparta Rotterdam,VVV-Venlo,1,1,3,1,1,2,0,4.0,7.0
8843,1988-1989,34,BV Veendam,Fortuna Sittard,1,1,3,1,1,2,0,2.0,3.0
8844,1989-1990,1,FC Twente,Roda JC Kerkrade,1,1,3,1,1,2,0,6.0,5.0
8845,1989-1990,1,MVV Maastricht,Willem II,2,1,1,3,0,3,1,10.0,2.0
8846,1989-1990,1,FC Den Haag,AFC Ajax,0,4,2,0,3,4,-4,3.0,12.0
8847,1989-1990,1,FC Utrecht,Feyenoord,3,0,1,3,0,3,3,7.0,5.0
8848,1989-1990,1,FC Volendam,SBV Haarlem,1,0,1,3,0,1,1,10.0,5.0
8849,1989-1990,1,RKC Waalwijk,FC Groningen,3,1,1,3,0,4,2,13.0,3.0
8850,1989-1990,1,Sparta Rotterdam,NEC Nijmegen,1,2,2,0,3,3,-1,1.0,13.0
8851,1989-1990,1,Vitesse,Fortuna Sittard,1,1,3,1,1,2,0,3.0,4.0
8852,1989-1990,1,PSV,BVV Den Bosch,1,1,3,1,1,2,0,13.0,10.0
8853,1989-1990,2,AFC Ajax,Vitesse,5,2,1,3,0,7,3,15.0,2.0
8854,1989-1990,2,BVV Den Bosch,MVV Maastricht,0,3,2,0,3,3,-3,7.0,10.0
8855,1989-1990,2,Feyenoord,FC Volendam,1,1,3,1,1,2,0,5.0,8.0
8856,1989-1990,2,SBV Haarlem,RKC Waalwijk,0,2,2,0,3,2,-2,4.0,15.0
8857,1989-1990,2,Roda JC Kerkrade,Sparta Rotterdam,1,1,3,1,1,2,0,6.0,2.0
8858,1989-1990,2,Willem II,FC Twente,0,0,3,1,1,0,0,3.0,7.0
8859,1989-1990,2,NEC Nijmegen,FC Den Haag,3,3,3,1,1,6,0,11.0,1.0
8860,1989-1990,2,Fortuna Sittard,FC Utrecht,1,0,1,3,0,1,1,7.0,4.0
8861,1989-1990,2,FC Groningen,PSV,0,0,3,1,1,0,0,1.0,11.0
8862,1989-1990,3,BVV Den Bosch,RKC Waalwijk,1,2,2,0,3,3,-1,4.0,15.0
8863,1989-1990,3,SBV Haarlem,FC Utrecht,1,2,2,0,3,3,-1,4.0,6.0
8864,1989-1990,3,NEC Nijmegen,FC Twente,2,2,3,1,1,4,0,11.0,7.0
8865,1989-1990,3,Roda JC Kerkrade,MVV Maastricht,3,2,1,3,0,5,1,8.0,9.0
8866,1989-1990,3,Willem II,PSV,3,4,2,0,3,7,-1,2.0,11.0
8867,1989-1990,3,AFC Ajax,Sparta Rotterdam,1,2,2,0,3,3,-1,12.0,5.0
8868,1989-1990,3,FC Den Haag,Vitesse,2,1,1,3,0,3,1,4.0,2.0
8869,1989-1990,3,FC Groningen,FC Volendam,3,0,1,3,0,3,3,4.0,7.0
8870,1989-1990,3,Feyenoord,Fortuna Sittard,0,2,2,0,3,2,-2,2.0,9.0
8871,1989-1990,4,FC Utrecht,FC Groningen,1,0,1,3,0,1,1,9.0,4.0
8872,1989-1990,4,FC Volendam,BVV Den Bosch,3,0,1,3,0,3,3,7.0,4.0
8873,1989-1990,4,Fortuna Sittard,SBV Haarlem,1,0,1,3,0,1,1,11.0,3.0
8874,1989-1990,4,MVV Maastricht,NEC Nijmegen,2,0,1,3,0,2,2,9.0,8.0
8875,1989-1990,4,PSV,Roda JC Kerkrade,3,4,2,0,3,7,-1,8.0,11.0
8876,1989-1990,4,RKC Waalwijk,Willem II,2,2,3,1,1,4,0,13.0,2.0
8877,1989-1990,4,FC Twente,AFC Ajax,2,1,1,3,0,3,1,9.0,9.0
8878,1989-1990,4,Vitesse,Feyenoord,2,1,1,3,0,3,1,5.0,1.0
8879,1989-1990,4,Sparta Rotterdam,FC Den Haag,3,1,1,3,0,4,2,8.0,4.0
8880,1989-1990,5,Willem II,FC Volendam,5,1,1,3,0,6,4,5.0,7.0
8881,1989-1990,5,AFC Ajax,MVV Maastricht,5,0,1,3,0,5,5,9.0,9.0
8882,1989-1990,5,BVV Den Bosch,FC Utrecht,2,0,1,3,0,2,2,4.0,9.0
8883,1989-1990,5,FC Den Haag,FC Twente,3,1,1,3,0,4,2,7.0,6.0
8884,1989-1990,5,FC Groningen,Fortuna Sittard,0,0,3,1,1,0,0,5.0,11.0
8885,1989-1990,5,SBV Haarlem,Feyenoord,3,1,1,3,0,4,2,3.0,1.0
8886,1989-1990,5,NEC Nijmegen,PSV,1,4,2,0,3,5,-3,5.0,8.0
8887,1989-1990,5,Roda JC Kerkrade,RKC Waalwijk,3,0,1,3,0,3,3,11.0,10.0
8888,1989-1990,5,Sparta Rotterdam,Vitesse,1,1,3,1,1,2,0,8.0,5.0
8889,1989-1990,6,MVV Maastricht,FC Den Haag,3,0,1,3,0,3,3,9.0,7.0
8890,1989-1990,6,FC Twente,Sparta Rotterdam,2,0,1,3,0,2,2,8.0,8.0
8891,1989-1990,6,Fortuna Sittard,BVV Den Bosch,2,0,1,3,0,2,2,13.0,3.0
8892,1989-1990,6,FC Utrecht,Willem II,2,1,1,3,0,3,1,9.0,5.0
8893,1989-1990,6,FC Volendam,Roda JC Kerkrade,2,0,1,3,0,2,2,7.0,10.0
8894,1989-1990,6,Feyenoord,FC Groningen,3,3,3,1,1,6,0,2.0,6.0
8895,1989-1990,6,PSV,AFC Ajax,2,0,1,3,0,2,2,10.0,6.0
8896,1989-1990,6,RKC Waalwijk,NEC Nijmegen,3,1,1,3,0,4,2,10.0,2.0
8897,1989-1990,6,Vitesse,SBV Haarlem,4,0,1,3,0,4,4,7.0,3.0
8898,1989-1990,7,Roda JC Kerkrade,FC Utrecht,1,0,1,3,0,1,1,12.0,9.0
8899,1989-1990,7,NEC Nijmegen,FC Volendam,2,2,3,1,1,4,0,2.0,7.0
8900,1989-1990,7,Willem II,Fortuna Sittard,2,0,1,3,0,2,2,7.0,10.0
8901,1989-1990,7,AFC Ajax,RKC Waalwijk,0,0,3,1,1,0,0,4.0,8.0
8902,1989-1990,7,FC Den Haag,PSV,1,5,2,0,3,6,-4,6.0,12.0
8903,1989-1990,7,FC Groningen,SBV Haarlem,3,3,3,1,1,6,0,6.0,4.0
8904,1989-1990,7,FC Twente,Vitesse,1,1,3,1,1,2,0,8.0,8.0
8905,1989-1990,7,Sparta Rotterdam,MVV Maastricht,2,2,3,1,1,4,0,8.0,7.0
8906,1989-1990,7,BVV Den Bosch,Feyenoord,1,1,3,1,1,2,0,4.0,2.0
8907,1989-1990,8,Feyenoord,Willem II,4,1,1,3,0,5,3,5.0,7.0
8908,1989-1990,8,SBV Haarlem,BVV Den Bosch,2,0,1,3,0,2,2,7.0,4.0
8909,1989-1990,8,MVV Maastricht,FC Twente,0,0,3,1,1,0,0,8.0,8.0
8910,1989-1990,8,PSV,Sparta Rotterdam,9,1,1,3,0,10,8,12.0,5.0
8911,1989-1990,8,FC Utrecht,NEC Nijmegen,3,0,1,3,0,3,3,9.0,1.0
8912,1989-1990,8,FC Volendam,AFC Ajax,2,2,3,1,1,4,0,8.0,5.0
8913,1989-1990,8,Fortuna Sittard,Roda JC Kerkrade,1,1,3,1,1,2,0,8.0,10.0
8914,1989-1990,8,RKC Waalwijk,FC Den Haag,3,2,1,3,0,5,1,8.0,3.0
8915,1989-1990,8,Vitesse,FC Groningen,0,1,2,0,3,1,-1,8.0,6.0
8916,1989-1990,9,BVV Den Bosch,FC Groningen,0,0,3,1,1,0,0,5.0,7.0
8917,1989-1990,9,MVV Maastricht,Vitesse,1,5,2,0,3,6,-4,5.0,8.0
8918,1989-1990,9,AFC Ajax,FC Utrecht,3,0,1,3,0,3,3,8.0,6.0
8919,1989-1990,9,FC Den Haag,FC Volendam,2,1,1,3,0,3,1,6.0,5.0
8920,1989-1990,9,FC Twente,PSV,0,0,3,1,1,0,0,6.0,13.0
8921,1989-1990,9,NEC Nijmegen,Fortuna Sittard,1,0,1,3,0,1,1,4.0,5.0
8922,1989-1990,9,Sparta Rotterdam,RKC Waalwijk,2,1,1,3,0,3,1,5.0,7.0
8923,1989-1990,9,Roda JC Kerkrade,Feyenoord,2,0,1,3,0,2,2,10.0,5.0
8924,1989-1990,9,Willem II,SBV Haarlem,3,2,1,3,0,5,1,9.0,7.0
8925,1989-1990,10,FC Groningen,Willem II,1,1,3,1,1,2,0,7.0,7.0
8926,1989-1990,10,SBV Haarlem,Roda JC Kerkrade,0,0,3,1,1,0,0,5.0,8.0
8927,1989-1990,10,PSV,MVV Maastricht,8,1,1,3,0,9,7,13.0,5.0
8928,1989-1990,10,FC Utrecht,FC Den Haag,2,1,1,3,0,3,1,9.0,3.0
8929,1989-1990,10,FC Volendam,Sparta Rotterdam,2,0,1,3,0,2,2,8.0,4.0
8930,1989-1990,10,Feyenoord,NEC Nijmegen,2,1,1,3,0,3,1,8.0,4.0
8931,1989-1990,10,Fortuna Sittard,AFC Ajax,0,0,3,1,1,0,0,5.0,6.0
8932,1989-1990,10,RKC Waalwijk,FC Twente,0,0,3,1,1,0,0,8.0,7.0
8933,1989-1990,10,Vitesse,BVV Den Bosch,0,0,3,1,1,0,0,8.0,3.0
8934,1989-1990,11,MVV Maastricht,RKC Waalwijk,3,0,1,3,0,3,3,5.0,5.0
8935,1989-1990,11,NEC Nijmegen,SBV Haarlem,3,1,1,3,0,4,2,7.0,5.0
8936,1989-1990,11,PSV,Vitesse,0,1,2,0,3,1,-1,10.0,8.0
8937,1989-1990,11,Willem II,BVV Den Bosch,1,0,1,3,0,1,1,10.0,3.0
8938,1989-1990,11,AFC Ajax,Feyenoord,1,1,3,1,1,2,0,7.0,8.0
8939,1989-1990,11,FC Den Haag,Fortuna Sittard,4,1,1,3,0,5,3,6.0,2.0
8940,1989-1990,11,FC Twente,FC Volendam,1,0,1,3,0,1,1,7.0,5.0
8941,1989-1990,11,Roda JC Kerkrade,FC Groningen,1,1,3,1,1,2,0,9.0,7.0
8942,1989-1990,11,Sparta Rotterdam,FC Utrecht,0,1,2,0,3,1,-1,4.0,9.0
8943,1989-1990,12,BVV Den Bosch,Roda JC Kerkrade,1,1,3,1,1,2,0,3.0,7.0
8944,1989-1990,12,FC Groningen,NEC Nijmegen,1,1,3,1,1,2,0,7.0,7.0
8945,1989-1990,12,Fortuna Sittard,Sparta Rotterdam,2,1,1,3,0,3,1,5.0,3.0
8946,1989-1990,12,FC Utrecht,FC Twente,1,2,2,0,3,3,-1,9.0,9.0
8947,1989-1990,12,FC Volendam,MVV Maastricht,4,1,1,3,0,5,3,7.0,4.0
8948,1989-1990,12,SBV Haarlem,AFC Ajax,0,4,2,0,3,4,-4,4.0,9.0
8949,1989-1990,12,RKC Waalwijk,PSV,0,3,2,0,3,3,-3,4.0,10.0
8950,1989-1990,12,Vitesse,Willem II,2,0,1,3,0,2,2,10.0,7.0
8951,1989-1990,12,Feyenoord,FC Den Haag,0,2,2,0,3,2,-2,7.0,9.0
8952,1989-1990,13,NEC Nijmegen,BVV Den Bosch,2,2,3,1,1,4,0,8.0,4.0
8953,1989-1990,13,PSV,FC Volendam,2,2,3,1,1,4,0,8.0,7.0
8954,1989-1990,13,AFC Ajax,FC Groningen,3,2,1,3,0,5,1,11.0,4.0
8955,1989-1990,13,FC Den Haag,SBV Haarlem,6,1,1,3,0,7,5,12.0,1.0
8956,1989-1990,13,FC Twente,Fortuna Sittard,1,1,3,1,1,2,0,9.0,5.0
8957,1989-1990,13,RKC Waalwijk,Vitesse,0,1,2,0,3,1,-1,1.0,13.0
8958,1989-1990,13,Roda JC Kerkrade,Willem II,4,1,1,3,0,5,3,9.0,7.0
8959,1989-1990,13,Sparta Rotterdam,Feyenoord,2,2,3,1,1,4,0,4.0,5.0
8960,1989-1990,13,MVV Maastricht,FC Utrecht,0,0,3,1,1,0,0,4.0,7.0
8961,1989-1990,14,SBV Haarlem,Sparta Rotterdam,0,4,2,0,3,4,-4,1.0,4.0
8962,1989-1990,14,Willem II,NEC Nijmegen,0,1,2,0,3,1,-1,4.0,8.0
8963,1989-1990,14,BVV Den Bosch,AFC Ajax,0,1,2,0,3,1,-1,3.0,11.0
8964,1989-1990,14,FC Groningen,FC Den Haag,2,1,1,3,0,3,1,6.0,9.0
8965,1989-1990,14,FC Utrecht,PSV,1,7,2,0,3,8,-6,7.0,10.0
8966,1989-1990,14,FC Volendam,RKC Waalwijk,1,0,1,3,0,1,1,10.0,1.0
8967,1989-1990,14,Feyenoord,FC Twente,2,3,2,0,3,5,-1,5.0,11.0
8968,1989-1990,14,Fortuna Sittard,MVV Maastricht,1,1,3,1,1,2,0,6.0,5.0
8969,1989-1990,14,Vitesse,Roda JC Kerkrade,2,0,1,3,0,2,2,13.0,6.0
8970,1989-1990,15,MVV Maastricht,Feyenoord,1,1,3,1,1,2,0,6.0,3.0
8971,1989-1990,15,NEC Nijmegen,Roda JC Kerkrade,0,1,2,0,3,1,-1,8.0,8.0
8972,1989-1990,15,PSV,Fortuna Sittard,2,0,1,3,0,2,2,10.0,5.0
8973,1989-1990,15,AFC Ajax,Willem II,1,0,1,3,0,1,1,13.0,3.0
8974,1989-1990,15,FC Den Haag,BVV Den Bosch,3,1,1,3,0,4,2,12.0,2.0
8975,1989-1990,15,FC Twente,SBV Haarlem,2,2,3,1,1,4,0,11.0,1.0
8976,1989-1990,15,FC Volendam,Vitesse,1,0,1,3,0,1,1,10.0,12.0
8977,1989-1990,15,RKC Waalwijk,FC Utrecht,3,3,3,1,1,6,0,1.0,5.0
8978,1989-1990,15,Sparta Rotterdam,FC Groningen,3,0,1,3,0,3,3,7.0,5.0
8979,1989-1990,16,Roda JC Kerkrade,AFC Ajax,1,1,3,1,1,2,0,8.0,13.0
8980,1989-1990,16,BVV Den Bosch,Sparta Rotterdam,3,0,1,3,0,3,3,5.0,7.0
8981,1989-1990,16,Fortuna Sittard,RKC Waalwijk,1,1,3,1,1,2,0,6.0,2.0
8982,1989-1990,16,SBV Haarlem,MVV Maastricht,1,1,3,1,1,2,0,2.0,4.0
8983,1989-1990,16,FC Utrecht,FC Volendam,0,3,2,0,3,3,-3,2.0,13.0
8984,1989-1990,16,Feyenoord,PSV,4,0,1,3,0,4,4,5.0,10.0
8985,1989-1990,16,NEC Nijmegen,Vitesse,0,4,2,0,3,4,-4,5.0,12.0
8986,1989-1990,16,Willem II,FC Den Haag,1,1,3,1,1,2,0,1.0,10.0
8987,1989-1990,16,FC Groningen,FC Twente,5,0,1,3,0,5,5,7.0,8.0
8988,1989-1990,17,MVV Maastricht,FC Groningen,1,3,2,0,3,4,-2,4.0,9.0
8989,1989-1990,17,PSV,SBV Haarlem,4,0,1,3,0,4,4,10.0,2.0
8990,1989-1990,17,AFC Ajax,NEC Nijmegen,3,0,1,3,0,3,3,13.0,4.0
8991,1989-1990,17,FC Den Haag,Roda JC Kerkrade,1,3,2,0,3,4,-2,7.0,10.0
8992,1989-1990,17,FC Twente,BVV Den Bosch,4,1,1,3,0,5,3,8.0,4.0
8993,1989-1990,17,FC Volendam,Fortuna Sittard,2,2,3,1,1,4,0,11.0,4.0
8994,1989-1990,17,RKC Waalwijk,Feyenoord,3,0,1,3,0,3,3,5.0,5.0
8995,1989-1990,17,Sparta Rotterdam,Willem II,1,1,3,1,1,2,0,8.0,2.0
8996,1989-1990,17,Vitesse,FC Utrecht,5,1,1,3,0,6,4,12.0,2.0
8997,1989-1990,18,Fortuna Sittard,Vitesse,0,0,3,1,1,0,0,4.0,10.0
8998,1989-1990,18,SBV Haarlem,FC Volendam,2,1,1,3,0,3,1,5.0,10.0
8999,1989-1990,18,NEC Nijmegen,Sparta Rotterdam,1,2,2,0,3,3,-1,3.0,10.0
9000,1989-1990,18,Willem II,MVV Maastricht,1,1,3,1,1,2,0,3.0,4.0
9001,1989-1990,18,BVV Den Bosch,PSV,1,1,3,1,1,2,0,4.0,10.0
9002,1989-1990,18,FC Groningen,RKC Waalwijk,1,2,2,0,3,3,-1,9.0,8.0
9003,1989-1990,18,Feyenoord,FC Utrecht,0,0,3,1,1,0,0,5.0,2.0
9004,1989-1990,18,Roda JC Kerkrade,FC Twente,2,0,1,3,0,2,2,10.0,7.0
9005,1989-1990,18,AFC Ajax,FC Den Haag,1,0,1,3,0,1,1,13.0,4.0
9006,1989-1990,19,FC Volendam,Feyenoord,2,0,1,3,0,2,2,10.0,5.0
9007,1989-1990,19,Vitesse,AFC Ajax,1,1,3,1,1,2,0,8.0,11.0
9008,1989-1990,19,FC Twente,Willem II,2,0,1,3,0,2,2,7.0,3.0
9009,1989-1990,19,MVV Maastricht,BVV Den Bosch,3,0,1,3,0,3,3,6.0,4.0
9010,1989-1990,19,PSV,FC Groningen,2,0,1,3,0,2,2,10.0,6.0
9011,1989-1990,19,FC Den Haag,NEC Nijmegen,2,2,3,1,1,4,0,5.0,1.0
9012,1989-1990,19,FC Utrecht,Fortuna Sittard,0,1,2,0,3,1,-1,2.0,6.0
9013,1989-1990,19,RKC Waalwijk,SBV Haarlem,1,0,1,3,0,1,1,11.0,5.0
9014,1989-1990,19,Sparta Rotterdam,Roda JC Kerkrade,3,1,1,3,0,4,2,10.0,10.0
9015,1989-1990,20,MVV Maastricht,Roda JC Kerkrade,1,1,3,1,1,2,0,6.0,8.0
9016,1989-1990,20,PSV,Willem II,2,1,1,3,0,3,1,10.0,3.0
9017,1989-1990,20,FC Twente,NEC Nijmegen,2,1,1,3,0,3,1,9.0,1.0
9018,1989-1990,20,FC Utrecht,SBV Haarlem,0,0,3,1,1,0,0,2.0,5.0
9019,1989-1990,20,RKC Waalwijk,BVV Den Bosch,1,1,3,1,1,2,0,11.0,5.0
9020,1989-1990,20,Vitesse,FC Den Haag,1,1,3,1,1,2,0,9.0,3.0
9021,1989-1990,20,Fortuna Sittard,Feyenoord,1,1,3,1,1,2,0,7.0,5.0
9022,1989-1990,20,FC Volendam,FC Groningen,1,2,2,0,3,3,-1,7.0,9.0
9023,1989-1990,20,Sparta Rotterdam,AFC Ajax,1,2,2,0,3,3,-1,7.0,11.0
9024,1989-1990,21,BVV Den Bosch,FC Volendam,0,0,3,1,1,0,0,3.0,5.0
9025,1989-1990,21,NEC Nijmegen,MVV Maastricht,0,0,3,1,1,0,0,2.0,6.0
9026,1989-1990,21,Roda JC Kerkrade,PSV,3,1,1,3,0,4,2,10.0,10.0
9027,1989-1990,21,Willem II,RKC Waalwijk,0,2,2,0,3,2,-2,2.0,13.0
9028,1989-1990,21,AFC Ajax,FC Twente,4,0,1,3,0,4,4,13.0,9.0
9029,1989-1990,21,FC Den Haag,Sparta Rotterdam,1,0,1,3,0,1,1,5.0,7.0
9030,1989-1990,21,FC Groningen,FC Utrecht,2,0,1,3,0,2,2,9.0,2.0
9031,1989-1990,21,Feyenoord,Vitesse,0,0,3,1,1,0,0,3.0,7.0
9032,1989-1990,21,SBV Haarlem,Fortuna Sittard,0,3,2,0,3,3,-3,4.0,9.0
9033,1989-1990,22,MVV Maastricht,AFC Ajax,1,0,1,3,0,1,1,9.0,10.0
9034,1989-1990,22,Fortuna Sittard,FC Groningen,0,0,3,1,1,0,0,9.0,7.0
9035,1989-1990,22,PSV,NEC Nijmegen,6,0,1,3,0,6,6,10.0,2.0
9036,1989-1990,22,RKC Waalwijk,Roda JC Kerkrade,3,1,1,3,0,4,2,13.0,7.0
9037,1989-1990,22,FC Twente,FC Den Haag,1,0,1,3,0,1,1,9.0,5.0
9038,1989-1990,22,FC Volendam,Willem II,2,1,1,3,0,3,1,7.0,1.0
9039,1989-1990,22,Feyenoord,SBV Haarlem,5,0,1,3,0,5,5,6.0,4.0
9040,1989-1990,22,Vitesse,Sparta Rotterdam,2,1,1,3,0,3,1,7.0,6.0
9041,1989-1990,22,FC Utrecht,BVV Den Bosch,1,1,3,1,1,2,0,3.0,4.0
9042,1989-1990,23,BVV Den Bosch,Fortuna Sittard,1,1,3,1,1,2,0,4.0,9.0
9043,1989-1990,23,SBV Haarlem,Vitesse,0,2,2,0,3,2,-2,1.0,9.0
9044,1989-1990,23,NEC Nijmegen,RKC Waalwijk,2,1,1,3,0,3,1,5.0,10.0
9045,1989-1990,23,Willem II,FC Utrecht,0,0,3,1,1,0,0,1.0,3.0
9046,1989-1990,23,AFC Ajax,PSV,3,2,1,3,0,5,1,10.0,9.0
9047,1989-1990,23,FC Den Haag,MVV Maastricht,6,1,1,3,0,7,5,8.0,8.0
9048,1989-1990,23,FC Groningen,Feyenoord,3,3,3,1,1,6,0,8.0,6.0
9049,1989-1990,23,Roda JC Kerkrade,FC Volendam,2,1,1,3,0,3,1,7.0,7.0
9050,1989-1990,23,Sparta Rotterdam,FC Twente,3,0,1,3,0,3,3,6.0,9.0
9051,1989-1990,24,FC Volendam,NEC Nijmegen,1,0,1,3,0,1,1,7.0,4.0
9052,1989-1990,24,Fortuna Sittard,Willem II,3,0,1,3,0,3,3,9.0,1.0
9053,1989-1990,24,SBV Haarlem,FC Groningen,0,1,2,0,3,1,-1,1.0,11.0
9054,1989-1990,24,MVV Maastricht,Sparta Rotterdam,1,2,2,0,3,3,-1,5.0,6.0
9055,1989-1990,24,Vitesse,FC Twente,1,2,2,0,3,3,-1,8.0,9.0
9056,1989-1990,24,FC Utrecht,Roda JC Kerkrade,0,1,2,0,3,1,-1,3.0,10.0
9057,1989-1990,24,Feyenoord,BVV Den Bosch,2,0,1,3,0,2,2,9.0,4.0
9058,1989-1990,24,PSV,FC Den Haag,9,2,1,3,0,11,7,9.0,7.0
9059,1989-1990,24,RKC Waalwijk,AFC Ajax,0,3,2,0,3,3,-3,7.0,12.0
9060,1989-1990,25,BVV Den Bosch,SBV Haarlem,1,0,1,3,0,1,1,6.0,0.0
9061,1989-1990,25,NEC Nijmegen,FC Utrecht,0,0,3,1,1,0,0,5.0,3.0
9062,1989-1990,25,Roda JC Kerkrade,Fortuna Sittard,0,1,2,0,3,1,-1,9.0,11.0
9063,1989-1990,25,Willem II,Feyenoord,0,1,2,0,3,1,-1,1.0,11.0
9064,1989-1990,25,AFC Ajax,FC Volendam,0,0,3,1,1,0,0,10.0,8.0
9065,1989-1990,25,FC Den Haag,RKC Waalwijk,1,1,3,1,1,2,0,7.0,7.0
9066,1989-1990,25,FC Groningen,Vitesse,3,1,1,3,0,4,2,11.0,7.0
9067,1989-1990,25,FC Twente,MVV Maastricht,3,0,1,3,0,3,3,9.0,4.0
9068,1989-1990,25,Sparta Rotterdam,PSV,0,4,2,0,3,4,-4,6.0,9.0
9069,1989-1990,26,Fortuna Sittard,NEC Nijmegen,1,1,3,1,1,2,0,9.0,5.0
9070,1989-1990,26,SBV Haarlem,Willem II,0,2,2,0,3,2,-2,0.0,4.0
9071,1989-1990,26,PSV,FC Twente,1,1,3,1,1,2,0,10.0,10.0
9072,1989-1990,26,FC Groningen,BVV Den Bosch,0,0,3,1,1,0,0,9.0,6.0
9073,1989-1990,26,FC Utrecht,AFC Ajax,0,0,3,1,1,0,0,4.0,8.0
9074,1989-1990,26,FC Volendam,FC Den Haag,0,2,2,0,3,2,-2,7.0,7.0
9075,1989-1990,26,Feyenoord,Roda JC Kerkrade,2,2,3,1,1,4,0,11.0,7.0
9076,1989-1990,26,RKC Waalwijk,Sparta Rotterdam,3,0,1,3,0,3,3,7.0,6.0
9077,1989-1990,26,Vitesse,MVV Maastricht,2,1,1,3,0,3,1,9.0,3.0
9078,1989-1990,27,FC Twente,RKC Waalwijk,0,1,2,0,3,1,-1,7.0,7.0
9079,1989-1990,27,MVV Maastricht,PSV,0,1,2,0,3,1,-1,0.0,10.0
9080,1989-1990,27,Roda JC Kerkrade,SBV Haarlem,5,0,1,3,0,5,5,10.0,0.0
9081,1989-1990,27,Willem II,FC Groningen,3,0,1,3,0,3,3,7.0,8.0
9082,1989-1990,27,AFC Ajax,Fortuna Sittard,1,0,1,3,0,1,1,11.0,8.0
9083,1989-1990,27,BVV Den Bosch,Vitesse,1,2,2,0,3,3,-1,5.0,9.0
9084,1989-1990,27,FC Den Haag,FC Utrecht,1,1,3,1,1,2,0,8.0,4.0
9085,1989-1990,27,NEC Nijmegen,Feyenoord,0,0,3,1,1,0,0,6.0,9.0
9086,1989-1990,27,Sparta Rotterdam,FC Volendam,2,0,1,3,0,2,2,9.0,4.0
9087,1989-1990,28,Fortuna Sittard,FC Den Haag,2,1,1,3,0,3,1,10.0,5.0
9088,1989-1990,28,BVV Den Bosch,Willem II,1,1,3,1,1,2,0,5.0,7.0
9089,1989-1990,28,FC Groningen,Roda JC Kerkrade,1,1,3,1,1,2,0,8.0,8.0
9090,1989-1990,28,SBV Haarlem,NEC Nijmegen,1,1,3,1,1,2,0,1.0,4.0
9091,1989-1990,28,FC Utrecht,Sparta Rotterdam,2,1,1,3,0,3,1,6.0,6.0
9092,1989-1990,28,FC Volendam,FC Twente,2,1,1,3,0,3,1,7.0,7.0
9093,1989-1990,28,Feyenoord,AFC Ajax,0,1,2,0,3,1,-1,8.0,11.0
9094,1989-1990,28,RKC Waalwijk,MVV Maastricht,1,1,3,1,1,2,0,8.0,1.0
9095,1989-1990,28,Vitesse,PSV,0,2,2,0,3,2,-2,6.0,13.0
9096,1989-1990,29,AFC Ajax,SBV Haarlem,5,0,1,3,0,5,5,11.0,1.0
9097,1989-1990,29,NEC Nijmegen,FC Groningen,1,1,3,1,1,2,0,5.0,6.0
9098,1989-1990,29,Willem II,Vitesse,1,1,3,1,1,2,0,8.0,7.0
9099,1989-1990,29,FC Den Haag,Feyenoord,2,0,1,3,0,2,2,8.0,5.0
9100,1989-1990,29,FC Twente,FC Utrecht,3,1,1,3,0,4,2,7.0,6.0
9101,1989-1990,29,Roda JC Kerkrade,BVV Den Bosch,0,3,2,0,3,3,-3,5.0,8.0
9102,1989-1990,29,Sparta Rotterdam,Fortuna Sittard,4,1,1,3,0,5,3,6.0,7.0
9103,1989-1990,29,MVV Maastricht,FC Volendam,0,1,2,0,3,1,-1,1.0,7.0
9104,1989-1990,29,PSV,RKC Waalwijk,4,0,1,3,0,4,4,13.0,8.0
9105,1989-1990,30,FC Groningen,AFC Ajax,0,1,2,0,3,1,-1,3.0,13.0
9106,1989-1990,30,FC Volendam,PSV,0,0,3,1,1,0,0,7.0,11.0
9107,1989-1990,30,BVV Den Bosch,NEC Nijmegen,1,0,1,3,0,1,1,8.0,4.0
9108,1989-1990,30,FC Utrecht,MVV Maastricht,0,0,3,1,1,0,0,6.0,2.0
9109,1989-1990,30,Feyenoord,Sparta Rotterdam,6,1,1,3,0,7,5,5.0,6.0
9110,1989-1990,30,Fortuna Sittard,FC Twente,2,3,2,0,3,5,-1,4.0,7.0
9111,1989-1990,30,Vitesse,RKC Waalwijk,1,1,3,1,1,2,0,8.0,8.0
9112,1989-1990,30,Willem II,Roda JC Kerkrade,2,2,3,1,1,4,0,9.0,6.0
9113,1989-1990,30,SBV Haarlem,FC Den Haag,1,2,2,0,3,3,-1,1.0,10.0
9114,1989-1990,31,AFC Ajax,BVV Den Bosch,6,0,1,3,0,6,6,15.0,7.0
9115,1989-1990,31,FC Den Haag,FC Groningen,2,2,3,1,1,4,0,8.0,3.0
9116,1989-1990,31,FC Twente,Feyenoord,1,0,1,3,0,1,1,9.0,4.0
9117,1989-1990,31,MVV Maastricht,Fortuna Sittard,1,1,3,1,1,2,0,3.0,4.0
9118,1989-1990,31,NEC Nijmegen,Willem II,2,2,3,1,1,4,0,4.0,7.0
9119,1989-1990,31,PSV,FC Utrecht,1,0,1,3,0,1,1,13.0,5.0
9120,1989-1990,31,Roda JC Kerkrade,Vitesse,0,1,2,0,3,1,-1,5.0,8.0
9121,1989-1990,31,Sparta Rotterdam,SBV Haarlem,0,1,2,0,3,1,-1,6.0,4.0
9122,1989-1990,31,RKC Waalwijk,FC Volendam,1,1,3,1,1,2,0,6.0,8.0
9123,1989-1990,32,FC Groningen,Sparta Rotterdam,2,2,3,1,1,4,0,4.0,4.0
9124,1989-1990,32,Feyenoord,MVV Maastricht,2,0,1,3,0,2,2,6.0,3.0
9125,1989-1990,32,Fortuna Sittard,PSV,4,1,1,3,0,5,3,7.0,10.0
9126,1989-1990,32,SBV Haarlem,FC Twente,0,1,2,0,3,1,-1,4.0,12.0
9127,1989-1990,32,Roda JC Kerkrade,NEC Nijmegen,0,0,3,1,1,0,0,3.0,4.0
9128,1989-1990,32,BVV Den Bosch,FC Den Haag,0,1,2,0,3,1,-1,7.0,10.0
9129,1989-1990,32,FC Utrecht,RKC Waalwijk,1,1,3,1,1,2,0,5.0,4.0
9130,1989-1990,32,Vitesse,FC Volendam,0,1,2,0,3,1,-1,5.0,11.0
9131,1989-1990,32,Willem II,AFC Ajax,1,1,3,1,1,2,0,5.0,13.0
9132,1989-1990,33,AFC Ajax,Roda JC Kerkrade,2,2,3,1,1,4,0,11.0,3.0
9133,1989-1990,33,FC Den Haag,Willem II,0,3,2,0,3,3,-3,10.0,7.0
9134,1989-1990,33,FC Twente,FC Groningen,4,1,1,3,0,5,3,15.0,3.0
9135,1989-1990,33,MVV Maastricht,SBV Haarlem,1,1,3,1,1,2,0,3.0,4.0
9136,1989-1990,33,PSV,Feyenoord,1,1,3,1,1,2,0,8.0,7.0
9137,1989-1990,33,RKC Waalwijk,Fortuna Sittard,3,1,1,3,0,4,2,6.0,4.0
9138,1989-1990,33,Sparta Rotterdam,BVV Den Bosch,4,2,1,3,0,6,2,7.0,6.0
9139,1989-1990,33,Vitesse,NEC Nijmegen,0,0,3,1,1,0,0,6.0,4.0
9140,1989-1990,33,FC Volendam,FC Utrecht,1,0,1,3,0,1,1,11.0,2.0
9141,1989-1990,34,BVV Den Bosch,FC Twente,4,2,1,3,0,6,2,6.0,12.0
9142,1989-1990,34,FC Groningen,MVV Maastricht,5,2,1,3,0,7,3,5.0,3.0
9143,1989-1990,34,FC Utrecht,Vitesse,1,2,2,0,3,3,-1,2.0,8.0
9144,1989-1990,34,Feyenoord,RKC Waalwijk,5,0,1,3,0,5,5,10.0,6.0
9145,1989-1990,34,Fortuna Sittard,FC Volendam,4,1,1,3,0,5,3,7.0,8.0
9146,1989-1990,34,SBV Haarlem,PSV,0,2,2,0,3,2,-2,4.0,8.0
9147,1989-1990,34,NEC Nijmegen,AFC Ajax,1,1,3,1,1,2,0,4.0,9.0
9148,1989-1990,34,Roda JC Kerkrade,FC Den Haag,3,1,1,3,0,4,2,6.0,7.0
9149,1989-1990,34,Willem II,Sparta Rotterdam,1,1,3,1,1,2,0,7.0,5.0
9150,1990-1991,1,Roda JC Kerkrade,FC Twente,1,2,2,0,3,3,-1,5.0,12.0
9151,1990-1991,1,MVV Maastricht,NEC Nijmegen,1,2,2,0,3,3,-1,2.0,7.0
9152,1990-1991,1,sc Heerenveen,FC Volendam,1,3,2,0,3,4,-2,,10.0
9153,1990-1991,1,AFC Ajax,Willem II,3,1,1,3,0,4,2,9.0,6.0
9154,1990-1991,1,FC Den Haag,Fortuna Sittard,0,0,3,1,1,0,0,5.0,8.0
9155,1990-1991,1,RKC Waalwijk,FC Groningen,1,1,3,1,1,2,0,6.0,6.0
9156,1990-1991,1,Sparta Rotterdam,Vitesse,1,1,3,1,1,2,0,6.0,8.0
9157,1990-1991,1,PSV,FC Utrecht,5,0,1,3,0,5,5,10.0,1.0
9158,1990-1991,1,SVV Schiedam,Feyenoord,0,0,3,1,1,0,0,7.0,8.0
9159,1990-1991,2,FC Twente,FC Den Haag,2,1,1,3,0,3,1,12.0,4.0
9160,1990-1991,2,Fortuna Sittard,AFC Ajax,1,1,3,1,1,2,0,8.0,7.0
9161,1990-1991,2,NEC Nijmegen,PSV,1,1,3,1,1,2,0,7.0,8.0
9162,1990-1991,2,Willem II,Sparta Rotterdam,6,1,1,3,0,7,5,8.0,6.0
9163,1990-1991,2,FC Groningen,Roda JC Kerkrade,3,1,1,3,0,4,2,8.0,5.0
9164,1990-1991,2,FC Utrecht,sc Heerenveen,1,2,2,0,3,3,-1,1.0,
9165,1990-1991,2,FC Volendam,RKC Waalwijk,2,0,1,3,0,2,2,12.0,5.0
9166,1990-1991,2,Feyenoord,MVV Maastricht,6,0,1,3,0,6,6,11.0,1.0
9167,1990-1991,2,Vitesse,SVV Schiedam,3,0,1,3,0,3,3,8.0,7.0
9168,1990-1991,3,Roda JC Kerkrade,FC Volendam,2,1,1,3,0,3,1,7.0,9.0
9169,1990-1991,3,PSV,MVV Maastricht,3,0,1,3,0,3,3,11.0,1.0
9170,1990-1991,3,sc Heerenveen,NEC Nijmegen,1,1,3,1,1,2,0,,7.0
9171,1990-1991,3,AFC Ajax,FC Twente,1,1,3,1,1,2,0,7.0,10.0
9172,1990-1991,3,FC Den Haag,FC Groningen,1,2,2,0,3,3,-1,1.0,10.0
9173,1990-1991,3,RKC Waalwijk,FC Utrecht,1,0,1,3,0,1,1,7.0,0.0
9174,1990-1991,3,Sparta Rotterdam,Fortuna Sittard,2,2,3,1,1,4,0,6.0,6.0
9175,1990-1991,3,SVV Schiedam,Willem II,0,0,3,1,1,0,0,5.0,8.0
9176,1990-1991,3,Vitesse,Feyenoord,0,0,3,1,1,0,0,9.0,9.0
9177,1990-1991,4,FC Twente,Sparta Rotterdam,0,1,2,0,3,1,-1,7.0,6.0
9178,1990-1991,4,FC Utrecht,Roda JC Kerkrade,2,1,1,3,0,3,1,3.0,6.0
9179,1990-1991,4,Fortuna Sittard,SVV Schiedam,1,0,1,3,0,1,1,9.0,5.0
9180,1990-1991,4,MVV Maastricht,sc Heerenveen,2,0,1,3,0,2,2,3.0,
9181,1990-1991,4,NEC Nijmegen,RKC Waalwijk,0,0,3,1,1,0,0,7.0,5.0
9182,1990-1991,4,Willem II,Vitesse,0,0,3,1,1,0,0,6.0,9.0
9183,1990-1991,4,FC Groningen,AFC Ajax,1,2,2,0,3,3,-1,10.0,9.0
9184,1990-1991,4,Feyenoord,PSV,1,1,3,1,1,2,0,9.0,11.0
9185,1990-1991,4,FC Volendam,FC Den Haag,0,2,2,0,3,2,-2,6.0,4.0
9186,1990-1991,5,Roda JC Kerkrade,NEC Nijmegen,2,2,3,1,1,4,0,4.0,7.0
9187,1990-1991,5,SVV Schiedam,FC Twente,1,1,3,1,1,2,0,3.0,8.0
9188,1990-1991,5,AFC Ajax,FC Volendam,3,1,1,3,0,4,2,11.0,6.0
9189,1990-1991,5,FC Den Haag,FC Utrecht,3,1,1,3,0,4,2,7.0,3.0
9190,1990-1991,5,RKC Waalwijk,MVV Maastricht,3,2,1,3,0,5,1,8.0,3.0
9191,1990-1991,5,sc Heerenveen,PSV,0,3,2,0,3,3,-3,4.0,11.0
9192,1990-1991,5,Sparta Rotterdam,FC Groningen,1,1,3,1,1,2,0,6.0,8.0
9193,1990-1991,5,Vitesse,Fortuna Sittard,2,3,2,0,3,5,-1,6.0,9.0
9194,1990-1991,5,Willem II,Feyenoord,3,2,1,3,0,5,1,8.0,6.0
9195,1990-1991,6,FC Twente,Fortuna Sittard,1,0,1,3,0,1,1,8.0,8.0
9196,1990-1991,6,NEC Nijmegen,Sparta Rotterdam,3,1,1,3,0,4,2,7.0,5.0
9197,1990-1991,6,sc Heerenveen,Roda JC Kerkrade,1,2,2,0,3,3,-1,4.0,7.0
9198,1990-1991,6,FC Groningen,Willem II,4,1,1,3,0,5,3,10.0,8.0
9199,1990-1991,6,FC Utrecht,SVV Schiedam,1,0,1,3,0,1,1,6.0,2.0
9200,1990-1991,6,Feyenoord,RKC Waalwijk,3,0,1,3,0,3,3,8.0,7.0
9201,1990-1991,6,MVV Maastricht,AFC Ajax,1,4,2,0,3,5,-3,3.0,11.0
9202,1990-1991,6,PSV,FC Den Haag,4,0,1,3,0,4,4,11.0,6.0
9203,1990-1991,6,FC Volendam,Vitesse,2,1,1,3,0,3,1,6.0,5.0
9204,1990-1991,7,Fortuna Sittard,Feyenoord,3,2,1,3,0,5,1,10.0,5.0
9205,1990-1991,7,SVV Schiedam,FC Volendam,1,0,1,3,0,1,1,5.0,3.0
9206,1990-1991,7,Willem II,FC Twente,2,1,1,3,0,3,1,8.0,5.0
9207,1990-1991,7,AFC Ajax,NEC Nijmegen,7,0,1,3,0,7,7,13.0,6.0
9208,1990-1991,7,FC Den Haag,MVV Maastricht,5,1,1,3,0,6,4,9.0,3.0
9209,1990-1991,7,RKC Waalwijk,sc Heerenveen,5,2,1,3,0,7,3,10.0,1.0
9210,1990-1991,7,Sparta Rotterdam,FC Utrecht,4,1,1,3,0,5,3,8.0,6.0
9211,1990-1991,7,Vitesse,FC Groningen,1,2,2,0,3,3,-1,2.0,10.0
9212,1990-1991,7,Roda JC Kerkrade,PSV,1,3,2,0,3,4,-2,7.0,13.0
9213,1990-1991,8,FC Twente,Vitesse,0,2,2,0,3,2,-2,4.0,4.0
9214,1990-1991,8,Fortuna Sittard,Willem II,2,0,1,3,0,2,2,12.0,7.0
9215,1990-1991,8,MVV Maastricht,Roda JC Kerkrade,1,2,2,0,3,3,-1,3.0,7.0
9216,1990-1991,8,PSV,RKC Waalwijk,3,1,1,3,0,4,2,13.0,7.0
9217,1990-1991,8,FC Groningen,SVV Schiedam,2,2,3,1,1,4,0,8.0,5.0
9218,1990-1991,8,FC Utrecht,AFC Ajax,0,0,3,1,1,0,0,7.0,13.0
9219,1990-1991,8,FC Volendam,Sparta Rotterdam,2,2,3,1,1,4,0,4.0,8.0
9220,1990-1991,8,Feyenoord,sc Heerenveen,1,1,3,1,1,2,0,5.0,1.0
9221,1990-1991,8,NEC Nijmegen,FC Den Haag,0,0,3,1,1,0,0,6.0,10.0
9222,1990-1991,9,Roda JC Kerkrade,RKC Waalwijk,1,0,1,3,0,1,1,10.0,6.0
9223,1990-1991,9,Fortuna Sittard,FC Groningen,0,0,3,1,1,0,0,10.0,9.0
9224,1990-1991,9,Willem II,FC Volendam,4,1,1,3,0,5,3,9.0,4.0
9225,1990-1991,9,AFC Ajax,PSV,3,1,1,3,0,4,2,13.0,12.0
9226,1990-1991,9,FC Den Haag,sc Heerenveen,3,2,1,3,0,5,1,10.0,1.0
9227,1990-1991,9,FC Twente,Feyenoord,1,1,3,1,1,2,0,5.0,5.0
9228,1990-1991,9,SVV Schiedam,NEC Nijmegen,1,0,1,3,0,1,1,8.0,5.0
9229,1990-1991,9,Vitesse,FC Utrecht,1,0,1,3,0,1,1,6.0,4.0
9230,1990-1991,9,Sparta Rotterdam,MVV Maastricht,0,0,3,1,1,0,0,6.0,1.0
9231,1990-1991,10,MVV Maastricht,SVV Schiedam,2,0,1,3,0,2,2,4.0,7.0
9232,1990-1991,10,FC Groningen,FC Twente,4,0,1,3,0,4,4,11.0,4.0
9233,1990-1991,10,FC Utrecht,Willem II,1,0,1,3,0,1,1,7.0,6.0
9234,1990-1991,10,FC Volendam,Fortuna Sittard,2,1,1,3,0,3,1,7.0,7.0
9235,1990-1991,10,Feyenoord,Roda JC Kerkrade,2,1,1,3,0,3,1,8.0,9.0
9236,1990-1991,10,NEC Nijmegen,Vitesse,0,2,2,0,3,2,-2,4.0,9.0
9237,1990-1991,10,PSV,Sparta Rotterdam,6,1,1,3,0,7,5,12.0,5.0
9238,1990-1991,10,RKC Waalwijk,FC Den Haag,1,2,2,0,3,3,-1,3.0,10.0
9239,1990-1991,10,sc Heerenveen,AFC Ajax,1,4,2,0,3,5,-3,1.0,13.0
9240,1990-1991,11,FC Twente,FC Volendam,0,0,3,1,1,0,0,2.0,5.0
9241,1990-1991,11,Fortuna Sittard,FC Utrecht,0,2,2,0,3,2,-2,7.0,7.0
9242,1990-1991,11,Willem II,NEC Nijmegen,2,2,3,1,1,4,0,7.0,2.0
9243,1990-1991,11,AFC Ajax,RKC Waalwijk,0,0,3,1,1,0,0,11.0,4.0
9244,1990-1991,11,FC Den Haag,Roda JC Kerkrade,3,1,1,3,0,4,2,13.0,6.0
9245,1990-1991,11,FC Groningen,Feyenoord,1,1,3,1,1,2,0,9.0,6.0
9246,1990-1991,11,Sparta Rotterdam,sc Heerenveen,2,1,1,3,0,3,1,8.0,1.0
9247,1990-1991,11,SVV Schiedam,PSV,0,1,2,0,3,1,-1,7.0,12.0
9248,1990-1991,11,Vitesse,MVV Maastricht,1,1,3,1,1,2,0,10.0,5.0
9249,1990-1991,12,MVV Maastricht,Willem II,3,1,1,3,0,4,2,8.0,4.0
9250,1990-1991,12,NEC Nijmegen,Fortuna Sittard,0,2,2,0,3,2,-2,2.0,7.0
9251,1990-1991,12,PSV,Vitesse,1,1,3,1,1,2,0,10.0,11.0
9252,1990-1991,12,sc Heerenveen,SVV Schiedam,0,1,2,0,3,1,-1,1.0,7.0
9253,1990-1991,12,FC Utrecht,FC Twente,1,0,1,3,0,1,1,10.0,2.0
9254,1990-1991,12,FC Volendam,FC Groningen,2,2,3,1,1,4,0,6.0,7.0
9255,1990-1991,12,Feyenoord,FC Den Haag,0,2,2,0,3,2,-2,6.0,13.0
9256,1990-1991,12,RKC Waalwijk,Sparta Rotterdam,4,2,1,3,0,6,2,4.0,5.0
9257,1990-1991,12,Roda JC Kerkrade,AFC Ajax,0,0,3,1,1,0,0,7.0,9.0
9258,1990-1991,13,Fortuna Sittard,MVV Maastricht,1,1,3,1,1,2,0,5.0,9.0
9259,1990-1991,13,FC Twente,NEC Nijmegen,5,0,1,3,0,5,5,5.0,1.0
9260,1990-1991,13,AFC Ajax,FC Den Haag,5,0,1,3,0,5,5,11.0,12.0
9261,1990-1991,13,FC Groningen,FC Utrecht,2,2,3,1,1,4,0,7.0,10.0
9262,1990-1991,13,FC Volendam,Feyenoord,2,2,3,1,1,4,0,6.0,6.0
9263,1990-1991,13,Sparta Rotterdam,Roda JC Kerkrade,1,1,3,1,1,2,0,5.0,5.0
9264,1990-1991,13,SVV Schiedam,RKC Waalwijk,0,0,3,1,1,0,0,7.0,5.0
9265,1990-1991,13,Vitesse,sc Heerenveen,2,0,1,3,0,2,2,11.0,0.0
9266,1990-1991,13,Willem II,PSV,0,2,2,0,3,2,-2,4.0,10.0
9267,1990-1991,14,Roda JC Kerkrade,SVV Schiedam,1,0,1,3,0,1,1,5.0,4.0
9268,1990-1991,14,MVV Maastricht,FC Twente,2,1,1,3,0,3,1,11.0,4.0
9269,1990-1991,14,NEC Nijmegen,FC Groningen,0,3,2,0,3,3,-3,1.0,9.0
9270,1990-1991,14,PSV,Fortuna Sittard,5,1,1,3,0,6,4,13.0,4.0
9271,1990-1991,14,sc Heerenveen,Willem II,2,1,1,3,0,3,1,3.0,1.0
9272,1990-1991,14,FC Den Haag,Sparta Rotterdam,3,0,1,3,0,3,3,12.0,4.0
9273,1990-1991,14,FC Utrecht,FC Volendam,1,0,1,3,0,1,1,13.0,6.0
9274,1990-1991,14,Feyenoord,AFC Ajax,0,4,2,0,3,4,-4,5.0,11.0
9275,1990-1991,14,RKC Waalwijk,Vitesse,1,1,3,1,1,2,0,6.0,9.0
9276,1990-1991,15,Fortuna Sittard,sc Heerenveen,1,0,1,3,0,1,1,7.0,3.0
9277,1990-1991,15,Willem II,RKC Waalwijk,4,2,1,3,0,6,2,4.0,6.0
9278,1990-1991,15,FC Groningen,MVV Maastricht,2,1,1,3,0,3,1,9.0,8.0
9279,1990-1991,15,FC Twente,PSV,0,2,2,0,3,2,-2,4.0,13.0
9280,1990-1991,15,FC Utrecht,Feyenoord,2,0,1,3,0,2,2,13.0,2.0
9281,1990-1991,15,FC Volendam,NEC Nijmegen,0,0,3,1,1,0,0,4.0,2.0
9282,1990-1991,15,SVV Schiedam,FC Den Haag,4,2,1,3,0,6,2,7.0,9.0
9283,1990-1991,15,Vitesse,Roda JC Kerkrade,1,3,2,0,3,4,-2,6.0,8.0
9284,1990-1991,15,Sparta Rotterdam,AFC Ajax,0,0,3,1,1,0,0,5.0,9.0
9285,1990-1991,16,Roda JC Kerkrade,Willem II,1,0,1,3,0,1,1,11.0,3.0
9286,1990-1991,16,PSV,FC Groningen,1,1,3,1,1,2,0,11.0,9.0
9287,1990-1991,16,RKC Waalwijk,Fortuna Sittard,1,1,3,1,1,2,0,6.0,8.0
9288,1990-1991,16,NEC Nijmegen,FC Utrecht,1,1,3,1,1,2,0,2.0,11.0
9289,1990-1991,16,sc Heerenveen,FC Twente,0,1,2,0,3,1,-1,3.0,6.0
9290,1990-1991,16,MVV Maastricht,FC Volendam,1,1,3,1,1,2,0,8.0,4.0
9291,1990-1991,16,AFC Ajax,SVV Schiedam,2,0,1,3,0,2,2,11.0,7.0
9292,1990-1991,16,FC Den Haag,Vitesse,1,1,3,1,1,2,0,7.0,6.0
9293,1990-1991,16,Sparta Rotterdam,Feyenoord,1,1,3,1,1,2,0,3.0,2.0
9294,1990-1991,17,Fortuna Sittard,Roda JC Kerkrade,0,1,2,0,3,1,-1,5.0,13.0
9295,1990-1991,17,FC Twente,RKC Waalwijk,1,1,3,1,1,2,0,7.0,4.0
9296,1990-1991,17,FC Groningen,sc Heerenveen,3,0,1,3,0,3,3,11.0,3.0
9297,1990-1991,17,FC Utrecht,MVV Maastricht,4,1,1,3,0,5,3,11.0,5.0
9298,1990-1991,17,FC Volendam,PSV,0,2,2,0,3,2,-2,3.0,13.0
9299,1990-1991,17,Feyenoord,NEC Nijmegen,0,0,3,1,1,0,0,3.0,3.0
9300,1990-1991,17,Vitesse,AFC Ajax,1,3,2,0,3,4,-2,5.0,13.0
9301,1990-1991,17,Willem II,FC Den Haag,5,0,1,3,0,5,5,6.0,4.0
9302,1990-1991,17,SVV Schiedam,Sparta Rotterdam,0,0,3,1,1,0,0,5.0,4.0
9303,1990-1991,18,FC Groningen,RKC Waalwijk,2,1,1,3,0,3,1,13.0,3.0
9304,1990-1991,18,FC Utrecht,PSV,1,1,3,1,1,2,0,11.0,11.0
9305,1990-1991,18,Willem II,AFC Ajax,3,2,1,3,0,5,1,9.0,10.0
9306,1990-1991,18,FC Volendam,sc Heerenveen,1,1,3,1,1,2,0,3.0,4.0
9307,1990-1991,18,Feyenoord,SVV Schiedam,1,1,3,1,1,2,0,3.0,5.0
9308,1990-1991,18,NEC Nijmegen,MVV Maastricht,2,1,1,3,0,3,1,6.0,4.0
9309,1990-1991,18,Vitesse,Sparta Rotterdam,0,0,3,1,1,0,0,3.0,4.0
9310,1990-1991,18,FC Twente,Roda JC Kerkrade,4,1,1,3,0,5,3,7.0,12.0
9311,1990-1991,18,Fortuna Sittard,FC Den Haag,3,1,1,3,0,4,2,7.0,4.0
9312,1990-1991,19,sc Heerenveen,FC Utrecht,1,0,1,3,0,1,1,4.0,8.0
9313,1990-1991,19,AFC Ajax,Fortuna Sittard,2,0,1,3,0,2,2,10.0,7.0
9314,1990-1991,19,FC Den Haag,FC Twente,1,5,2,0,3,6,-4,1.0,10.0
9315,1990-1991,19,MVV Maastricht,Feyenoord,0,2,2,0,3,2,-2,1.0,6.0
9316,1990-1991,19,PSV,NEC Nijmegen,1,0,1,3,0,1,1,11.0,6.0
9317,1990-1991,19,RKC Waalwijk,FC Volendam,1,1,3,1,1,2,0,3.0,4.0
9318,1990-1991,19,Roda JC Kerkrade,FC Groningen,0,0,3,1,1,0,0,10.0,11.0
9319,1990-1991,19,Sparta Rotterdam,Willem II,2,0,1,3,0,2,2,7.0,9.0
9320,1990-1991,19,SVV Schiedam,Vitesse,1,2,2,0,3,3,-1,5.0,5.0
9321,1990-1991,20,FC Groningen,FC Den Haag,2,0,1,3,0,2,2,11.0,1.0
9322,1990-1991,20,FC Utrecht,RKC Waalwijk,2,0,1,3,0,2,2,8.0,3.0
9323,1990-1991,20,FC Volendam,Roda JC Kerkrade,2,0,1,3,0,2,2,6.0,7.0
9324,1990-1991,20,Feyenoord,Vitesse,0,0,3,1,1,0,0,7.0,6.0
9325,1990-1991,20,Fortuna Sittard,Sparta Rotterdam,1,1,3,1,1,2,0,5.0,7.0
9326,1990-1991,20,MVV Maastricht,PSV,3,3,3,1,1,6,0,2.0,9.0
9327,1990-1991,20,Willem II,SVV Schiedam,6,0,1,3,0,6,6,9.0,2.0
9328,1990-1991,20,FC Twente,AFC Ajax,0,1,2,0,3,1,-1,10.0,12.0
9329,1990-1991,20,NEC Nijmegen,sc Heerenveen,2,1,1,3,0,3,1,8.0,4.0
9330,1990-1991,21,sc Heerenveen,MVV Maastricht,1,0,1,3,0,1,1,7.0,1.0
9331,1990-1991,21,SVV Schiedam,Fortuna Sittard,2,0,1,3,0,2,2,5.0,4.0
9332,1990-1991,21,AFC Ajax,FC Groningen,1,1,3,1,1,2,0,10.0,11.0
9333,1990-1991,21,FC Den Haag,FC Volendam,1,3,2,0,3,4,-2,0.0,8.0
9334,1990-1991,21,PSV,Feyenoord,6,0,1,3,0,6,6,11.0,6.0
9335,1990-1991,21,RKC Waalwijk,NEC Nijmegen,3,0,1,3,0,3,3,5.0,7.0
9336,1990-1991,21,Sparta Rotterdam,FC Twente,1,3,2,0,3,4,-2,6.0,10.0
9337,1990-1991,21,Vitesse,Willem II,2,0,1,3,0,2,2,8.0,9.0
9338,1990-1991,21,Roda JC Kerkrade,FC Utrecht,1,2,2,0,3,3,-1,4.0,10.0
9339,1990-1991,22,Fortuna Sittard,Vitesse,0,4,2,0,3,4,-4,4.0,11.0
9340,1990-1991,22,FC Twente,SVV Schiedam,2,1,1,3,0,3,1,12.0,4.0
9341,1990-1991,22,MVV Maastricht,RKC Waalwijk,0,1,2,0,3,1,-1,1.0,7.0
9342,1990-1991,22,NEC Nijmegen,Roda JC Kerkrade,1,2,2,0,3,3,-1,6.0,4.0
9343,1990-1991,22,FC Groningen,Sparta Rotterdam,4,0,1,3,0,4,4,11.0,5.0
9344,1990-1991,22,FC Utrecht,FC Den Haag,0,0,3,1,1,0,0,8.0,1.0
9345,1990-1991,22,Feyenoord,Willem II,0,1,2,0,3,1,-1,5.0,9.0
9346,1990-1991,22,PSV,sc Heerenveen,2,0,1,3,0,2,2,11.0,7.0
9347,1990-1991,22,FC Volendam,AFC Ajax,0,3,2,0,3,3,-3,8.0,10.0
9348,1990-1991,23,Fortuna Sittard,FC Twente,0,0,3,1,1,0,0,2.0,10.0
9349,1990-1991,23,Willem II,FC Groningen,1,2,2,0,3,3,-1,6.0,11.0
9350,1990-1991,23,AFC Ajax,MVV Maastricht,1,0,1,3,0,1,1,13.0,1.0
9351,1990-1991,23,FC Den Haag,PSV,3,0,1,3,0,3,3,4.0,10.0
9352,1990-1991,23,RKC Waalwijk,Feyenoord,1,0,1,3,0,1,1,10.0,4.0
9353,1990-1991,23,Roda JC Kerkrade,sc Heerenveen,1,0,1,3,0,1,1,7.0,6.0
9354,1990-1991,23,Sparta Rotterdam,NEC Nijmegen,3,1,1,3,0,4,2,7.0,3.0
9355,1990-1991,23,SVV Schiedam,FC Utrecht,1,0,1,3,0,1,1,6.0,7.0
9356,1990-1991,23,Vitesse,FC Volendam,0,0,3,1,1,0,0,11.0,8.0
9357,1990-1991,24,MVV Maastricht,FC Den Haag,1,0,1,3,0,1,1,4.0,4.0
9358,1990-1991,24,FC Twente,Willem II,2,0,1,3,0,2,2,10.0,6.0
9359,1990-1991,24,PSV,Roda JC Kerkrade,3,0,1,3,0,3,3,10.0,6.0
9360,1990-1991,24,sc Heerenveen,RKC Waalwijk,4,1,1,3,0,5,3,6.0,9.0
9361,1990-1991,24,FC Groningen,Vitesse,2,0,1,3,0,2,2,13.0,8.0
9362,1990-1991,24,FC Utrecht,Sparta Rotterdam,2,0,1,3,0,2,2,10.0,4.0
9363,1990-1991,24,FC Volendam,SVV Schiedam,2,1,1,3,0,3,1,10.0,6.0
9364,1990-1991,24,Feyenoord,Fortuna Sittard,0,0,3,1,1,0,0,2.0,3.0
9365,1990-1991,24,NEC Nijmegen,AFC Ajax,0,5,2,0,3,5,-5,3.0,13.0
9366,1990-1991,25,Roda JC Kerkrade,MVV Maastricht,1,0,1,3,0,1,1,9.0,3.0
9367,1990-1991,25,Willem II,Fortuna Sittard,3,2,1,3,0,5,1,6.0,2.0
9368,1990-1991,25,AFC Ajax,FC Utrecht,1,1,3,1,1,2,0,11.0,8.0
9369,1990-1991,25,FC Den Haag,NEC Nijmegen,1,1,3,1,1,2,0,5.0,1.0
9370,1990-1991,25,RKC Waalwijk,PSV,0,3,2,0,3,3,-3,9.0,12.0
9371,1990-1991,25,sc Heerenveen,Feyenoord,0,0,3,1,1,0,0,7.0,2.0
9372,1990-1991,25,Sparta Rotterdam,FC Volendam,1,2,2,0,3,3,-1,3.0,10.0
9373,1990-1991,25,SVV Schiedam,FC Groningen,0,1,2,0,3,1,-1,6.0,13.0
9374,1990-1991,25,Vitesse,FC Twente,1,0,1,3,0,1,1,10.0,10.0
9375,1990-1991,26,MVV Maastricht,Sparta Rotterdam,0,0,3,1,1,0,0,4.0,4.0
9376,1990-1991,26,NEC Nijmegen,SVV Schiedam,2,1,1,3,0,3,1,4.0,3.0
9377,1990-1991,26,FC Groningen,Fortuna Sittard,3,1,1,3,0,4,2,15.0,2.0
9378,1990-1991,26,FC Utrecht,Vitesse,1,1,3,1,1,2,0,6.0,8.0
9379,1990-1991,26,FC Volendam,Willem II,0,0,3,1,1,0,0,8.0,7.0
9380,1990-1991,26,Feyenoord,FC Twente,2,2,3,1,1,4,0,3.0,8.0
9381,1990-1991,26,PSV,AFC Ajax,4,1,1,3,0,5,3,12.0,10.0
9382,1990-1991,26,RKC Waalwijk,Roda JC Kerkrade,4,1,1,3,0,5,3,9.0,9.0
9383,1990-1991,26,sc Heerenveen,FC Den Haag,3,0,1,3,0,3,3,7.0,5.0
9384,1990-1991,27,Roda JC Kerkrade,Feyenoord,0,0,3,1,1,0,0,7.0,4.0
9385,1990-1991,27,SVV Schiedam,MVV Maastricht,1,4,2,0,3,5,-3,3.0,7.0
9386,1990-1991,27,Fortuna Sittard,FC Volendam,0,0,3,1,1,0,0,3.0,9.0
9387,1990-1991,27,Sparta Rotterdam,PSV,1,0,1,3,0,1,1,7.0,9.0
9388,1990-1991,27,Willem II,FC Utrecht,0,2,2,0,3,2,-2,4.0,8.0
9389,1990-1991,27,AFC Ajax,sc Heerenveen,4,0,1,3,0,4,4,10.0,7.0
9390,1990-1991,27,FC Den Haag,RKC Waalwijk,2,2,3,1,1,4,0,5.0,7.0
9391,1990-1991,27,FC Twente,FC Groningen,4,2,1,3,0,6,2,8.0,12.0
9392,1990-1991,27,Vitesse,NEC Nijmegen,0,0,3,1,1,0,0,6.0,5.0
9393,1990-1991,28,MVV Maastricht,Vitesse,2,0,1,3,0,2,2,10.0,5.0
9394,1990-1991,28,Roda JC Kerkrade,FC Den Haag,5,1,1,3,0,6,4,7.0,2.0
9395,1990-1991,28,NEC Nijmegen,Willem II,0,2,2,0,3,2,-2,5.0,7.0
9396,1990-1991,28,PSV,SVV Schiedam,3,2,1,3,0,5,1,12.0,0.0
9397,1990-1991,28,sc Heerenveen,Sparta Rotterdam,2,1,1,3,0,3,1,10.0,4.0
9398,1990-1991,28,FC Utrecht,Fortuna Sittard,2,0,1,3,0,2,2,11.0,2.0
9399,1990-1991,28,FC Volendam,FC Twente,3,1,1,3,0,4,2,11.0,7.0
9400,1990-1991,28,Feyenoord,FC Groningen,2,0,1,3,0,2,2,7.0,9.0
9401,1990-1991,28,RKC Waalwijk,AFC Ajax,1,1,3,1,1,2,0,5.0,8.0
9402,1990-1991,29,Fortuna Sittard,NEC Nijmegen,3,1,1,3,0,4,2,4.0,5.0
9403,1990-1991,29,AFC Ajax,Roda JC Kerkrade,4,1,1,3,0,5,3,8.0,7.0
9404,1990-1991,29,FC Den Haag,Feyenoord,0,2,2,0,3,2,-2,2.0,9.0
9405,1990-1991,29,FC Groningen,FC Volendam,1,0,1,3,0,1,1,9.0,8.0
9406,1990-1991,29,FC Twente,FC Utrecht,1,1,3,1,1,2,0,5.0,9.0
9407,1990-1991,29,Sparta Rotterdam,RKC Waalwijk,0,0,3,1,1,0,0,5.0,6.0
9408,1990-1991,29,SVV Schiedam,sc Heerenveen,1,2,2,0,3,3,-1,0.0,10.0
9409,1990-1991,29,Vitesse,PSV,1,1,3,1,1,2,0,6.0,10.0
9410,1990-1991,29,Willem II,MVV Maastricht,0,1,2,0,3,1,-1,7.0,10.0
9411,1990-1991,30,NEC Nijmegen,FC Twente,1,3,2,0,3,4,-2,4.0,8.0
9412,1990-1991,30,FC Den Haag,AFC Ajax,0,1,2,0,3,1,-1,1.0,10.0
9413,1990-1991,30,Feyenoord,FC Volendam,3,0,1,3,0,3,3,11.0,5.0
9414,1990-1991,30,MVV Maastricht,Fortuna Sittard,1,1,3,1,1,2,0,11.0,5.0
9415,1990-1991,30,PSV,Willem II,3,0,1,3,0,3,3,10.0,4.0
9416,1990-1991,30,RKC Waalwijk,SVV Schiedam,4,1,1,3,0,5,3,9.0,0.0
9417,1990-1991,30,Roda JC Kerkrade,Sparta Rotterdam,2,2,3,1,1,4,0,5.0,6.0
9418,1990-1991,30,sc Heerenveen,Vitesse,2,2,3,1,1,4,0,10.0,4.0
9419,1990-1991,30,FC Utrecht,FC Groningen,4,0,1,3,0,4,4,11.0,6.0
9420,1990-1991,31,Fortuna Sittard,PSV,0,3,2,0,3,3,-3,5.0,10.0
9421,1990-1991,31,FC Twente,MVV Maastricht,4,1,1,3,0,5,3,10.0,10.0
9422,1990-1991,31,Sparta Rotterdam,FC Den Haag,0,0,3,1,1,0,0,6.0,2.0
9423,1990-1991,31,SVV Schiedam,Roda JC Kerkrade,3,1,1,3,0,4,2,3.0,5.0
9424,1990-1991,31,Willem II,sc Heerenveen,5,2,1,3,0,7,3,6.0,7.0
9425,1990-1991,31,AFC Ajax,Feyenoord,2,0,1,3,0,2,2,13.0,10.0
9426,1990-1991,31,Vitesse,RKC Waalwijk,1,1,3,1,1,2,0,4.0,7.0
9427,1990-1991,31,FC Groningen,NEC Nijmegen,2,1,1,3,0,3,1,6.0,1.0
9428,1990-1991,31,FC Volendam,FC Utrecht,0,1,2,0,3,1,-1,4.0,13.0
9429,1990-1991,32,NEC Nijmegen,FC Volendam,1,2,2,0,3,3,-1,0.0,6.0
9430,1990-1991,32,AFC Ajax,Sparta Rotterdam,1,0,1,3,0,1,1,13.0,3.0
9431,1990-1991,32,MVV Maastricht,FC Groningen,1,0,1,3,0,1,1,10.0,6.0
9432,1990-1991,32,Roda JC Kerkrade,Vitesse,1,2,2,0,3,3,-1,4.0,6.0
9433,1990-1991,32,PSV,FC Twente,3,1,1,3,0,4,2,13.0,7.0
9434,1990-1991,32,sc Heerenveen,Fortuna Sittard,1,2,2,0,3,3,-1,7.0,7.0
9435,1990-1991,32,FC Den Haag,SVV Schiedam,1,1,3,1,1,2,0,2.0,4.0
9436,1990-1991,32,Feyenoord,FC Utrecht,0,0,3,1,1,0,0,10.0,11.0
9437,1990-1991,32,RKC Waalwijk,Willem II,2,0,1,3,0,2,2,9.0,6.0
9438,1990-1991,33,Fortuna Sittard,RKC Waalwijk,0,2,2,0,3,2,-2,7.0,11.0
9439,1990-1991,33,Willem II,Roda JC Kerkrade,2,0,1,3,0,2,2,6.0,1.0
9440,1990-1991,33,FC Groningen,PSV,4,1,1,3,0,5,3,9.0,10.0
9441,1990-1991,33,FC Twente,sc Heerenveen,3,3,3,1,1,6,0,8.0,5.0
9442,1990-1991,33,FC Utrecht,NEC Nijmegen,2,0,1,3,0,2,2,11.0,0.0
9443,1990-1991,33,FC Volendam,MVV Maastricht,2,2,3,1,1,4,0,4.0,8.0
9444,1990-1991,33,Feyenoord,Sparta Rotterdam,4,3,1,3,0,7,1,10.0,3.0
9445,1990-1991,33,SVV Schiedam,AFC Ajax,1,0,1,3,0,1,1,7.0,12.0
9446,1990-1991,33,Vitesse,FC Den Haag,2,0,1,3,0,2,2,9.0,2.0
9447,1990-1991,34,AFC Ajax,Vitesse,3,0,1,3,0,3,3,12.0,8.0
9448,1990-1991,34,FC Den Haag,Willem II,1,0,1,3,0,1,1,5.0,6.0
9449,1990-1991,34,MVV Maastricht,FC Utrecht,1,1,3,1,1,2,0,6.0,11.0
9450,1990-1991,34,NEC Nijmegen,Feyenoord,2,1,1,3,0,3,1,3.0,7.0
9451,1990-1991,34,PSV,FC Volendam,3,0,1,3,0,3,3,12.0,4.0
9452,1990-1991,34,RKC Waalwijk,FC Twente,6,6,3,1,1,12,0,11.0,8.0
9453,1990-1991,34,Roda JC Kerkrade,Fortuna Sittard,1,1,3,1,1,2,0,2.0,5.0
9454,1990-1991,34,sc Heerenveen,FC Groningen,4,2,1,3,0,6,2,5.0,6.0
9455,1990-1991,34,Sparta Rotterdam,SVV Schiedam,5,3,1,3,0,8,2,5.0,7.0
9456,1991-1992,1,MVV Maastricht,Fortuna Sittard,0,0,3,1,1,0,0,6.0,5.0
9457,1991-1992,1,VVV-Venlo,Roda JC Kerkrade,1,3,2,0,3,4,-2,7.0,4.0
9458,1991-1992,1,FC Groningen,Willem II,1,0,1,3,0,1,1,9.0,6.0
9459,1991-1992,1,FC Volendam,Sparta Rotterdam,1,1,3,1,1,2,0,5.0,5.0
9460,1991-1992,1,Feyenoord,FC Twente,1,0,1,3,0,1,1,7.0,5.0
9461,1991-1992,1,PSV,FC Utrecht,2,1,1,3,0,3,1,12.0,8.0
9462,1991-1992,1,RKC Waalwijk,De Graafschap,2,1,1,3,0,3,1,11.0,1.0
9463,1991-1992,1,Vitesse,AFC Ajax,0,0,3,1,1,0,0,8.0,10.0
9464,1991-1992,1,S.V.V./Dordrecht '90,FC Den Haag,2,2,3,1,1,4,0,,6.0
9465,1991-1992,2,AFC Ajax,FC Volendam,3,0,1,3,0,3,3,10.0,5.0
9466,1991-1992,2,De Graafschap,FC Groningen,0,0,3,1,1,0,0,2.0,7.0
9467,1991-1992,2,FC Den Haag,Vitesse,0,3,2,0,3,3,-3,5.0,10.0
9468,1991-1992,2,FC Twente,MVV Maastricht,1,0,1,3,0,1,1,5.0,6.0
9469,1991-1992,2,Roda JC Kerkrade,S.V.V./Dordrecht '90,1,0,1,3,0,1,1,7.0,
9470,1991-1992,2,Willem II,VVV-Venlo,4,0,1,3,0,4,4,6.0,4.0
9471,1991-1992,2,Sparta Rotterdam,Feyenoord,0,0,3,1,1,0,0,5.0,8.0
9472,1991-1992,2,FC Utrecht,RKC Waalwijk,1,1,3,1,1,2,0,6.0,11.0
9473,1991-1992,2,Fortuna Sittard,PSV,2,5,2,0,3,7,-3,5.0,12.0
9474,1991-1992,3,S.V.V./Dordrecht '90,VVV-Venlo,6,1,1,3,0,7,5,,4.0
9475,1991-1992,3,RKC Waalwijk,Fortuna Sittard,2,2,3,1,1,4,0,9.0,3.0
9476,1991-1992,3,De Graafschap,Willem II,1,2,2,0,3,3,-1,2.0,9.0
9477,1991-1992,3,Vitesse,Roda JC Kerkrade,0,0,3,1,1,0,0,8.0,8.0
9478,1991-1992,3,MVV Maastricht,Sparta Rotterdam,1,3,2,0,3,4,-2,3.0,8.0
9479,1991-1992,3,PSV,FC Twente,3,3,3,1,1,6,0,10.0,6.0
9480,1991-1992,3,Feyenoord,AFC Ajax,2,0,1,3,0,2,2,10.0,7.0
9481,1991-1992,3,FC Groningen,FC Utrecht,2,0,1,3,0,2,2,10.0,5.0
9482,1991-1992,3,FC Volendam,FC Den Haag,0,0,3,1,1,0,0,3.0,5.0
9483,1991-1992,4,Fortuna Sittard,FC Groningen,2,2,3,1,1,4,0,4.0,8.0
9484,1991-1992,4,Roda JC Kerkrade,FC Volendam,1,5,2,0,3,6,-4,8.0,5.0
9485,1991-1992,4,VVV-Venlo,Vitesse,0,0,3,1,1,0,0,2.0,6.0
9486,1991-1992,4,Willem II,S.V.V./Dordrecht '90,2,2,3,1,1,4,0,7.0,
9487,1991-1992,4,AFC Ajax,MVV Maastricht,3,0,1,3,0,3,3,10.0,2.0
9488,1991-1992,4,FC Twente,RKC Waalwijk,1,1,3,1,1,2,0,6.0,7.0
9489,1991-1992,4,FC Utrecht,De Graafschap,2,0,1,3,0,2,2,5.0,1.0
9490,1991-1992,4,Sparta Rotterdam,PSV,1,3,2,0,3,4,-2,8.0,13.0
9491,1991-1992,4,FC Den Haag,Feyenoord,1,4,2,0,3,5,-3,5.0,10.0
9492,1991-1992,5,De Graafschap,Fortuna Sittard,2,0,1,3,0,2,2,4.0,3.0
9493,1991-1992,5,FC Groningen,FC Twente,1,2,2,0,3,3,-1,8.0,8.0
9494,1991-1992,5,FC Utrecht,Willem II,1,0,1,3,0,1,1,7.0,7.0
9495,1991-1992,5,FC Volendam,VVV-Venlo,1,0,1,3,0,1,1,8.0,1.0
9496,1991-1992,5,Feyenoord,Roda JC Kerkrade,1,1,3,1,1,2,0,11.0,8.0
9497,1991-1992,5,MVV Maastricht,FC Den Haag,1,1,3,1,1,2,0,2.0,3.0
9498,1991-1992,5,RKC Waalwijk,Sparta Rotterdam,6,2,1,3,0,8,4,9.0,5.0
9499,1991-1992,5,Vitesse,S.V.V./Dordrecht '90,4,1,1,3,0,5,3,9.0,5.0
9500,1991-1992,5,PSV,AFC Ajax,3,2,1,3,0,5,1,13.0,7.0
9501,1991-1992,6,FC Twente,De Graafschap,3,0,1,3,0,3,3,11.0,4.0
9502,1991-1992,6,Fortuna Sittard,FC Utrecht,2,2,3,1,1,4,0,3.0,8.0
9503,1991-1992,6,Sparta Rotterdam,FC Groningen,4,2,1,3,0,6,2,7.0,5.0
9504,1991-1992,6,S.V.V./Dordrecht '90,FC Volendam,3,2,1,3,0,5,1,7.0,7.0
9505,1991-1992,6,VVV-Venlo,Feyenoord,0,1,2,0,3,1,-1,1.0,11.0
9506,1991-1992,6,Willem II,Vitesse,2,4,2,0,3,6,-2,7.0,11.0
9507,1991-1992,6,AFC Ajax,RKC Waalwijk,5,1,1,3,0,6,4,9.0,6.0
9508,1991-1992,6,Roda JC Kerkrade,MVV Maastricht,0,2,2,0,3,2,-2,5.0,4.0
9509,1991-1992,6,FC Den Haag,PSV,0,2,2,0,3,2,-2,2.0,13.0
9510,1991-1992,7,Fortuna Sittard,Willem II,0,0,3,1,1,0,0,4.0,5.0
9511,1991-1992,7,De Graafschap,Sparta Rotterdam,0,1,2,0,3,1,-1,3.0,9.0
9512,1991-1992,7,FC Utrecht,FC Twente,1,1,3,1,1,2,0,8.0,9.0
9513,1991-1992,7,MVV Maastricht,VVV-Venlo,1,0,1,3,0,1,1,7.0,1.0
9514,1991-1992,7,PSV,Roda JC Kerkrade,2,1,1,3,0,3,1,13.0,2.0
9515,1991-1992,7,FC Volendam,Vitesse,0,1,2,0,3,1,-1,7.0,11.0
9516,1991-1992,7,Feyenoord,S.V.V./Dordrecht '90,2,0,1,3,0,2,2,13.0,7.0
9517,1991-1992,7,RKC Waalwijk,FC Den Haag,3,0,1,3,0,3,3,8.0,2.0
9518,1991-1992,7,FC Groningen,AFC Ajax,1,2,2,0,3,3,-1,4.0,9.0
9519,1991-1992,8,Roda JC Kerkrade,RKC Waalwijk,1,0,1,3,0,1,1,4.0,7.0
9520,1991-1992,8,S.V.V./Dordrecht '90,MVV Maastricht,2,3,2,0,3,5,-1,4.0,10.0
9521,1991-1992,8,Willem II,FC Volendam,1,1,3,1,1,2,0,3.0,7.0
9522,1991-1992,8,AFC Ajax,De Graafschap,5,1,1,3,0,6,4,12.0,3.0
9523,1991-1992,8,FC Den Haag,FC Groningen,2,2,3,1,1,4,0,2.0,2.0
9524,1991-1992,8,FC Twente,Fortuna Sittard,3,1,1,3,0,4,2,11.0,3.0
9525,1991-1992,8,Sparta Rotterdam,FC Utrecht,2,1,1,3,0,3,1,9.0,8.0
9526,1991-1992,8,Vitesse,Feyenoord,2,1,1,3,0,3,1,13.0,10.0
9527,1991-1992,8,VVV-Venlo,PSV,0,2,2,0,3,2,-2,1.0,15.0
9528,1991-1992,9,De Graafschap,FC Den Haag,2,4,2,0,3,6,-2,3.0,5.0
9529,1991-1992,9,FC Groningen,Roda JC Kerkrade,1,2,2,0,3,3,-1,1.0,7.0
9530,1991-1992,9,FC Twente,Willem II,1,0,1,3,0,1,1,13.0,2.0
9531,1991-1992,9,Feyenoord,FC Volendam,1,0,1,3,0,1,1,10.0,4.0
9532,1991-1992,9,Fortuna Sittard,Sparta Rotterdam,2,2,3,1,1,4,0,3.0,10.0
9533,1991-1992,9,MVV Maastricht,Vitesse,2,1,1,3,0,3,1,13.0,12.0
9534,1991-1992,9,PSV,S.V.V./Dordrecht '90,5,0,1,3,0,5,5,15.0,3.0
9535,1991-1992,9,RKC Waalwijk,VVV-Venlo,3,3,3,1,1,6,0,7.0,1.0
9536,1991-1992,9,FC Utrecht,AFC Ajax,2,1,1,3,0,3,1,8.0,9.0
9537,1991-1992,10,AFC Ajax,Fortuna Sittard,3,1,1,3,0,4,2,12.0,3.0
9538,1991-1992,10,FC Den Haag,FC Utrecht,0,0,3,1,1,0,0,5.0,6.0
9539,1991-1992,10,Roda JC Kerkrade,De Graafschap,3,2,1,3,0,5,1,9.0,0.0
9540,1991-1992,10,Sparta Rotterdam,FC Twente,3,2,1,3,0,5,1,13.0,10.0
9541,1991-1992,10,S.V.V./Dordrecht '90,RKC Waalwijk,3,2,1,3,0,5,1,6.0,4.0
9542,1991-1992,10,VVV-Venlo,FC Groningen,1,2,2,0,3,3,-1,1.0,4.0
9543,1991-1992,10,FC Volendam,MVV Maastricht,2,0,1,3,0,2,2,4.0,12.0
9544,1991-1992,10,Vitesse,PSV,1,2,2,0,3,3,-1,9.0,15.0
9545,1991-1992,10,Willem II,Feyenoord,1,4,2,0,3,5,-3,2.0,12.0
9546,1991-1992,11,FC Groningen,S.V.V./Dordrecht '90,5,0,1,3,0,5,5,7.0,3.0
9547,1991-1992,11,FC Utrecht,Roda JC Kerkrade,3,1,1,3,0,4,2,8.0,9.0
9548,1991-1992,11,MVV Maastricht,Feyenoord,0,1,2,0,3,1,-1,9.0,12.0
9549,1991-1992,11,RKC Waalwijk,Vitesse,1,0,1,3,0,1,1,7.0,6.0
9550,1991-1992,11,Sparta Rotterdam,Willem II,1,1,3,1,1,2,0,11.0,3.0
9551,1991-1992,11,Fortuna Sittard,FC Den Haag,0,1,2,0,3,1,-1,2.0,8.0
9552,1991-1992,11,PSV,FC Volendam,1,1,3,1,1,2,0,13.0,5.0
9553,1991-1992,11,FC Twente,AFC Ajax,0,0,3,1,1,0,0,8.0,10.0
9554,1991-1992,11,De Graafschap,VVV-Venlo,1,0,1,3,0,1,1,3.0,1.0
9555,1991-1992,12,AFC Ajax,Sparta Rotterdam,4,0,1,3,0,4,4,10.0,8.0
9556,1991-1992,12,FC Den Haag,FC Twente,0,4,2,0,3,4,-4,8.0,10.0
9557,1991-1992,12,Feyenoord,PSV,1,1,3,1,1,2,0,10.0,11.0
9558,1991-1992,12,Roda JC Kerkrade,Fortuna Sittard,0,0,3,1,1,0,0,10.0,2.0
9559,1991-1992,12,S.V.V./Dordrecht '90,De Graafschap,3,1,1,3,0,4,2,6.0,3.0
9560,1991-1992,12,Vitesse,FC Groningen,0,0,3,1,1,0,0,4.0,8.0
9561,1991-1992,12,VVV-Venlo,FC Utrecht,1,1,3,1,1,2,0,2.0,8.0
9562,1991-1992,12,Willem II,MVV Maastricht,0,0,3,1,1,0,0,3.0,7.0
9563,1991-1992,12,FC Volendam,RKC Waalwijk,0,3,2,0,3,3,-3,5.0,7.0
9564,1991-1992,13,Fortuna Sittard,VVV-Venlo,0,1,2,0,3,1,-1,2.0,5.0
9565,1991-1992,13,De Graafschap,Vitesse,2,0,1,3,0,2,2,6.0,1.0
9566,1991-1992,13,FC Groningen,FC Volendam,1,0,1,3,0,1,1,10.0,4.0
9567,1991-1992,13,FC Twente,Roda JC Kerkrade,1,1,3,1,1,2,0,8.0,8.0
9568,1991-1992,13,FC Utrecht,S.V.V./Dordrecht '90,1,1,3,1,1,2,0,9.0,7.0
9569,1991-1992,13,RKC Waalwijk,Feyenoord,2,3,2,0,3,5,-1,7.0,13.0
9570,1991-1992,13,Sparta Rotterdam,FC Den Haag,4,0,1,3,0,4,4,8.0,7.0
9571,1991-1992,13,AFC Ajax,Willem II,3,0,1,3,0,3,3,10.0,2.0
9572,1991-1992,13,PSV,MVV Maastricht,1,1,3,1,1,2,0,9.0,5.0
9573,1991-1992,14,Roda JC Kerkrade,Sparta Rotterdam,1,1,3,1,1,2,0,6.0,8.0
9574,1991-1992,14,MVV Maastricht,RKC Waalwijk,1,1,3,1,1,2,0,3.0,7.0
9575,1991-1992,14,S.V.V./Dordrecht '90,Fortuna Sittard,2,1,1,3,0,3,1,10.0,1.0
9576,1991-1992,14,VVV-Venlo,FC Twente,3,4,2,0,3,7,-1,4.0,8.0
9577,1991-1992,14,FC Volendam,De Graafschap,2,1,1,3,0,3,1,7.0,6.0
9578,1991-1992,14,Feyenoord,FC Groningen,0,0,3,1,1,0,0,11.0,11.0
9579,1991-1992,14,Willem II,PSV,0,2,2,0,3,2,-2,2.0,9.0
9580,1991-1992,14,Vitesse,FC Utrecht,1,0,1,3,0,1,1,4.0,6.0
9581,1991-1992,14,FC Den Haag,AFC Ajax,0,0,3,1,1,0,0,5.0,11.0
9582,1991-1992,15,Fortuna Sittard,Vitesse,2,2,3,1,1,4,0,2.0,5.0
9583,1991-1992,15,De Graafschap,Feyenoord,1,1,3,1,1,2,0,7.0,9.0
9584,1991-1992,15,FC Groningen,MVV Maastricht,2,2,3,1,1,4,0,9.0,4.0
9585,1991-1992,15,FC Twente,S.V.V./Dordrecht '90,5,0,1,3,0,5,5,11.0,7.0
9586,1991-1992,15,FC Utrecht,FC Volendam,0,0,3,1,1,0,0,6.0,5.0
9587,1991-1992,15,RKC Waalwijk,PSV,2,2,3,1,1,4,0,8.0,7.0
9588,1991-1992,15,Sparta Rotterdam,VVV-Venlo,1,1,3,1,1,2,0,6.0,5.0
9589,1991-1992,15,AFC Ajax,Roda JC Kerkrade,2,0,1,3,0,2,2,11.0,3.0
9590,1991-1992,15,FC Den Haag,Willem II,0,2,2,0,3,2,-2,4.0,5.0
9591,1991-1992,16,Roda JC Kerkrade,FC Den Haag,5,0,1,3,0,5,5,6.0,1.0
9592,1991-1992,16,MVV Maastricht,De Graafschap,0,0,3,1,1,0,0,5.0,5.0
9593,1991-1992,16,FC Volendam,Fortuna Sittard,0,1,2,0,3,1,-1,4.0,5.0
9594,1991-1992,16,Feyenoord,FC Utrecht,0,0,3,1,1,0,0,7.0,4.0
9595,1991-1992,16,PSV,FC Groningen,2,1,1,3,0,3,1,9.0,6.0
9596,1991-1992,16,RKC Waalwijk,Willem II,1,2,2,0,3,3,-1,5.0,7.0
9597,1991-1992,16,Vitesse,FC Twente,4,1,1,3,0,5,3,8.0,10.0
9598,1991-1992,16,VVV-Venlo,AFC Ajax,0,4,2,0,3,4,-4,5.0,13.0
9599,1991-1992,16,S.V.V./Dordrecht '90,Sparta Rotterdam,0,0,3,1,1,0,0,8.0,6.0
9600,1991-1992,17,FC Twente,FC Volendam,0,1,2,0,3,1,-1,7.0,7.0
9601,1991-1992,17,AFC Ajax,S.V.V./Dordrecht '90,1,0,1,3,0,1,1,13.0,5.0
9602,1991-1992,17,Fortuna Sittard,Feyenoord,0,1,2,0,3,1,-1,4.0,9.0
9603,1991-1992,17,De Graafschap,PSV,0,2,2,0,3,2,-2,5.0,11.0
9604,1991-1992,17,FC Den Haag,VVV-Venlo,2,2,3,1,1,4,0,2.0,5.0
9605,1991-1992,17,FC Groningen,RKC Waalwijk,2,0,1,3,0,2,2,8.0,2.0
9606,1991-1992,17,FC Utrecht,MVV Maastricht,3,2,1,3,0,5,1,6.0,4.0
9607,1991-1992,17,Sparta Rotterdam,Vitesse,1,1,3,1,1,2,0,7.0,8.0
9608,1991-1992,17,Willem II,Roda JC Kerkrade,0,2,2,0,3,2,-2,6.0,8.0
9609,1991-1992,18,AFC Ajax,Vitesse,0,2,2,0,3,2,-2,10.0,11.0
9610,1991-1992,18,De Graafschap,RKC Waalwijk,2,2,3,1,1,4,0,3.0,3.0
9611,1991-1992,18,FC Den Haag,S.V.V./Dordrecht '90,0,1,2,0,3,1,-1,2.0,7.0
9612,1991-1992,18,FC Twente,Feyenoord,1,2,2,0,3,3,-1,6.0,9.0
9613,1991-1992,18,FC Utrecht,PSV,1,1,3,1,1,2,0,6.0,11.0
9614,1991-1992,18,Roda JC Kerkrade,VVV-Venlo,3,2,1,3,0,5,1,10.0,2.0
9615,1991-1992,18,Sparta Rotterdam,FC Volendam,2,1,1,3,0,3,1,7.0,7.0
9616,1991-1992,18,Fortuna Sittard,MVV Maastricht,0,0,3,1,1,0,0,5.0,4.0
9617,1991-1992,18,Willem II,FC Groningen,0,0,3,1,1,0,0,7.0,6.0
9618,1991-1992,19,MVV Maastricht,FC Twente,0,3,2,0,3,3,-3,3.0,6.0
9619,1991-1992,19,PSV,Fortuna Sittard,1,0,1,3,0,1,1,11.0,5.0
9620,1991-1992,19,S.V.V./Dordrecht '90,Roda JC Kerkrade,2,0,1,3,0,2,2,7.0,9.0
9621,1991-1992,19,VVV-Venlo,Willem II,1,2,2,0,3,3,-1,2.0,10.0
9622,1991-1992,19,FC Groningen,De Graafschap,1,0,1,3,0,1,1,8.0,3.0
9623,1991-1992,19,FC Volendam,AFC Ajax,1,4,2,0,3,5,-3,4.0,12.0
9624,1991-1992,19,Feyenoord,Sparta Rotterdam,2,0,1,3,0,2,2,11.0,6.0
9625,1991-1992,19,RKC Waalwijk,FC Utrecht,1,1,3,1,1,2,0,3.0,7.0
9626,1991-1992,19,Vitesse,FC Den Haag,2,0,1,3,0,2,2,11.0,1.0
9627,1991-1992,20,Willem II,De Graafschap,4,1,1,3,0,5,3,10.0,2.0
9628,1991-1992,20,AFC Ajax,Feyenoord,3,1,1,3,0,4,2,12.0,10.0
9629,1991-1992,20,FC Den Haag,FC Volendam,5,0,1,3,0,5,5,4.0,3.0
9630,1991-1992,20,FC Twente,PSV,0,4,2,0,3,4,-4,3.0,13.0
9631,1991-1992,20,FC Utrecht,FC Groningen,0,2,2,0,3,2,-2,6.0,10.0
9632,1991-1992,20,Sparta Rotterdam,MVV Maastricht,1,2,2,0,3,3,-1,5.0,5.0
9633,1991-1992,20,VVV-Venlo,S.V.V./Dordrecht '90,3,2,1,3,0,5,1,4.0,7.0
9634,1991-1992,20,Roda JC Kerkrade,Vitesse,1,1,3,1,1,2,0,10.0,11.0
9635,1991-1992,20,Fortuna Sittard,RKC Waalwijk,1,0,1,3,0,1,1,7.0,2.0
9636,1991-1992,21,MVV Maastricht,AFC Ajax,1,4,2,0,3,5,-3,4.0,12.0
9637,1991-1992,21,PSV,Sparta Rotterdam,4,1,1,3,0,5,3,13.0,4.0
9638,1991-1992,21,S.V.V./Dordrecht '90,Willem II,0,3,2,0,3,3,-3,6.0,10.0
9639,1991-1992,21,De Graafschap,FC Utrecht,0,0,3,1,1,0,0,2.0,6.0
9640,1991-1992,21,FC Groningen,Fortuna Sittard,2,1,1,3,0,3,1,13.0,4.0
9641,1991-1992,21,FC Volendam,Roda JC Kerkrade,3,2,1,3,0,5,1,6.0,7.0
9642,1991-1992,21,Feyenoord,FC Den Haag,3,0,1,3,0,3,3,12.0,4.0
9643,1991-1992,21,RKC Waalwijk,FC Twente,4,1,1,3,0,5,3,5.0,3.0
9644,1991-1992,21,Vitesse,VVV-Venlo,6,1,1,3,0,7,5,11.0,4.0
9645,1991-1992,22,Fortuna Sittard,De Graafschap,3,1,1,3,0,4,2,7.0,2.0
9646,1991-1992,22,Roda JC Kerkrade,Feyenoord,0,0,3,1,1,0,0,5.0,10.0
9647,1991-1992,22,VVV-Venlo,FC Volendam,0,1,2,0,3,1,-1,3.0,6.0
9648,1991-1992,22,AFC Ajax,PSV,1,0,1,3,0,1,1,12.0,10.0
9649,1991-1992,22,FC Den Haag,MVV Maastricht,1,2,2,0,3,3,-1,3.0,7.0
9650,1991-1992,22,FC Twente,FC Groningen,4,1,1,3,0,5,3,6.0,10.0
9651,1991-1992,22,Sparta Rotterdam,RKC Waalwijk,2,3,2,0,3,5,-1,3.0,8.0
9652,1991-1992,22,S.V.V./Dordrecht '90,Vitesse,0,1,2,0,3,1,-1,6.0,13.0
9653,1991-1992,22,Willem II,FC Utrecht,0,1,2,0,3,1,-1,10.0,6.0
9654,1991-1992,23,MVV Maastricht,Roda JC Kerkrade,0,2,2,0,3,2,-2,6.0,5.0
9655,1991-1992,23,De Graafschap,FC Twente,0,0,3,1,1,0,0,2.0,7.0
9656,1991-1992,23,FC Utrecht,Fortuna Sittard,1,1,3,1,1,2,0,6.0,7.0
9657,1991-1992,23,Feyenoord,VVV-Venlo,5,1,1,3,0,6,4,10.0,3.0
9658,1991-1992,23,PSV,FC Den Haag,2,1,1,3,0,3,1,12.0,3.0
9659,1991-1992,23,RKC Waalwijk,AFC Ajax,2,2,3,1,1,4,0,8.0,13.0
9660,1991-1992,23,Vitesse,Willem II,3,1,1,3,0,4,2,13.0,9.0
9661,1991-1992,23,FC Volendam,S.V.V./Dordrecht '90,2,3,2,0,3,5,-1,6.0,6.0
9662,1991-1992,23,FC Groningen,Sparta Rotterdam,1,0,1,3,0,1,1,12.0,0.0
9663,1991-1992,24,Roda JC Kerkrade,PSV,0,0,3,1,1,0,0,6.0,10.0
9664,1991-1992,24,Willem II,Fortuna Sittard,5,0,1,3,0,5,5,9.0,7.0
9665,1991-1992,24,AFC Ajax,FC Groningen,0,0,3,1,1,0,0,11.0,10.0
9666,1991-1992,24,FC Den Haag,RKC Waalwijk,0,0,3,1,1,0,0,4.0,8.0
9667,1991-1992,24,Sparta Rotterdam,De Graafschap,1,1,3,1,1,2,0,1.0,3.0
9668,1991-1992,24,S.V.V./Dordrecht '90,Feyenoord,0,1,2,0,3,1,-1,3.0,10.0
9669,1991-1992,24,Vitesse,FC Volendam,0,0,3,1,1,0,0,11.0,7.0
9670,1991-1992,24,FC Twente,FC Utrecht,2,0,1,3,0,2,2,7.0,5.0
9671,1991-1992,24,VVV-Venlo,MVV Maastricht,0,4,2,0,3,4,-4,3.0,9.0
9672,1991-1992,25,Fortuna Sittard,FC Twente,3,1,1,3,0,4,2,7.0,7.0
9673,1991-1992,25,MVV Maastricht,S.V.V./Dordrecht '90,3,1,1,3,0,4,2,9.0,3.0
9674,1991-1992,25,PSV,VVV-Venlo,4,0,1,3,0,4,4,10.0,0.0
9675,1991-1992,25,De Graafschap,AFC Ajax,0,1,2,0,3,1,-1,3.0,11.0
9676,1991-1992,25,FC Groningen,FC Den Haag,3,1,1,3,0,4,2,10.0,1.0
9677,1991-1992,25,FC Utrecht,Sparta Rotterdam,1,1,3,1,1,2,0,6.0,2.0
9678,1991-1992,25,FC Volendam,Willem II,0,0,3,1,1,0,0,8.0,7.0
9679,1991-1992,25,Feyenoord,Vitesse,5,0,1,3,0,5,5,13.0,10.0
9680,1991-1992,25,RKC Waalwijk,Roda JC Kerkrade,0,1,2,0,3,1,-1,8.0,8.0
9681,1991-1992,26,Roda JC Kerkrade,FC Groningen,0,0,3,1,1,0,0,9.0,8.0
9682,1991-1992,26,VVV-Venlo,RKC Waalwijk,0,0,3,1,1,0,0,1.0,6.0
9683,1991-1992,26,Willem II,FC Twente,3,1,1,3,0,4,2,7.0,7.0
9684,1991-1992,26,AFC Ajax,FC Utrecht,1,0,1,3,0,1,1,11.0,5.0
9685,1991-1992,26,FC Den Haag,De Graafschap,4,0,1,3,0,4,4,4.0,2.0
9686,1991-1992,26,FC Volendam,Feyenoord,0,1,2,0,3,1,-1,5.0,13.0
9687,1991-1992,26,Sparta Rotterdam,Fortuna Sittard,3,2,1,3,0,5,1,5.0,7.0
9688,1991-1992,26,S.V.V./Dordrecht '90,PSV,1,2,2,0,3,3,-1,3.0,10.0
9689,1991-1992,26,Vitesse,MVV Maastricht,1,2,2,0,3,3,-1,7.0,12.0
9690,1991-1992,27,Fortuna Sittard,AFC Ajax,0,1,2,0,3,1,-1,4.0,11.0
9691,1991-1992,27,De Graafschap,Roda JC Kerkrade,3,2,1,3,0,5,1,5.0,8.0
9692,1991-1992,27,MVV Maastricht,FC Volendam,1,2,2,0,3,3,-1,9.0,5.0
9693,1991-1992,27,PSV,Vitesse,2,0,1,3,0,2,2,13.0,4.0
9694,1991-1992,27,FC Groningen,VVV-Venlo,3,2,1,3,0,5,1,11.0,1.0
9695,1991-1992,27,FC Twente,Sparta Rotterdam,4,0,1,3,0,4,4,7.0,5.0
9696,1991-1992,27,FC Utrecht,FC Den Haag,4,1,1,3,0,5,3,5.0,4.0
9697,1991-1992,27,RKC Waalwijk,S.V.V./Dordrecht '90,2,0,1,3,0,2,2,6.0,3.0
9698,1991-1992,27,Feyenoord,Willem II,3,1,1,3,0,4,2,15.0,7.0
9699,1991-1992,28,AFC Ajax,FC Twente,7,0,1,3,0,7,7,13.0,6.0
9700,1991-1992,28,Feyenoord,MVV Maastricht,0,1,2,0,3,1,-1,12.0,12.0
9701,1991-1992,28,VVV-Venlo,De Graafschap,1,2,2,0,3,3,-1,1.0,7.0
9702,1991-1992,28,Willem II,Sparta Rotterdam,0,2,2,0,3,2,-2,7.0,8.0
9703,1991-1992,28,FC Den Haag,Fortuna Sittard,1,0,1,3,0,1,1,7.0,3.0
9704,1991-1992,28,FC Volendam,PSV,0,3,2,0,3,3,-3,5.0,13.0
9705,1991-1992,28,S.V.V./Dordrecht '90,FC Groningen,0,1,2,0,3,1,-1,0.0,11.0
9706,1991-1992,28,Vitesse,RKC Waalwijk,0,1,2,0,3,1,-1,1.0,8.0
9707,1991-1992,28,Roda JC Kerkrade,FC Utrecht,2,0,1,3,0,2,2,8.0,4.0
9708,1991-1992,29,Fortuna Sittard,Roda JC Kerkrade,0,1,2,0,3,1,-1,3.0,10.0
9709,1991-1992,29,De Graafschap,S.V.V./Dordrecht '90,0,0,3,1,1,0,0,7.0,1.0
9710,1991-1992,29,MVV Maastricht,Willem II,1,1,3,1,1,2,0,10.0,5.0
9711,1991-1992,29,FC Groningen,Vitesse,1,2,2,0,3,3,-1,10.0,3.0
9712,1991-1992,29,FC Twente,FC Den Haag,0,0,3,1,1,0,0,4.0,7.0
9713,1991-1992,29,FC Utrecht,VVV-Venlo,3,1,1,3,0,4,2,7.0,1.0
9714,1991-1992,29,PSV,Feyenoord,2,1,1,3,0,3,1,15.0,9.0
9715,1991-1992,29,RKC Waalwijk,FC Volendam,2,1,1,3,0,3,1,10.0,4.0
9716,1991-1992,29,Sparta Rotterdam,AFC Ajax,1,3,2,0,3,4,-2,7.0,15.0
9717,1991-1992,30,MVV Maastricht,PSV,1,1,3,1,1,2,0,8.0,13.0
9718,1991-1992,30,Roda JC Kerkrade,FC Twente,1,1,3,1,1,2,0,8.0,5.0
9719,1991-1992,30,Feyenoord,RKC Waalwijk,0,0,3,1,1,0,0,7.0,11.0
9720,1991-1992,30,VVV-Venlo,Fortuna Sittard,1,4,2,0,3,5,-3,1.0,3.0
9721,1991-1992,30,FC Den Haag,Sparta Rotterdam,0,0,3,1,1,0,0,8.0,7.0
9722,1991-1992,30,FC Volendam,FC Groningen,2,0,1,3,0,2,2,6.0,7.0
9723,1991-1992,30,S.V.V./Dordrecht '90,FC Utrecht,1,2,2,0,3,3,-1,1.0,9.0
9724,1991-1992,30,Vitesse,De Graafschap,1,0,1,3,0,1,1,6.0,7.0
9725,1991-1992,30,Willem II,AFC Ajax,2,4,2,0,3,6,-2,4.0,15.0
9726,1991-1992,31,De Graafschap,FC Volendam,3,0,1,3,0,3,3,10.0,6.0
9727,1991-1992,31,Fortuna Sittard,S.V.V./Dordrecht '90,0,0,3,1,1,0,0,4.0,2.0
9728,1991-1992,31,PSV,Willem II,3,0,1,3,0,3,3,13.0,1.0
9729,1991-1992,31,AFC Ajax,FC Den Haag,3,2,1,3,0,5,1,15.0,5.0
9730,1991-1992,31,FC Groningen,Feyenoord,1,0,1,3,0,1,1,9.0,4.0
9731,1991-1992,31,FC Twente,VVV-Venlo,2,1,1,3,0,3,1,8.0,0.0
9732,1991-1992,31,FC Utrecht,Vitesse,1,1,3,1,1,2,0,10.0,7.0
9733,1991-1992,31,RKC Waalwijk,MVV Maastricht,1,1,3,1,1,2,0,11.0,6.0
9734,1991-1992,31,Sparta Rotterdam,Roda JC Kerkrade,4,0,1,3,0,4,4,7.0,7.0
9735,1991-1992,32,FC Volendam,FC Utrecht,4,2,1,3,0,6,2,6.0,7.0
9736,1991-1992,32,Willem II,FC Den Haag,2,0,1,3,0,2,2,4.0,5.0
9737,1991-1992,32,VVV-Venlo,Sparta Rotterdam,1,3,2,0,3,4,-2,0.0,10.0
9738,1991-1992,32,MVV Maastricht,FC Groningen,3,3,3,1,1,6,0,7.0,7.0
9739,1991-1992,32,PSV,RKC Waalwijk,5,0,1,3,0,5,5,13.0,8.0
9740,1991-1992,32,S.V.V./Dordrecht '90,FC Twente,1,0,1,3,0,1,1,5.0,5.0
9741,1991-1992,32,Feyenoord,De Graafschap,3,0,1,3,0,3,3,4.0,7.0
9742,1991-1992,32,Vitesse,Fortuna Sittard,0,1,2,0,3,1,-1,7.0,7.0
9743,1991-1992,32,Roda JC Kerkrade,AFC Ajax,0,3,2,0,3,3,-3,7.0,15.0
9744,1991-1992,33,AFC Ajax,VVV-Venlo,3,1,1,3,0,4,2,15.0,0.0
9745,1991-1992,33,De Graafschap,MVV Maastricht,1,1,3,1,1,2,0,5.0,5.0
9746,1991-1992,33,FC Den Haag,Roda JC Kerkrade,5,3,1,3,0,8,2,5.0,4.0
9747,1991-1992,33,FC Groningen,PSV,0,3,2,0,3,3,-3,4.0,13.0
9748,1991-1992,33,FC Twente,Vitesse,1,2,2,0,3,3,-1,5.0,10.0
9749,1991-1992,33,FC Utrecht,Feyenoord,0,0,3,1,1,0,0,8.0,5.0
9750,1991-1992,33,Fortuna Sittard,FC Volendam,4,1,1,3,0,5,3,10.0,6.0
9751,1991-1992,33,Sparta Rotterdam,S.V.V./Dordrecht '90,1,1,3,1,1,2,0,8.0,6.0
9752,1991-1992,33,Willem II,RKC Waalwijk,3,1,1,3,0,4,2,7.0,5.0
9753,1991-1992,34,FC Volendam,FC Twente,0,0,3,1,1,0,0,7.0,5.0
9754,1991-1992,34,Feyenoord,Fortuna Sittard,3,0,1,3,0,3,3,8.0,10.0
9755,1991-1992,34,MVV Maastricht,FC Utrecht,3,1,1,3,0,4,2,7.0,5.0
9756,1991-1992,34,PSV,De Graafschap,5,0,1,3,0,5,5,13.0,4.0
9757,1991-1992,34,RKC Waalwijk,FC Groningen,0,0,3,1,1,0,0,3.0,5.0
9758,1991-1992,34,Roda JC Kerkrade,Willem II,0,0,3,1,1,0,0,2.0,7.0
9759,1991-1992,34,S.V.V./Dordrecht '90,AFC Ajax,0,5,2,0,3,5,-5,5.0,15.0
9760,1991-1992,34,Vitesse,Sparta Rotterdam,1,1,3,1,1,2,0,8.0,9.0
9761,1991-1992,34,VVV-Venlo,FC Den Haag,2,1,1,3,0,3,1,3.0,4.0
9762,1992-1993,1,Fortuna Sittard,MVV Maastricht,1,1,3,1,1,2,0,8.0,7.0
9763,1992-1993,1,Go Ahead Eagles,SC Cambuur,1,1,3,1,1,2,0,3.0,
9764,1992-1993,1,PSV,Roda JC Kerkrade,2,0,1,3,0,2,2,15.0,1.0
9765,1992-1993,1,S.V.V./Dordrecht '90,AFC Ajax,0,3,2,0,3,3,-3,5.0,15.0
9766,1992-1993,1,FC Groningen,Willem II,1,1,3,1,1,2,0,6.0,8.0
9767,1992-1993,1,FC Twente,Feyenoord,0,5,2,0,3,5,-5,4.0,10.0
9768,1992-1993,1,FC Utrecht,FC Den Bosch,1,1,3,1,1,2,0,3.0,
9769,1992-1993,1,FC Volendam,Vitesse,1,1,3,1,1,2,0,5.0,6.0
9770,1992-1993,1,Sparta Rotterdam,RKC Waalwijk,0,0,3,1,1,0,0,9.0,3.0
9771,1992-1993,2,SC Cambuur,Sparta Rotterdam,0,0,3,1,1,0,0,,7.0
9772,1992-1993,2,FC Den Bosch,S.V.V./Dordrecht '90,2,0,1,3,0,2,2,,4.0
9773,1992-1993,2,MVV Maastricht,FC Utrecht,0,3,2,0,3,3,-3,6.0,5.0
9774,1992-1993,2,Willem II,FC Twente,0,1,2,0,3,1,-1,8.0,4.0
9775,1992-1993,2,AFC Ajax,Go Ahead Eagles,3,1,1,3,0,4,2,15.0,3.0
9776,1992-1993,2,Feyenoord,Fortuna Sittard,4,1,1,3,0,5,3,13.0,7.0
9777,1992-1993,2,Roda JC Kerkrade,FC Volendam,1,0,1,3,0,1,1,4.0,5.0
9778,1992-1993,2,Vitesse,FC Groningen,0,0,3,1,1,0,0,6.0,4.0
9779,1992-1993,2,RKC Waalwijk,PSV,0,3,2,0,3,3,-3,2.0,15.0
9780,1992-1993,3,Roda JC Kerkrade,Vitesse,0,2,2,0,3,2,-2,4.0,9.0
9781,1992-1993,3,S.V.V./Dordrecht '90,MVV Maastricht,2,2,3,1,1,4,0,2.0,6.0
9782,1992-1993,3,Fortuna Sittard,Willem II,0,1,2,0,3,1,-1,4.0,8.0
9783,1992-1993,3,Go Ahead Eagles,FC Den Bosch,2,0,1,3,0,2,2,5.0,
9784,1992-1993,3,FC Twente,FC Groningen,5,0,1,3,0,5,5,7.0,3.0
9785,1992-1993,3,FC Utrecht,Feyenoord,0,0,3,1,1,0,0,6.0,11.0
9786,1992-1993,3,FC Volendam,RKC Waalwijk,0,2,2,0,3,2,-2,2.0,5.0
9787,1992-1993,3,Sparta Rotterdam,AFC Ajax,0,0,3,1,1,0,0,5.0,13.0
9788,1992-1993,3,PSV,SC Cambuur,3,0,1,3,0,3,3,15.0,
9789,1992-1993,4,FC Den Bosch,Sparta Rotterdam,1,1,3,1,1,2,0,,5.0
9790,1992-1993,4,SC Cambuur,FC Volendam,0,0,3,1,1,0,0,,3.0
9791,1992-1993,4,MVV Maastricht,Go Ahead Eagles,3,0,1,3,0,3,3,8.0,4.0
9792,1992-1993,4,Willem II,FC Utrecht,1,2,2,0,3,3,-1,5.0,8.0
9793,1992-1993,4,AFC Ajax,PSV,1,2,2,0,3,3,-1,10.0,15.0
9794,1992-1993,4,FC Groningen,Fortuna Sittard,2,1,1,3,0,3,1,6.0,1.0
9795,1992-1993,4,Feyenoord,S.V.V./Dordrecht '90,3,0,1,3,0,3,3,13.0,1.0
9796,1992-1993,4,RKC Waalwijk,Roda JC Kerkrade,1,4,2,0,3,5,-3,5.0,7.0
9797,1992-1993,4,Vitesse,FC Twente,0,1,2,0,3,1,-1,6.0,10.0
9798,1992-1993,5,Fortuna Sittard,FC Twente,0,2,2,0,3,2,-2,1.0,12.0
9799,1992-1993,5,Dordrecht '90,Willem II,0,2,2,0,3,2,-2,,7.0
9800,1992-1993,5,PSV,FC Den Bosch,7,0,1,3,0,7,7,15.0,5.0
9801,1992-1993,5,FC Utrecht,FC Groningen,1,0,1,3,0,1,1,11.0,5.0
9802,1992-1993,5,Go Ahead Eagles,Feyenoord,1,1,3,1,1,2,0,5.0,11.0
9803,1992-1993,5,RKC Waalwijk,Vitesse,0,0,3,1,1,0,0,5.0,6.0
9804,1992-1993,5,Sparta Rotterdam,MVV Maastricht,0,0,3,1,1,0,0,5.0,6.0
9805,1992-1993,5,Roda JC Kerkrade,SC Cambuur,3,2,1,3,0,5,1,9.0,3.0
9806,1992-1993,5,AFC Ajax,FC Volendam,1,1,3,1,1,2,0,8.0,3.0
9807,1992-1993,6,SC Cambuur,RKC Waalwijk,0,2,2,0,3,2,-2,2.0,7.0
9808,1992-1993,6,FC Den Bosch,FC Volendam,0,5,2,0,3,5,-5,4.0,5.0
9809,1992-1993,6,MVV Maastricht,PSV,1,5,2,0,3,6,-4,5.0,15.0
9810,1992-1993,6,Vitesse,Fortuna Sittard,5,0,1,3,0,5,5,8.0,0.0
9811,1992-1993,6,Willem II,Go Ahead Eagles,2,1,1,3,0,3,1,9.0,4.0
9812,1992-1993,6,AFC Ajax,Roda JC Kerkrade,4,2,1,3,0,6,2,8.0,9.0
9813,1992-1993,6,FC Groningen,Dordrecht '90,3,0,1,3,0,3,3,7.0,
9814,1992-1993,6,FC Twente,FC Utrecht,5,1,1,3,0,6,4,15.0,10.0
9815,1992-1993,6,Feyenoord,Sparta Rotterdam,2,2,3,1,1,4,0,9.0,5.0
9816,1992-1993,7,Roda JC Kerkrade,FC Den Bosch,4,1,1,3,0,5,3,9.0,1.0
9817,1992-1993,7,SC Cambuur,Vitesse,1,3,2,0,3,4,-2,1.0,10.0
9818,1992-1993,7,Dordrecht '90,FC Twente,0,0,3,1,1,0,0,,13.0
9819,1992-1993,7,FC Utrecht,Fortuna Sittard,4,0,1,3,0,4,4,10.0,0.0
9820,1992-1993,7,FC Volendam,MVV Maastricht,1,2,2,0,3,3,-1,5.0,8.0
9821,1992-1993,7,Go Ahead Eagles,FC Groningen,0,0,3,1,1,0,0,5.0,7.0
9822,1992-1993,7,PSV,Feyenoord,1,1,3,1,1,2,0,13.0,7.0
9823,1992-1993,7,RKC Waalwijk,AFC Ajax,0,5,2,0,3,5,-5,7.0,8.0
9824,1992-1993,7,Sparta Rotterdam,Willem II,1,0,1,3,0,1,1,7.0,9.0
9825,1992-1993,8,FC Den Bosch,RKC Waalwijk,1,3,2,0,3,4,-2,1.0,7.0
9826,1992-1993,8,Fortuna Sittard,Dordrecht '90,0,2,2,0,3,2,-2,0.0,
9827,1992-1993,8,MVV Maastricht,Roda JC Kerkrade,2,1,1,3,0,3,1,10.0,9.0
9828,1992-1993,8,AFC Ajax,SC Cambuur,3,1,1,3,0,4,2,10.0,1.0
9829,1992-1993,8,FC Groningen,Sparta Rotterdam,1,2,2,0,3,3,-1,7.0,9.0
9830,1992-1993,8,FC Twente,Go Ahead Eagles,4,0,1,3,0,4,4,13.0,2.0
9831,1992-1993,8,Feyenoord,FC Volendam,2,0,1,3,0,2,2,9.0,5.0
9832,1992-1993,8,Vitesse,FC Utrecht,1,1,3,1,1,2,0,8.0,10.0
9833,1992-1993,8,Willem II,PSV,1,1,3,1,1,2,0,7.0,11.0
9834,1992-1993,9,SC Cambuur,FC Den Bosch,2,1,1,3,0,3,1,3.0,0.0
9835,1992-1993,9,Go Ahead Eagles,Fortuna Sittard,4,2,1,3,0,6,2,5.0,0.0
9836,1992-1993,9,PSV,FC Groningen,3,0,1,3,0,3,3,11.0,4.0
9837,1992-1993,9,RKC Waalwijk,MVV Maastricht,0,3,2,0,3,3,-3,7.0,10.0
9838,1992-1993,9,Dordrecht '90,FC Utrecht,0,2,2,0,3,2,-2,4.0,10.0
9839,1992-1993,9,FC Volendam,Willem II,5,1,1,3,0,6,4,7.0,7.0
9840,1992-1993,9,Roda JC Kerkrade,Feyenoord,1,2,2,0,3,3,-1,6.0,9.0
9841,1992-1993,9,AFC Ajax,Vitesse,4,0,1,3,0,4,4,13.0,8.0
9842,1992-1993,9,Sparta Rotterdam,FC Twente,2,3,2,0,3,5,-1,8.0,13.0
9843,1992-1993,10,Fortuna Sittard,Sparta Rotterdam,1,0,1,3,0,1,1,3.0,7.0
9844,1992-1993,10,MVV Maastricht,SC Cambuur,1,3,2,0,3,4,-2,9.0,6.0
9845,1992-1993,10,Vitesse,Dordrecht '90,3,0,1,3,0,3,3,10.0,4.0
9846,1992-1993,10,Willem II,Roda JC Kerkrade,1,0,1,3,0,1,1,7.0,3.0
9847,1992-1993,10,FC Den Bosch,AFC Ajax,2,2,3,1,1,4,0,1.0,13.0
9848,1992-1993,10,FC Groningen,FC Volendam,2,1,1,3,0,3,1,7.0,6.0
9849,1992-1993,10,FC Twente,PSV,1,2,2,0,3,3,-1,10.0,11.0
9850,1992-1993,10,FC Utrecht,Go Ahead Eagles,0,2,2,0,3,2,-2,7.0,7.0
9851,1992-1993,10,Feyenoord,RKC Waalwijk,4,1,1,3,0,5,3,11.0,6.0
9852,1992-1993,11,Roda JC Kerkrade,FC Groningen,4,2,1,3,0,6,2,6.0,4.0
9853,1992-1993,11,FC Den Bosch,Vitesse,0,0,3,1,1,0,0,2.0,8.0
9854,1992-1993,11,Go Ahead Eagles,Dordrecht '90,2,1,1,3,0,3,1,10.0,4.0
9855,1992-1993,11,PSV,Fortuna Sittard,5,0,1,3,0,5,5,11.0,3.0
9856,1992-1993,11,AFC Ajax,MVV Maastricht,2,2,3,1,1,4,0,11.0,10.0
9857,1992-1993,11,SC Cambuur,Feyenoord,0,1,2,0,3,1,-1,6.0,13.0
9858,1992-1993,11,FC Volendam,FC Twente,1,1,3,1,1,2,0,4.0,8.0
9859,1992-1993,11,RKC Waalwijk,Willem II,0,0,3,1,1,0,0,4.0,5.0
9860,1992-1993,11,Sparta Rotterdam,FC Utrecht,1,3,2,0,3,4,-2,6.0,10.0
9861,1992-1993,12,Dordrecht '90,Sparta Rotterdam,0,0,3,1,1,0,0,4.0,4.0
9862,1992-1993,12,Fortuna Sittard,FC Volendam,0,0,3,1,1,0,0,4.0,5.0
9863,1992-1993,12,MVV Maastricht,FC Den Bosch,2,1,1,3,0,3,1,10.0,2.0
9864,1992-1993,12,Willem II,SC Cambuur,4,0,1,3,0,4,4,8.0,6.0
9865,1992-1993,12,FC Groningen,RKC Waalwijk,2,2,3,1,1,4,0,4.0,5.0
9866,1992-1993,12,FC Twente,Roda JC Kerkrade,4,0,1,3,0,4,4,10.0,3.0
9867,1992-1993,12,FC Utrecht,PSV,2,0,1,3,0,2,2,10.0,10.0
9868,1992-1993,12,Feyenoord,AFC Ajax,0,3,2,0,3,3,-3,12.0,11.0
9869,1992-1993,12,Vitesse,Go Ahead Eagles,2,2,3,1,1,4,0,6.0,10.0
9870,1992-1993,13,MVV Maastricht,Vitesse,1,0,1,3,0,1,1,10.0,5.0
9871,1992-1993,13,AFC Ajax,Willem II,0,0,3,1,1,0,0,9.0,8.0
9872,1992-1993,13,PSV,Dordrecht '90,4,1,1,3,0,5,3,12.0,1.0
9873,1992-1993,13,SC Cambuur,FC Groningen,0,0,3,1,1,0,0,7.0,5.0
9874,1992-1993,13,FC Den Bosch,Feyenoord,1,5,2,0,3,6,-4,2.0,12.0
9875,1992-1993,13,FC Volendam,FC Utrecht,2,2,3,1,1,4,0,6.0,10.0
9876,1992-1993,13,RKC Waalwijk,FC Twente,2,1,1,3,0,3,1,5.0,7.0
9877,1992-1993,13,Roda JC Kerkrade,Fortuna Sittard,4,1,1,3,0,5,3,6.0,4.0
9878,1992-1993,13,Sparta Rotterdam,Go Ahead Eagles,6,4,1,3,0,10,2,4.0,10.0
9879,1992-1993,14,Dordrecht '90,FC Volendam,0,4,2,0,3,4,-4,1.0,6.0
9880,1992-1993,14,Fortuna Sittard,RKC Waalwijk,4,1,1,3,0,5,3,7.0,5.0
9881,1992-1993,14,Go Ahead Eagles,PSV,0,3,2,0,3,3,-3,7.0,12.0
9882,1992-1993,14,Willem II,FC Den Bosch,1,1,3,1,1,2,0,9.0,3.0
9883,1992-1993,14,FC Groningen,AFC Ajax,0,3,2,0,3,3,-3,5.0,9.0
9884,1992-1993,14,FC Twente,SC Cambuur,1,1,3,1,1,2,0,5.0,5.0
9885,1992-1993,14,FC Utrecht,Roda JC Kerkrade,2,1,1,3,0,3,1,10.0,6.0
9886,1992-1993,14,Feyenoord,MVV Maastricht,3,4,2,0,3,7,-1,9.0,10.0
9887,1992-1993,14,Vitesse,Sparta Rotterdam,3,2,1,3,0,5,1,8.0,4.0
9888,1992-1993,15,AFC Ajax,FC Twente,0,1,2,0,3,1,-1,8.0,8.0
9889,1992-1993,15,FC Den Bosch,FC Groningen,0,2,2,0,3,2,-2,2.0,5.0
9890,1992-1993,15,FC Volendam,Go Ahead Eagles,1,0,1,3,0,1,1,9.0,4.0
9891,1992-1993,15,Feyenoord,Vitesse,2,2,3,1,1,4,0,7.0,6.0
9892,1992-1993,15,MVV Maastricht,Willem II,2,0,1,3,0,2,2,13.0,6.0
9893,1992-1993,15,Roda JC Kerkrade,Dordrecht '90,1,3,2,0,3,4,-2,6.0,4.0
9894,1992-1993,15,SC Cambuur,Fortuna Sittard,1,3,2,0,3,4,-2,2.0,7.0
9895,1992-1993,15,RKC Waalwijk,FC Utrecht,2,4,2,0,3,6,-2,5.0,13.0
9896,1992-1993,15,PSV,Sparta Rotterdam,3,1,1,3,0,4,2,12.0,4.0
9897,1992-1993,16,Go Ahead Eagles,Roda JC Kerkrade,2,0,1,3,0,2,2,4.0,3.0
9898,1992-1993,16,PSV,Vitesse,1,0,1,3,0,1,1,12.0,5.0
9899,1992-1993,16,FC Groningen,MVV Maastricht,2,1,1,3,0,3,1,8.0,12.0
9900,1992-1993,16,FC Utrecht,SC Cambuur,1,1,3,1,1,2,0,11.0,3.0
9901,1992-1993,16,Sparta Rotterdam,FC Volendam,0,2,2,0,3,2,-2,4.0,11.0
9902,1992-1993,16,Willem II,Feyenoord,0,2,2,0,3,2,-2,5.0,7.0
9903,1992-1993,16,Dordrecht '90,RKC Waalwijk,0,1,2,0,3,1,-1,4.0,7.0
9904,1992-1993,16,FC Twente,FC Den Bosch,5,0,1,3,0,5,5,10.0,1.0
9905,1992-1993,16,Fortuna Sittard,AFC Ajax,1,4,2,0,3,5,-3,7.0,10.0
9906,1992-1993,17,SC Cambuur,Dordrecht '90,5,0,1,3,0,5,5,6.0,3.0
9907,1992-1993,17,FC Den Bosch,Fortuna Sittard,1,2,2,0,3,3,-1,1.0,9.0
9908,1992-1993,17,MVV Maastricht,FC Twente,2,0,1,3,0,2,2,12.0,7.0
9909,1992-1993,17,AFC Ajax,FC Utrecht,1,1,3,1,1,2,0,8.0,9.0
9910,1992-1993,17,FC Volendam,PSV,3,1,1,3,0,4,2,13.0,12.0
9911,1992-1993,17,Feyenoord,FC Groningen,3,1,1,3,0,4,2,10.0,7.0
9912,1992-1993,17,RKC Waalwijk,Go Ahead Eagles,2,1,1,3,0,3,1,9.0,3.0
9913,1992-1993,17,Roda JC Kerkrade,Sparta Rotterdam,1,2,2,0,3,3,-1,3.0,6.0
9914,1992-1993,17,Vitesse,Willem II,2,0,1,3,0,2,2,7.0,2.0
9915,1992-1993,18,SC Cambuur,Go Ahead Eagles,1,1,3,1,1,2,0,6.0,4.0
9916,1992-1993,18,FC Den Bosch,FC Utrecht,2,0,1,3,0,2,2,4.0,8.0
9917,1992-1993,18,Willem II,FC Groningen,1,1,3,1,1,2,0,2.0,7.0
9918,1992-1993,18,AFC Ajax,Dordrecht '90,4,1,1,3,0,5,3,10.0,3.0
9919,1992-1993,18,Feyenoord,FC Twente,1,1,3,1,1,2,0,8.0,8.0
9920,1992-1993,18,MVV Maastricht,Fortuna Sittard,5,0,1,3,0,5,5,12.0,9.0
9921,1992-1993,18,RKC Waalwijk,Sparta Rotterdam,4,0,1,3,0,4,4,9.0,3.0
9922,1992-1993,18,Vitesse,FC Volendam,0,0,3,1,1,0,0,8.0,13.0
9923,1992-1993,18,Roda JC Kerkrade,PSV,2,0,1,3,0,2,2,3.0,9.0
9924,1992-1993,19,Fortuna Sittard,Feyenoord,0,1,2,0,3,1,-1,6.0,11.0
9925,1992-1993,19,Dordrecht '90,FC Den Bosch,1,1,3,1,1,2,0,4.0,4.0
9926,1992-1993,19,PSV,RKC Waalwijk,0,3,2,0,3,3,-3,6.0,12.0
9927,1992-1993,19,FC Utrecht,MVV Maastricht,0,1,2,0,3,1,-1,5.0,12.0
9928,1992-1993,19,FC Volendam,Roda JC Kerkrade,0,0,3,1,1,0,0,11.0,4.0
9929,1992-1993,19,Go Ahead Eagles,AFC Ajax,0,6,2,0,3,6,-6,4.0,10.0
9930,1992-1993,19,Sparta Rotterdam,SC Cambuur,2,2,3,1,1,4,0,4.0,6.0
9931,1992-1993,19,FC Twente,Willem II,1,0,1,3,0,1,1,10.0,1.0
9932,1992-1993,19,FC Groningen,Vitesse,0,1,2,0,3,1,-1,7.0,8.0
9933,1992-1993,20,FC Den Bosch,Go Ahead Eagles,0,1,2,0,3,1,-1,4.0,7.0
9934,1992-1993,20,SC Cambuur,PSV,0,1,2,0,3,1,-1,6.0,6.0
9935,1992-1993,20,MVV Maastricht,Dordrecht '90,1,0,1,3,0,1,1,12.0,1.0
9936,1992-1993,20,Willem II,Fortuna Sittard,2,0,1,3,0,2,2,4.0,3.0
9937,1992-1993,20,AFC Ajax,Sparta Rotterdam,6,0,1,3,0,6,6,13.0,4.0
9938,1992-1993,20,FC Groningen,FC Twente,1,1,3,1,1,2,0,5.0,8.0
9939,1992-1993,20,Feyenoord,FC Utrecht,0,0,3,1,1,0,0,11.0,3.0
9940,1992-1993,20,RKC Waalwijk,FC Volendam,2,3,2,0,3,5,-1,12.0,11.0
9941,1992-1993,20,Vitesse,Roda JC Kerkrade,6,1,1,3,0,7,5,10.0,4.0
9942,1992-1993,21,Dordrecht '90,Feyenoord,1,5,2,0,3,6,-4,1.0,11.0
9943,1992-1993,21,FC Twente,Vitesse,0,0,3,1,1,0,0,6.0,11.0
9944,1992-1993,21,FC Utrecht,Willem II,0,1,2,0,3,1,-1,2.0,7.0
9945,1992-1993,21,FC Volendam,SC Cambuur,0,0,3,1,1,0,0,9.0,6.0
9946,1992-1993,21,Go Ahead Eagles,MVV Maastricht,1,2,2,0,3,3,-1,4.0,15.0
9947,1992-1993,21,PSV,AFC Ajax,2,1,1,3,0,3,1,6.0,10.0
9948,1992-1993,21,Roda JC Kerkrade,RKC Waalwijk,1,1,3,1,1,2,0,5.0,10.0
9949,1992-1993,21,Sparta Rotterdam,FC Den Bosch,2,0,1,3,0,2,2,7.0,4.0
9950,1992-1993,21,Fortuna Sittard,FC Groningen,1,1,3,1,1,2,0,4.0,3.0
9951,1992-1993,22,SC Cambuur,Roda JC Kerkrade,1,1,3,1,1,2,0,4.0,6.0
9952,1992-1993,22,Feyenoord,Go Ahead Eagles,4,2,1,3,0,6,2,11.0,4.0
9953,1992-1993,22,MVV Maastricht,Sparta Rotterdam,0,2,2,0,3,2,-2,12.0,7.0
9954,1992-1993,22,Willem II,Dordrecht '90,5,0,1,3,0,5,5,10.0,1.0
9955,1992-1993,22,FC Den Bosch,PSV,2,2,3,1,1,4,0,5.0,7.0
9956,1992-1993,22,FC Twente,Fortuna Sittard,4,1,1,3,0,5,3,9.0,1.0
9957,1992-1993,22,Vitesse,RKC Waalwijk,2,2,3,1,1,4,0,9.0,8.0
9958,1992-1993,22,FC Volendam,AFC Ajax,0,0,3,1,1,0,0,7.0,10.0
9959,1992-1993,22,FC Groningen,FC Utrecht,2,1,1,3,0,3,1,6.0,1.0
9960,1992-1993,23,Fortuna Sittard,Vitesse,1,2,2,0,3,3,-1,1.0,11.0
9961,1992-1993,23,Dordrecht '90,FC Groningen,0,0,3,1,1,0,0,2.0,6.0
9962,1992-1993,23,Go Ahead Eagles,Willem II,0,0,3,1,1,0,0,4.0,10.0
9963,1992-1993,23,PSV,MVV Maastricht,2,1,1,3,0,3,1,10.0,9.0
9964,1992-1993,23,FC Utrecht,FC Twente,0,1,2,0,3,1,-1,1.0,11.0
9965,1992-1993,23,RKC Waalwijk,SC Cambuur,2,2,3,1,1,4,0,6.0,4.0
9966,1992-1993,23,Sparta Rotterdam,Feyenoord,0,2,2,0,3,2,-2,7.0,13.0
9967,1992-1993,23,FC Volendam,FC Den Bosch,3,0,1,3,0,3,3,9.0,2.0
9968,1992-1993,23,Roda JC Kerkrade,AFC Ajax,1,3,2,0,3,4,-2,3.0,10.0
9969,1992-1993,24,AFC Ajax,RKC Waalwijk,2,1,1,3,0,3,1,10.0,3.0
9970,1992-1993,24,FC Den Bosch,Roda JC Kerkrade,4,3,1,3,0,7,1,4.0,2.0
9971,1992-1993,24,Feyenoord,PSV,1,1,3,1,1,2,0,11.0,11.0
9972,1992-1993,24,Fortuna Sittard,FC Utrecht,1,1,3,1,1,2,0,2.0,2.0
9973,1992-1993,24,MVV Maastricht,FC Volendam,0,1,2,0,3,1,-1,6.0,11.0
9974,1992-1993,24,Willem II,Sparta Rotterdam,5,0,1,3,0,5,5,13.0,6.0
9975,1992-1993,24,FC Groningen,Go Ahead Eagles,2,1,1,3,0,3,1,9.0,4.0
9976,1992-1993,24,FC Twente,Dordrecht '90,2,3,2,0,3,5,-1,8.0,4.0
9977,1992-1993,24,Vitesse,SC Cambuur,1,1,3,1,1,2,0,9.0,4.0
9978,1992-1993,25,Dordrecht '90,Fortuna Sittard,1,2,2,0,3,3,-1,4.0,5.0
9979,1992-1993,25,PSV,Willem II,1,1,3,1,1,2,0,9.0,11.0
9980,1992-1993,25,Roda JC Kerkrade,MVV Maastricht,0,0,3,1,1,0,0,3.0,4.0
9981,1992-1993,25,SC Cambuur,AFC Ajax,1,3,2,0,3,4,-2,4.0,10.0
9982,1992-1993,25,FC Utrecht,Vitesse,0,3,2,0,3,3,-3,1.0,9.0
9983,1992-1993,25,FC Volendam,Feyenoord,1,2,2,0,3,3,-1,8.0,13.0
9984,1992-1993,25,Go Ahead Eagles,FC Twente,2,1,1,3,0,3,1,4.0,7.0
9985,1992-1993,25,RKC Waalwijk,FC Den Bosch,4,2,1,3,0,6,2,6.0,4.0
9986,1992-1993,25,Sparta Rotterdam,FC Groningen,1,0,1,3,0,1,1,9.0,8.0
9987,1992-1993,26,FC Den Bosch,SC Cambuur,3,2,1,3,0,5,1,7.0,3.0
9988,1992-1993,26,Fortuna Sittard,Go Ahead Eagles,3,1,1,3,0,4,2,7.0,4.0
9989,1992-1993,26,MVV Maastricht,RKC Waalwijk,1,1,3,1,1,2,0,2.0,6.0
9990,1992-1993,26,Willem II,FC Volendam,1,3,2,0,3,4,-2,8.0,10.0
9991,1992-1993,26,FC Groningen,PSV,0,1,2,0,3,1,-1,7.0,9.0
9992,1992-1993,26,FC Twente,Sparta Rotterdam,5,0,1,3,0,5,5,9.0,6.0
9993,1992-1993,26,FC Utrecht,Dordrecht '90,1,1,3,1,1,2,0,2.0,5.0
9994,1992-1993,26,Feyenoord,Roda JC Kerkrade,3,0,1,3,0,3,3,13.0,2.0
9995,1992-1993,26,Vitesse,AFC Ajax,2,2,3,1,1,4,0,9.0,11.0
9996,1992-1993,27,SC Cambuur,MVV Maastricht,0,4,2,0,3,4,-4,2.0,5.0
9997,1992-1993,27,Dordrecht '90,Vitesse,3,3,3,1,1,6,0,6.0,9.0
9998,1992-1993,27,PSV,FC Twente,6,2,1,3,0,8,4,11.0,6.0
9999,1992-1993,27,AFC Ajax,FC Den Bosch,4,0,1,3,0,4,4,13.0,6.0
10000,1992-1993,27,FC Volendam,FC Groningen,1,3,2,0,3,4,-2,9.0,7.0
10001,1992-1993,27,Go Ahead Eagles,FC Utrecht,1,1,3,1,1,2,0,5.0,3.0
10002,1992-1993,27,RKC Waalwijk,Feyenoord,1,2,2,0,3,3,-1,5.0,13.0
10003,1992-1993,27,Roda JC Kerkrade,Willem II,2,0,1,3,0,2,2,4.0,5.0
10004,1992-1993,27,Sparta Rotterdam,Fortuna Sittard,1,0,1,3,0,1,1,6.0,7.0
10005,1992-1993,28,MVV Maastricht,AFC Ajax,1,1,3,1,1,2,0,6.0,11.0
10006,1992-1993,28,Dordrecht '90,Go Ahead Eagles,0,0,3,1,1,0,0,6.0,5.0
10007,1992-1993,28,FC Groningen,Roda JC Kerkrade,0,0,3,1,1,0,0,7.0,5.0
10008,1992-1993,28,FC Twente,FC Volendam,2,1,1,3,0,3,1,6.0,6.0
10009,1992-1993,28,FC Utrecht,Sparta Rotterdam,1,1,3,1,1,2,0,4.0,7.0
10010,1992-1993,28,Feyenoord,SC Cambuur,3,1,1,3,0,4,2,13.0,1.0
10011,1992-1993,28,Vitesse,FC Den Bosch,2,0,1,3,0,2,2,9.0,6.0
10012,1992-1993,28,Willem II,RKC Waalwijk,0,2,2,0,3,2,-2,4.0,7.0
10013,1992-1993,28,Fortuna Sittard,PSV,1,5,2,0,3,6,-4,7.0,11.0
10014,1992-1993,29,SC Cambuur,Willem II,3,1,1,3,0,4,2,3.0,1.0
10015,1992-1993,29,FC Den Bosch,MVV Maastricht,4,1,1,3,0,5,3,6.0,6.0
10016,1992-1993,29,Go Ahead Eagles,Vitesse,0,3,2,0,3,3,-3,5.0,11.0
10017,1992-1993,29,PSV,FC Utrecht,3,1,1,3,0,4,2,13.0,3.0
10018,1992-1993,29,Sparta Rotterdam,Dordrecht '90,0,0,3,1,1,0,0,8.0,4.0
10019,1992-1993,29,FC Volendam,Fortuna Sittard,2,0,1,3,0,2,2,6.0,6.0
10020,1992-1993,29,RKC Waalwijk,FC Groningen,1,2,2,0,3,3,-1,7.0,7.0
10021,1992-1993,29,Roda JC Kerkrade,FC Twente,2,2,3,1,1,4,0,6.0,7.0
10022,1992-1993,29,AFC Ajax,Feyenoord,5,2,1,3,0,7,3,11.0,12.0
10023,1992-1993,30,Fortuna Sittard,Roda JC Kerkrade,1,1,3,1,1,2,0,4.0,6.0
10024,1992-1993,30,Feyenoord,FC Den Bosch,5,0,1,3,0,5,5,12.0,6.0
10025,1992-1993,30,Go Ahead Eagles,Sparta Rotterdam,1,0,1,3,0,1,1,5.0,5.0
10026,1992-1993,30,FC Groningen,SC Cambuur,0,1,2,0,3,1,-1,7.0,6.0
10027,1992-1993,30,FC Twente,RKC Waalwijk,0,0,3,1,1,0,0,8.0,5.0
10028,1992-1993,30,FC Utrecht,FC Volendam,2,0,1,3,0,2,2,6.0,6.0
10029,1992-1993,30,Vitesse,MVV Maastricht,2,1,1,3,0,3,1,11.0,5.0
10030,1992-1993,30,Willem II,AFC Ajax,1,0,1,3,0,1,1,3.0,8.0
10031,1992-1993,30,Dordrecht '90,PSV,2,2,3,1,1,4,0,5.0,13.0
10032,1992-1993,31,Roda JC Kerkrade,FC Utrecht,1,3,2,0,3,4,-2,6.0,8.0
10033,1992-1993,31,SC Cambuur,FC Twente,4,2,1,3,0,6,2,9.0,5.0
10034,1992-1993,31,FC Den Bosch,Willem II,0,3,2,0,3,3,-3,3.0,6.0
10035,1992-1993,31,PSV,Go Ahead Eagles,2,0,1,3,0,2,2,13.0,5.0
10036,1992-1993,31,FC Volendam,Dordrecht '90,4,1,1,3,0,5,3,6.0,4.0
10037,1992-1993,31,RKC Waalwijk,Fortuna Sittard,1,3,2,0,3,4,-2,4.0,4.0
10038,1992-1993,31,Sparta Rotterdam,Vitesse,0,3,2,0,3,3,-3,5.0,13.0
10039,1992-1993,31,AFC Ajax,FC Groningen,4,0,1,3,0,4,4,10.0,7.0
10040,1992-1993,31,MVV Maastricht,Feyenoord,0,2,2,0,3,2,-2,4.0,12.0
10041,1992-1993,32,Dordrecht '90,Roda JC Kerkrade,0,1,2,0,3,1,-1,3.0,6.0
10042,1992-1993,32,Fortuna Sittard,SC Cambuur,1,1,3,1,1,2,0,5.0,10.0
10043,1992-1993,32,Go Ahead Eagles,FC Volendam,0,0,3,1,1,0,0,5.0,7.0
10044,1992-1993,32,Sparta Rotterdam,PSV,2,5,2,0,3,7,-3,2.0,13.0
10045,1992-1993,32,Willem II,MVV Maastricht,4,1,1,3,0,5,3,9.0,1.0
10046,1992-1993,32,FC Groningen,FC Den Bosch,1,1,3,1,1,2,0,5.0,4.0
10047,1992-1993,32,FC Twente,AFC Ajax,2,0,1,3,0,2,2,8.0,7.0
10048,1992-1993,32,FC Utrecht,RKC Waalwijk,0,1,2,0,3,1,-1,7.0,7.0
10049,1992-1993,32,Vitesse,Feyenoord,1,1,3,1,1,2,0,13.0,10.0
10050,1992-1993,33,MVV Maastricht,FC Groningen,1,0,1,3,0,1,1,3.0,4.0
10051,1992-1993,33,Feyenoord,Willem II,3,0,1,3,0,3,3,10.0,9.0
10052,1992-1993,33,SC Cambuur,FC Utrecht,1,2,2,0,3,3,-1,10.0,9.0
10053,1992-1993,33,FC Den Bosch,FC Twente,2,0,1,3,0,2,2,7.0,5.0
10054,1992-1993,33,FC Volendam,Sparta Rotterdam,3,3,3,1,1,6,0,8.0,2.0
10055,1992-1993,33,RKC Waalwijk,Dordrecht '90,0,3,2,0,3,3,-3,4.0,5.0
10056,1992-1993,33,Roda JC Kerkrade,Go Ahead Eagles,4,0,1,3,0,4,4,8.0,4.0
10057,1992-1993,33,Vitesse,PSV,1,0,1,3,0,1,1,13.0,10.0
10058,1992-1993,33,AFC Ajax,Fortuna Sittard,5,1,1,3,0,6,4,9.0,5.0
10059,1992-1993,34,Go Ahead Eagles,RKC Waalwijk,2,4,2,0,3,6,-2,4.0,7.0
10060,1992-1993,34,FC Groningen,Feyenoord,0,5,2,0,3,5,-5,1.0,13.0
10061,1992-1993,34,FC Twente,MVV Maastricht,3,0,1,3,0,3,3,7.0,3.0
10062,1992-1993,34,FC Utrecht,AFC Ajax,1,2,2,0,3,3,-1,9.0,9.0
10063,1992-1993,34,PSV,FC Volendam,2,2,3,1,1,4,0,8.0,6.0
10064,1992-1993,34,Sparta Rotterdam,Roda JC Kerkrade,2,4,2,0,3,6,-2,1.0,10.0
10065,1992-1993,34,Willem II,Vitesse,1,2,2,0,3,3,-1,9.0,13.0
10066,1992-1993,34,Dordrecht '90,SC Cambuur,4,0,1,3,0,4,4,7.0,7.0
10067,1992-1993,34,Fortuna Sittard,FC Den Bosch,1,1,3,1,1,2,0,6.0,5.0
10068,1993-1994,1,Go Ahead Eagles,Vitesse,1,4,2,0,3,5,-3,1.0,13.0
10069,1993-1994,1,NAC Breda,Roda JC Kerkrade,2,3,2,0,3,5,-1,3.0,12.0
10070,1993-1994,1,sc Heerenveen,Sparta Rotterdam,1,0,1,3,0,1,1,7.0,1.0
10071,1993-1994,1,Willem II,MVV Maastricht,1,0,1,3,0,1,1,9.0,3.0
10072,1993-1994,1,AFC Ajax,RKC Waalwijk,3,0,1,3,0,3,3,12.0,6.0
10073,1993-1994,1,FC Groningen,PSV,1,2,2,0,3,3,-1,1.0,10.0
10074,1993-1994,1,FC Twente,VVV-Venlo,3,0,1,3,0,3,3,9.0,3.0
10075,1993-1994,1,FC Volendam,FC Utrecht,2,2,3,1,1,4,0,7.0,7.0
10076,1993-1994,1,Feyenoord,SC Cambuur,1,0,1,3,0,1,1,13.0,4.0
10077,1993-1994,2,SC Cambuur,NAC Breda,1,3,2,0,3,4,-2,1.0,6.0
10078,1993-1994,2,PSV,Go Ahead Eagles,3,0,1,3,0,3,3,10.0,1.0
10079,1993-1994,2,RKC Waalwijk,FC Twente,1,3,2,0,3,4,-2,6.0,12.0
10080,1993-1994,2,Roda JC Kerkrade,FC Volendam,2,0,1,3,0,2,2,15.0,4.0
10081,1993-1994,2,Sparta Rotterdam,Willem II,1,0,1,3,0,1,1,4.0,6.0
10082,1993-1994,2,FC Utrecht,FC Groningen,2,0,1,3,0,2,2,7.0,1.0
10083,1993-1994,2,MVV Maastricht,AFC Ajax,1,1,3,1,1,2,0,4.0,10.0
10084,1993-1994,2,Vitesse,sc Heerenveen,3,0,1,3,0,3,3,13.0,7.0
10085,1993-1994,2,VVV-Venlo,Feyenoord,1,1,3,1,1,2,0,4.0,11.0
10086,1993-1994,3,AFC Ajax,Sparta Rotterdam,3,0,1,3,0,3,3,13.0,4.0
10087,1993-1994,3,FC Groningen,Roda JC Kerkrade,3,5,2,0,3,8,-2,0.0,15.0
10088,1993-1994,3,FC Volendam,SC Cambuur,4,1,1,3,0,5,3,6.0,0.0
10089,1993-1994,3,Feyenoord,FC Twente,1,0,1,3,0,1,1,13.0,9.0
10090,1993-1994,3,Go Ahead Eagles,FC Utrecht,4,0,1,3,0,4,4,3.0,7.0
10091,1993-1994,3,MVV Maastricht,RKC Waalwijk,1,1,3,1,1,2,0,5.0,4.0
10092,1993-1994,3,NAC Breda,VVV-Venlo,4,1,1,3,0,5,3,9.0,4.0
10093,1993-1994,3,sc Heerenveen,PSV,0,0,3,1,1,0,0,8.0,8.0
10094,1993-1994,3,Willem II,Vitesse,0,3,2,0,3,3,-3,3.0,15.0
10095,1993-1994,4,PSV,Willem II,2,1,1,3,0,3,1,11.0,3.0
10096,1993-1994,4,VVV-Venlo,FC Volendam,2,0,1,3,0,2,2,7.0,5.0
10097,1993-1994,4,SC Cambuur,FC Groningen,0,2,2,0,3,2,-2,0.0,3.0
10098,1993-1994,4,FC Twente,NAC Breda,0,1,2,0,3,1,-1,9.0,9.0
10099,1993-1994,4,FC Utrecht,sc Heerenveen,0,1,2,0,3,1,-1,4.0,10.0
10100,1993-1994,4,Roda JC Kerkrade,Go Ahead Eagles,2,1,1,3,0,3,1,15.0,3.0
10101,1993-1994,4,Sparta Rotterdam,MVV Maastricht,2,2,3,1,1,4,0,4.0,3.0
10102,1993-1994,4,Vitesse,AFC Ajax,0,1,2,0,3,1,-1,12.0,13.0
10103,1993-1994,4,RKC Waalwijk,Feyenoord,1,2,2,0,3,3,-1,4.0,13.0
10104,1993-1994,5,Go Ahead Eagles,SC Cambuur,3,0,1,3,0,3,3,6.0,0.0
10105,1993-1994,5,MVV Maastricht,Vitesse,0,2,2,0,3,2,-2,3.0,12.0
10106,1993-1994,5,sc Heerenveen,Roda JC Kerkrade,0,0,3,1,1,0,0,8.0,13.0
10107,1993-1994,5,Willem II,FC Utrecht,4,1,1,3,0,5,3,6.0,4.0
10108,1993-1994,5,AFC Ajax,PSV,2,0,1,3,0,2,2,13.0,10.0
10109,1993-1994,5,FC Groningen,VVV-Venlo,0,3,2,0,3,3,-3,3.0,7.0
10110,1993-1994,5,FC Volendam,FC Twente,2,5,2,0,3,7,-3,4.0,9.0
10111,1993-1994,5,NAC Breda,Feyenoord,1,2,2,0,3,3,-1,9.0,13.0
10112,1993-1994,5,Sparta Rotterdam,RKC Waalwijk,1,1,3,1,1,2,0,5.0,2.0
10113,1993-1994,6,FC Utrecht,AFC Ajax,1,4,2,0,3,5,-3,3.0,13.0
10114,1993-1994,6,SC Cambuur,sc Heerenveen,1,2,2,0,3,3,-1,0.0,8.0
10115,1993-1994,6,Feyenoord,FC Volendam,2,0,1,3,0,2,2,13.0,3.0
10116,1993-1994,6,PSV,MVV Maastricht,4,2,1,3,0,6,2,10.0,3.0
10117,1993-1994,6,RKC Waalwijk,NAC Breda,1,0,1,3,0,1,1,5.0,9.0
10118,1993-1994,6,Roda JC Kerkrade,Willem II,1,1,3,1,1,2,0,11.0,4.0
10119,1993-1994,6,Vitesse,Sparta Rotterdam,2,0,1,3,0,2,2,12.0,5.0
10120,1993-1994,6,VVV-Venlo,Go Ahead Eagles,1,0,1,3,0,1,1,10.0,6.0
10121,1993-1994,6,FC Twente,FC Groningen,0,1,2,0,3,1,-1,6.0,6.0
10122,1993-1994,7,MVV Maastricht,FC Utrecht,2,1,1,3,0,3,1,5.0,0.0
10123,1993-1994,7,sc Heerenveen,VVV-Venlo,1,0,1,3,0,1,1,11.0,9.0
10124,1993-1994,7,Sparta Rotterdam,PSV,0,0,3,1,1,0,0,3.0,8.0
10125,1993-1994,7,Willem II,SC Cambuur,4,1,1,3,0,5,3,7.0,0.0
10126,1993-1994,7,AFC Ajax,Roda JC Kerkrade,2,0,1,3,0,2,2,15.0,8.0
10127,1993-1994,7,FC Groningen,Feyenoord,0,4,2,0,3,4,-4,6.0,15.0
10128,1993-1994,7,FC Volendam,NAC Breda,1,3,2,0,3,4,-2,3.0,9.0
10129,1993-1994,7,Go Ahead Eagles,FC Twente,3,3,3,1,1,6,0,7.0,4.0
10130,1993-1994,7,Vitesse,RKC Waalwijk,4,1,1,3,0,5,3,12.0,5.0
10131,1993-1994,8,FC Utrecht,Sparta Rotterdam,3,1,1,3,0,4,2,3.0,3.0
10132,1993-1994,8,NAC Breda,FC Groningen,2,1,1,3,0,3,1,9.0,6.0
10133,1993-1994,8,FC Twente,sc Heerenveen,2,1,1,3,0,3,1,7.0,10.0
10134,1993-1994,8,Feyenoord,Go Ahead Eagles,1,0,1,3,0,1,1,15.0,4.0
10135,1993-1994,8,RKC Waalwijk,FC Volendam,1,3,2,0,3,4,-2,4.0,3.0
10136,1993-1994,8,Roda JC Kerkrade,MVV Maastricht,4,1,1,3,0,5,3,8.0,4.0
10137,1993-1994,8,SC Cambuur,AFC Ajax,0,3,2,0,3,3,-3,0.0,15.0
10138,1993-1994,8,PSV,Vitesse,0,1,2,0,3,1,-1,7.0,12.0
10139,1993-1994,8,VVV-Venlo,Willem II,0,0,3,1,1,0,0,10.0,8.0
10140,1993-1994,9,Go Ahead Eagles,NAC Breda,0,0,3,1,1,0,0,5.0,7.0
10141,1993-1994,9,MVV Maastricht,SC Cambuur,0,0,3,1,1,0,0,4.0,1.0
10142,1993-1994,9,PSV,RKC Waalwijk,1,1,3,1,1,2,0,5.0,5.0
10143,1993-1994,9,Willem II,FC Twente,2,0,1,3,0,2,2,11.0,7.0
10144,1993-1994,9,AFC Ajax,VVV-Venlo,2,0,1,3,0,2,2,15.0,7.0
10145,1993-1994,9,Sparta Rotterdam,Roda JC Kerkrade,2,0,1,3,0,2,2,5.0,5.0
10146,1993-1994,9,Vitesse,FC Utrecht,2,2,3,1,1,4,0,13.0,4.0
10147,1993-1994,9,sc Heerenveen,Feyenoord,1,3,2,0,3,4,-2,7.0,15.0
10148,1993-1994,9,FC Groningen,FC Volendam,0,0,3,1,1,0,0,4.0,4.0
10149,1993-1994,10,Roda JC Kerkrade,Vitesse,2,1,1,3,0,3,1,7.0,10.0
10150,1993-1994,10,SC Cambuur,Sparta Rotterdam,1,1,3,1,1,2,0,2.0,5.0
10151,1993-1994,10,NAC Breda,sc Heerenveen,6,0,1,3,0,6,6,10.0,6.0
10152,1993-1994,10,VVV-Venlo,MVV Maastricht,1,7,2,0,3,8,-6,4.0,7.0
10153,1993-1994,10,FC Twente,AFC Ajax,2,1,1,3,0,3,1,7.0,12.0
10154,1993-1994,10,FC Utrecht,PSV,0,4,2,0,3,4,-4,4.0,8.0
10155,1993-1994,10,FC Volendam,Go Ahead Eagles,0,1,2,0,3,1,-1,4.0,5.0
10156,1993-1994,10,Feyenoord,Willem II,2,0,1,3,0,2,2,15.0,8.0
10157,1993-1994,10,RKC Waalwijk,FC Groningen,2,3,2,0,3,5,-1,4.0,7.0
10158,1993-1994,11,MVV Maastricht,FC Twente,0,2,2,0,3,2,-2,7.0,10.0
10159,1993-1994,11,Go Ahead Eagles,FC Groningen,3,0,1,3,0,3,3,8.0,4.0
10160,1993-1994,11,PSV,Roda JC Kerkrade,2,0,1,3,0,2,2,8.0,6.0
10161,1993-1994,11,sc Heerenveen,FC Volendam,3,1,1,3,0,4,2,6.0,4.0
10162,1993-1994,11,AFC Ajax,Feyenoord,2,2,3,1,1,4,0,10.0,13.0
10163,1993-1994,11,FC Utrecht,RKC Waalwijk,3,1,1,3,0,4,2,7.0,1.0
10164,1993-1994,11,Sparta Rotterdam,VVV-Venlo,2,2,3,1,1,4,0,6.0,2.0
10165,1993-1994,11,Vitesse,SC Cambuur,2,1,1,3,0,3,1,10.0,2.0
10166,1993-1994,11,Willem II,NAC Breda,2,0,1,3,0,2,2,10.0,10.0
10167,1993-1994,12,VVV-Venlo,Vitesse,2,1,1,3,0,3,1,5.0,7.0
10168,1993-1994,12,Roda JC Kerkrade,FC Utrecht,4,0,1,3,0,4,4,9.0,7.0
10169,1993-1994,12,NAC Breda,AFC Ajax,0,5,2,0,3,5,-5,7.0,10.0
10170,1993-1994,12,SC Cambuur,PSV,1,3,2,0,3,4,-2,2.0,10.0
10171,1993-1994,12,FC Groningen,sc Heerenveen,2,2,3,1,1,4,0,5.0,4.0
10172,1993-1994,12,FC Twente,Sparta Rotterdam,0,0,3,1,1,0,0,10.0,6.0
10173,1993-1994,12,FC Volendam,Willem II,0,3,2,0,3,3,-3,4.0,10.0
10174,1993-1994,12,Feyenoord,MVV Maastricht,4,0,1,3,0,4,4,13.0,4.0
10175,1993-1994,12,RKC Waalwijk,Go Ahead Eagles,1,2,2,0,3,3,-1,1.0,10.0
10176,1993-1994,13,MVV Maastricht,NAC Breda,2,1,1,3,0,3,1,7.0,4.0
10177,1993-1994,13,PSV,VVV-Venlo,3,2,1,3,0,5,1,13.0,4.0
10178,1993-1994,13,sc Heerenveen,Go Ahead Eagles,1,4,2,0,3,5,-3,4.0,13.0
10179,1993-1994,13,Willem II,FC Groningen,4,1,1,3,0,5,3,12.0,5.0
10180,1993-1994,13,AFC Ajax,FC Volendam,3,1,1,3,0,4,2,10.0,1.0
10181,1993-1994,13,FC Utrecht,SC Cambuur,2,0,1,3,0,2,2,7.0,2.0
10182,1993-1994,13,Roda JC Kerkrade,RKC Waalwijk,2,0,1,3,0,2,2,9.0,1.0
10183,1993-1994,13,Sparta Rotterdam,Feyenoord,3,4,2,0,3,7,-1,6.0,13.0
10184,1993-1994,13,Vitesse,FC Twente,3,0,1,3,0,3,3,7.0,7.0
10185,1993-1994,14,VVV-Venlo,FC Utrecht,1,1,3,1,1,2,0,5.0,7.0
10186,1993-1994,14,Go Ahead Eagles,Willem II,3,0,1,3,0,3,3,15.0,9.0
10187,1993-1994,14,NAC Breda,Sparta Rotterdam,4,3,1,3,0,7,1,6.0,3.0
10188,1993-1994,14,FC Groningen,AFC Ajax,0,4,2,0,3,4,-4,4.0,10.0
10189,1993-1994,14,FC Volendam,MVV Maastricht,5,0,1,3,0,5,5,3.0,6.0
10190,1993-1994,14,Feyenoord,Vitesse,1,1,3,1,1,2,0,11.0,7.0
10191,1993-1994,14,RKC Waalwijk,sc Heerenveen,1,1,3,1,1,2,0,1.0,5.0
10192,1993-1994,14,SC Cambuur,Roda JC Kerkrade,0,1,2,0,3,1,-1,1.0,12.0
10193,1993-1994,14,FC Twente,PSV,0,0,3,1,1,0,0,8.0,13.0
10194,1993-1994,15,Willem II,sc Heerenveen,1,1,3,1,1,2,0,10.0,6.0
10195,1993-1994,15,AFC Ajax,Go Ahead Eagles,4,0,1,3,0,4,4,13.0,12.0
10196,1993-1994,15,FC Utrecht,FC Twente,1,0,1,3,0,1,1,10.0,5.0
10197,1993-1994,15,PSV,Feyenoord,1,3,2,0,3,4,-2,10.0,11.0
10198,1993-1994,15,Roda JC Kerkrade,VVV-Venlo,0,0,3,1,1,0,0,10.0,6.0
10199,1993-1994,15,SC Cambuur,RKC Waalwijk,1,1,3,1,1,2,0,1.0,2.0
10200,1993-1994,15,Sparta Rotterdam,FC Volendam,4,1,1,3,0,5,3,5.0,3.0
10201,1993-1994,15,Vitesse,NAC Breda,3,1,1,3,0,4,2,10.0,3.0
10202,1993-1994,15,MVV Maastricht,FC Groningen,2,0,1,3,0,2,2,6.0,1.0
10203,1993-1994,16,Go Ahead Eagles,MVV Maastricht,2,2,3,1,1,4,0,10.0,7.0
10204,1993-1994,16,NAC Breda,PSV,2,2,3,1,1,4,0,4.0,8.0
10205,1993-1994,16,FC Groningen,Sparta Rotterdam,1,4,2,0,3,5,-3,1.0,7.0
10206,1993-1994,16,FC Twente,Roda JC Kerkrade,2,1,1,3,0,3,1,5.0,10.0
10207,1993-1994,16,FC Volendam,Vitesse,2,0,1,3,0,2,2,6.0,7.0
10208,1993-1994,16,Feyenoord,FC Utrecht,1,1,3,1,1,2,0,11.0,8.0
10209,1993-1994,16,VVV-Venlo,SC Cambuur,1,0,1,3,0,1,1,8.0,1.0
10210,1993-1994,16,Willem II,RKC Waalwijk,4,1,1,3,0,5,3,10.0,2.0
10211,1993-1994,16,sc Heerenveen,AFC Ajax,1,4,2,0,3,5,-3,3.0,15.0
10212,1993-1994,17,SC Cambuur,FC Twente,1,1,3,1,1,2,0,2.0,5.0
10213,1993-1994,17,Roda JC Kerkrade,Feyenoord,1,0,1,3,0,1,1,10.0,8.0
10214,1993-1994,17,MVV Maastricht,sc Heerenveen,3,1,1,3,0,4,2,10.0,2.0
10215,1993-1994,17,PSV,FC Volendam,3,0,1,3,0,3,3,8.0,6.0
10216,1993-1994,17,AFC Ajax,Willem II,3,1,1,3,0,4,2,15.0,7.0
10217,1993-1994,17,FC Utrecht,NAC Breda,0,5,2,0,3,5,-5,8.0,7.0
10218,1993-1994,17,RKC Waalwijk,VVV-Venlo,1,2,2,0,3,3,-1,2.0,8.0
10219,1993-1994,17,Sparta Rotterdam,Go Ahead Eagles,1,0,1,3,0,1,1,9.0,7.0
10220,1993-1994,17,Vitesse,FC Groningen,4,1,1,3,0,5,3,10.0,0.0
10221,1993-1994,18,MVV Maastricht,Willem II,1,0,1,3,0,1,1,10.0,4.0
10222,1993-1994,18,PSV,FC Groningen,1,1,3,1,1,2,0,6.0,1.0
10223,1993-1994,18,VVV-Venlo,FC Twente,0,0,3,1,1,0,0,9.0,6.0
10224,1993-1994,18,FC Utrecht,FC Volendam,3,1,1,3,0,4,2,8.0,6.0
10225,1993-1994,18,Sparta Rotterdam,sc Heerenveen,3,0,1,3,0,3,3,12.0,2.0
10226,1993-1994,18,Vitesse,Go Ahead Eagles,5,0,1,3,0,5,5,10.0,4.0
10227,1993-1994,18,RKC Waalwijk,AFC Ajax,0,3,2,0,3,3,-3,2.0,15.0
10228,1993-1994,18,Roda JC Kerkrade,NAC Breda,1,2,2,0,3,3,-1,7.0,10.0
10229,1993-1994,18,SC Cambuur,Feyenoord,0,0,3,1,1,0,0,3.0,6.0
10230,1993-1994,19,Go Ahead Eagles,PSV,0,4,2,0,3,4,-4,1.0,8.0
10231,1993-1994,19,NAC Breda,SC Cambuur,2,0,1,3,0,2,2,10.0,3.0
10232,1993-1994,19,sc Heerenveen,Vitesse,0,4,2,0,3,4,-4,1.0,12.0
10233,1993-1994,19,Willem II,Sparta Rotterdam,5,1,1,3,0,6,4,7.0,12.0
10234,1993-1994,19,AFC Ajax,MVV Maastricht,4,1,1,3,0,5,3,15.0,10.0
10235,1993-1994,19,FC Groningen,FC Utrecht,4,1,1,3,0,5,3,4.0,7.0
10236,1993-1994,19,FC Twente,RKC Waalwijk,2,1,1,3,0,3,1,8.0,1.0
10237,1993-1994,19,Feyenoord,VVV-Venlo,5,0,1,3,0,5,5,8.0,8.0
10238,1993-1994,19,FC Volendam,Roda JC Kerkrade,2,0,1,3,0,2,2,6.0,4.0
10239,1993-1994,20,VVV-Venlo,NAC Breda,1,1,3,1,1,2,0,8.0,11.0
10240,1993-1994,20,SC Cambuur,FC Volendam,3,1,1,3,0,4,2,5.0,6.0
10241,1993-1994,20,PSV,sc Heerenveen,1,1,3,1,1,2,0,9.0,1.0
10242,1993-1994,20,Vitesse,Willem II,0,1,2,0,3,1,-1,9.0,9.0
10243,1993-1994,20,FC Utrecht,Go Ahead Eagles,2,0,1,3,0,2,2,7.0,1.0
10244,1993-1994,20,Sparta Rotterdam,AFC Ajax,0,1,2,0,3,1,-1,9.0,15.0
10245,1993-1994,20,RKC Waalwijk,MVV Maastricht,0,2,2,0,3,2,-2,0.0,10.0
10246,1993-1994,20,Roda JC Kerkrade,FC Groningen,2,0,1,3,0,2,2,6.0,4.0
10247,1993-1994,20,FC Twente,Feyenoord,1,1,3,1,1,2,0,9.0,6.0
10248,1993-1994,21,Go Ahead Eagles,Roda JC Kerkrade,3,1,1,3,0,4,2,3.0,6.0
10249,1993-1994,21,NAC Breda,FC Twente,2,1,1,3,0,3,1,13.0,6.0
10250,1993-1994,21,sc Heerenveen,FC Utrecht,1,0,1,3,0,1,1,4.0,6.0
10251,1993-1994,21,AFC Ajax,Vitesse,3,1,1,3,0,4,2,15.0,9.0
10252,1993-1994,21,FC Groningen,SC Cambuur,2,2,3,1,1,4,0,5.0,6.0
10253,1993-1994,21,FC Volendam,VVV-Venlo,1,1,3,1,1,2,0,4.0,6.0
10254,1993-1994,21,Feyenoord,RKC Waalwijk,1,1,3,1,1,2,0,6.0,1.0
10255,1993-1994,21,MVV Maastricht,Sparta Rotterdam,0,0,3,1,1,0,0,10.0,7.0
10256,1993-1994,21,Willem II,PSV,1,1,3,1,1,2,0,7.0,9.0
10257,1993-1994,22,SC Cambuur,Go Ahead Eagles,1,0,1,3,0,1,1,8.0,3.0
10258,1993-1994,22,VVV-Venlo,FC Groningen,1,3,2,0,3,4,-2,3.0,8.0
10259,1993-1994,22,FC Twente,FC Volendam,2,0,1,3,0,2,2,8.0,4.0
10260,1993-1994,22,FC Utrecht,Willem II,1,1,3,1,1,2,0,7.0,8.0
10261,1993-1994,22,Feyenoord,NAC Breda,1,1,3,1,1,2,0,7.0,11.0
10262,1993-1994,22,PSV,AFC Ajax,4,1,1,3,0,5,3,9.0,12.0
10263,1993-1994,22,RKC Waalwijk,Sparta Rotterdam,3,1,1,3,0,4,2,4.0,4.0
10264,1993-1994,22,Roda JC Kerkrade,sc Heerenveen,1,1,3,1,1,2,0,4.0,5.0
10265,1993-1994,22,Vitesse,MVV Maastricht,1,3,2,0,3,4,-2,6.0,10.0
10266,1993-1994,23,MVV Maastricht,PSV,2,1,1,3,0,3,1,10.0,8.0
10267,1993-1994,23,sc Heerenveen,SC Cambuur,1,2,2,0,3,3,-1,5.0,10.0
10268,1993-1994,23,Go Ahead Eagles,VVV-Venlo,2,0,1,3,0,2,2,6.0,2.0
10269,1993-1994,23,NAC Breda,RKC Waalwijk,3,0,1,3,0,3,3,11.0,4.0
10270,1993-1994,23,Willem II,Roda JC Kerkrade,0,3,2,0,3,3,-3,8.0,7.0
10271,1993-1994,23,AFC Ajax,FC Utrecht,3,0,1,3,0,3,3,12.0,4.0
10272,1993-1994,23,FC Groningen,FC Twente,1,1,3,1,1,2,0,8.0,8.0
10273,1993-1994,23,FC Volendam,Feyenoord,0,1,2,0,3,1,-1,4.0,9.0
10274,1993-1994,23,Sparta Rotterdam,Vitesse,4,1,1,3,0,5,3,4.0,3.0
10275,1993-1994,24,FC Twente,Go Ahead Eagles,1,1,3,1,1,2,0,6.0,7.0
10276,1993-1994,24,FC Utrecht,MVV Maastricht,3,0,1,3,0,3,3,7.0,10.0
10277,1993-1994,24,SC Cambuur,Willem II,0,1,2,0,3,1,-1,10.0,8.0
10278,1993-1994,24,Feyenoord,FC Groningen,2,2,3,1,1,4,0,7.0,6.0
10279,1993-1994,24,NAC Breda,FC Volendam,3,1,1,3,0,4,2,11.0,1.0
10280,1993-1994,24,PSV,Sparta Rotterdam,2,1,1,3,0,3,1,8.0,4.0
10281,1993-1994,24,RKC Waalwijk,Vitesse,0,0,3,1,1,0,0,5.0,1.0
10282,1993-1994,24,Roda JC Kerkrade,AFC Ajax,1,2,2,0,3,3,-1,7.0,12.0
10283,1993-1994,24,VVV-Venlo,sc Heerenveen,1,1,3,1,1,2,0,3.0,6.0
10284,1993-1994,25,MVV Maastricht,Roda JC Kerkrade,1,0,1,3,0,1,1,10.0,4.0
10285,1993-1994,25,Willem II,VVV-Venlo,3,0,1,3,0,3,3,8.0,2.0
10286,1993-1994,25,AFC Ajax,SC Cambuur,3,2,1,3,0,5,1,12.0,7.0
10287,1993-1994,25,FC Groningen,NAC Breda,0,0,3,1,1,0,0,7.0,11.0
10288,1993-1994,25,FC Volendam,RKC Waalwijk,3,1,1,3,0,4,2,4.0,5.0
10289,1993-1994,25,Go Ahead Eagles,Feyenoord,1,1,3,1,1,2,0,8.0,7.0
10290,1993-1994,25,Sparta Rotterdam,FC Utrecht,3,2,1,3,0,5,1,7.0,4.0
10291,1993-1994,25,Vitesse,PSV,0,0,3,1,1,0,0,2.0,8.0
10292,1993-1994,25,sc Heerenveen,FC Twente,2,2,3,1,1,4,0,6.0,6.0
10293,1993-1994,26,Feyenoord,sc Heerenveen,0,0,3,1,1,0,0,7.0,4.0
10294,1993-1994,26,SC Cambuur,MVV Maastricht,2,1,1,3,0,3,1,9.0,9.0
10295,1993-1994,26,NAC Breda,Go Ahead Eagles,2,2,3,1,1,4,0,9.0,6.0
10296,1993-1994,26,FC Utrecht,Vitesse,2,1,1,3,0,3,1,7.0,2.0
10297,1993-1994,26,FC Volendam,FC Groningen,1,0,1,3,0,1,1,6.0,6.0
10298,1993-1994,26,RKC Waalwijk,PSV,1,1,3,1,1,2,0,5.0,8.0
10299,1993-1994,26,Roda JC Kerkrade,Sparta Rotterdam,4,0,1,3,0,4,4,7.0,6.0
10300,1993-1994,26,VVV-Venlo,AFC Ajax,0,1,2,0,3,1,-1,1.0,12.0
10301,1993-1994,26,FC Twente,Willem II,4,0,1,3,0,4,4,9.0,7.0
10302,1993-1994,27,sc Heerenveen,NAC Breda,1,3,2,0,3,4,-2,3.0,11.0
10303,1993-1994,27,Go Ahead Eagles,FC Volendam,0,1,2,0,3,1,-1,6.0,9.0
10304,1993-1994,27,MVV Maastricht,VVV-Venlo,0,0,3,1,1,0,0,7.0,2.0
10305,1993-1994,27,FC Groningen,RKC Waalwijk,1,2,2,0,3,3,-1,3.0,5.0
10306,1993-1994,27,PSV,FC Utrecht,1,0,1,3,0,1,1,8.0,6.0
10307,1993-1994,27,Sparta Rotterdam,SC Cambuur,4,0,1,3,0,4,4,9.0,6.0
10308,1993-1994,27,Vitesse,Roda JC Kerkrade,1,3,2,0,3,4,-2,2.0,9.0
10309,1993-1994,27,Willem II,Feyenoord,2,1,1,3,0,3,1,9.0,6.0
10310,1993-1994,27,AFC Ajax,FC Twente,6,0,1,3,0,6,6,15.0,6.0
10311,1993-1994,28,Roda JC Kerkrade,PSV,4,0,1,3,0,4,4,9.0,8.0
10312,1993-1994,28,NAC Breda,Willem II,1,1,3,1,1,2,0,9.0,10.0
10313,1993-1994,28,VVV-Venlo,Sparta Rotterdam,1,4,2,0,3,5,-3,2.0,9.0
10314,1993-1994,28,SC Cambuur,Vitesse,1,3,2,0,3,4,-2,3.0,5.0
10315,1993-1994,28,FC Groningen,Go Ahead Eagles,3,1,1,3,0,4,2,5.0,3.0
10316,1993-1994,28,FC Twente,MVV Maastricht,4,2,1,3,0,6,2,8.0,4.0
10317,1993-1994,28,FC Volendam,sc Heerenveen,3,0,1,3,0,3,3,12.0,3.0
10318,1993-1994,28,Feyenoord,AFC Ajax,2,1,1,3,0,3,1,6.0,12.0
10319,1993-1994,28,RKC Waalwijk,FC Utrecht,3,0,1,3,0,3,3,8.0,6.0
10320,1993-1994,29,MVV Maastricht,Feyenoord,1,1,3,1,1,2,0,5.0,6.0
10321,1993-1994,29,PSV,SC Cambuur,2,0,1,3,0,2,2,8.0,3.0
10322,1993-1994,29,FC Utrecht,Roda JC Kerkrade,1,1,3,1,1,2,0,4.0,10.0
10323,1993-1994,29,Go Ahead Eagles,RKC Waalwijk,2,0,1,3,0,2,2,5.0,7.0
10324,1993-1994,29,Sparta Rotterdam,FC Twente,2,5,2,0,3,7,-3,9.0,10.0
10325,1993-1994,29,Vitesse,VVV-Venlo,4,0,1,3,0,4,4,7.0,1.0
10326,1993-1994,29,Willem II,FC Volendam,0,2,2,0,3,2,-2,7.0,15.0
10327,1993-1994,29,sc Heerenveen,FC Groningen,2,0,1,3,0,2,2,5.0,4.0
10328,1993-1994,29,AFC Ajax,NAC Breda,5,0,1,3,0,5,5,12.0,6.0
10329,1993-1994,30,VVV-Venlo,PSV,0,3,2,0,3,3,-3,1.0,10.0
10330,1993-1994,30,SC Cambuur,FC Utrecht,2,1,1,3,0,3,1,6.0,4.0
10331,1993-1994,30,Go Ahead Eagles,sc Heerenveen,2,3,2,0,3,5,-1,4.0,7.0
10332,1993-1994,30,FC Groningen,Willem II,4,1,1,3,0,5,3,6.0,4.0
10333,1993-1994,30,FC Twente,Vitesse,0,1,2,0,3,1,-1,9.0,9.0
10334,1993-1994,30,Feyenoord,Sparta Rotterdam,5,1,1,3,0,6,4,8.0,6.0
10335,1993-1994,30,NAC Breda,MVV Maastricht,1,4,2,0,3,5,-3,5.0,5.0
10336,1993-1994,30,RKC Waalwijk,Roda JC Kerkrade,1,1,3,1,1,2,0,8.0,11.0
10337,1993-1994,30,FC Volendam,AFC Ajax,1,0,1,3,0,1,1,15.0,9.0
10338,1993-1994,31,PSV,FC Twente,3,2,1,3,0,5,1,12.0,6.0
10339,1993-1994,31,MVV Maastricht,FC Volendam,1,1,3,1,1,2,0,6.0,13.0
10340,1993-1994,31,sc Heerenveen,RKC Waalwijk,0,3,2,0,3,3,-3,6.0,10.0
10341,1993-1994,31,Sparta Rotterdam,NAC Breda,0,0,3,1,1,0,0,7.0,5.0
10342,1993-1994,31,Willem II,Go Ahead Eagles,0,0,3,1,1,0,0,5.0,4.0
10343,1993-1994,31,FC Utrecht,VVV-Venlo,2,3,2,0,3,5,-1,1.0,4.0
10344,1993-1994,31,Roda JC Kerkrade,SC Cambuur,1,1,3,1,1,2,0,9.0,4.0
10345,1993-1994,31,Vitesse,Feyenoord,1,2,2,0,3,3,-1,9.0,10.0
10346,1993-1994,31,AFC Ajax,FC Groningen,0,2,2,0,3,2,-2,6.0,9.0
10347,1993-1994,32,NAC Breda,Vitesse,2,2,3,1,1,4,0,3.0,10.0
10348,1993-1994,32,sc Heerenveen,Willem II,1,2,2,0,3,3,-1,6.0,5.0
10349,1993-1994,32,VVV-Venlo,Roda JC Kerkrade,2,2,3,1,1,4,0,4.0,7.0
10350,1993-1994,32,FC Groningen,MVV Maastricht,3,2,1,3,0,5,1,12.0,5.0
10351,1993-1994,32,FC Twente,FC Utrecht,1,0,1,3,0,1,1,9.0,1.0
10352,1993-1994,32,FC Volendam,Sparta Rotterdam,2,1,1,3,0,3,1,13.0,4.0
10353,1993-1994,32,Go Ahead Eagles,AFC Ajax,0,3,2,0,3,3,-3,4.0,6.0
10354,1993-1994,32,RKC Waalwijk,SC Cambuur,3,0,1,3,0,3,3,10.0,4.0
10355,1993-1994,32,Feyenoord,PSV,2,1,1,3,0,3,1,13.0,9.0
10356,1993-1994,33,AFC Ajax,sc Heerenveen,2,1,1,3,0,3,1,9.0,6.0
10357,1993-1994,33,SC Cambuur,VVV-Venlo,2,1,1,3,0,3,1,7.0,4.0
10358,1993-1994,33,FC Utrecht,Feyenoord,0,0,3,1,1,0,0,2.0,11.0
10359,1993-1994,33,MVV Maastricht,Go Ahead Eagles,2,2,3,1,1,4,0,6.0,5.0
10360,1993-1994,33,PSV,NAC Breda,3,1,1,3,0,4,2,12.0,2.0
10361,1993-1994,33,RKC Waalwijk,Willem II,1,0,1,3,0,1,1,10.0,4.0
10362,1993-1994,33,Roda JC Kerkrade,FC Twente,1,4,2,0,3,5,-3,4.0,9.0
10363,1993-1994,33,Sparta Rotterdam,FC Groningen,3,0,1,3,0,3,3,4.0,9.0
10364,1993-1994,33,Vitesse,FC Volendam,2,1,1,3,0,3,1,10.0,10.0
10365,1993-1994,34,FC Groningen,Vitesse,0,0,3,1,1,0,0,10.0,8.0
10366,1993-1994,34,FC Twente,SC Cambuur,4,1,1,3,0,5,3,9.0,7.0
10367,1993-1994,34,FC Volendam,PSV,3,2,1,3,0,5,1,10.0,9.0
10368,1993-1994,34,Feyenoord,Roda JC Kerkrade,2,1,1,3,0,3,1,13.0,3.0
10369,1993-1994,34,Go Ahead Eagles,Sparta Rotterdam,1,5,2,0,3,6,-4,2.0,7.0
10370,1993-1994,34,NAC Breda,FC Utrecht,2,2,3,1,1,4,0,3.0,2.0
10371,1993-1994,34,sc Heerenveen,MVV Maastricht,3,1,1,3,0,4,2,6.0,5.0
10372,1993-1994,34,VVV-Venlo,RKC Waalwijk,0,2,2,0,3,2,-2,4.0,13.0
10373,1993-1994,34,Willem II,AFC Ajax,2,1,1,3,0,3,1,7.0,6.0
10374,1994-1995,1,sc Heerenveen,FC Groningen,2,0,1,3,0,2,2,6.0,7.0
10375,1994-1995,1,Roda JC Kerkrade,FC Twente,1,1,3,1,1,2,0,3.0,10.0
10376,1994-1995,1,AFC Ajax,RKC Waalwijk,3,1,1,3,0,4,2,9.0,12.0
10377,1994-1995,1,FC Volendam,Go Ahead Eagles,3,0,1,3,0,3,3,10.0,2.0
10378,1994-1995,1,NEC Nijmegen,FC Utrecht,2,3,2,0,3,5,-1,3.0,5.0
10379,1994-1995,1,Dordrecht '90,Feyenoord,1,1,3,1,1,2,0,7.0,11.0
10380,1994-1995,1,Willem II,NAC Breda,2,0,1,3,0,2,2,10.0,3.0
10381,1994-1995,1,Vitesse,PSV,2,4,2,0,3,6,-2,5.0,9.0
10382,1994-1995,1,PSV,Go Ahead Eagles,4,1,1,3,0,5,3,9.0,1.0
10383,1994-1995,2,Sparta Rotterdam,Feyenoord,0,1,2,0,3,1,-1,7.0,11.0
10384,1994-1995,2,FC Twente,Dordrecht '90,2,2,3,1,1,4,0,11.0,8.0
10385,1994-1995,2,RKC Waalwijk,Roda JC Kerkrade,1,1,3,1,1,2,0,10.0,3.0
10386,1994-1995,2,NAC Breda,Vitesse,0,0,3,1,1,0,0,3.0,6.0
10387,1994-1995,2,MVV Maastricht,NEC Nijmegen,1,2,2,0,3,3,-1,2.0,6.0
10388,1994-1995,2,FC Groningen,Willem II,3,1,1,3,0,4,2,7.0,9.0
10389,1994-1995,2,FC Utrecht,sc Heerenveen,4,0,1,3,0,4,4,8.0,6.0
10390,1994-1995,2,sc Heerenveen,MVV Maastricht,0,4,2,0,3,4,-4,6.0,4.0
10391,1994-1995,2,Dordrecht '90,RKC Waalwijk,0,1,2,0,3,1,-1,8.0,10.0
10392,1994-1995,3,Sparta Rotterdam,FC Twente,3,4,2,0,3,7,-1,6.0,11.0
10393,1994-1995,3,NEC Nijmegen,FC Volendam,0,0,3,1,1,0,0,7.0,10.0
10394,1994-1995,3,FC Groningen,NAC Breda,3,4,2,0,3,7,-1,4.0,5.0
10395,1994-1995,3,Go Ahead Eagles,Feyenoord,2,2,3,1,1,4,0,2.0,9.0
10396,1994-1995,3,AFC Ajax,Vitesse,5,0,1,3,0,5,5,12.0,5.0
10397,1994-1995,3,Willem II,FC Utrecht,0,1,2,0,3,1,-1,6.0,11.0
10398,1994-1995,3,PSV,Dordrecht '90,4,0,1,3,0,4,4,12.0,5.0
10399,1994-1995,3,MVV Maastricht,Willem II,3,0,1,3,0,3,3,7.0,6.0
10400,1994-1995,3,FC Twente,Go Ahead Eagles,3,0,1,3,0,3,3,11.0,1.0
10401,1994-1995,4,RKC Waalwijk,Sparta Rotterdam,2,2,3,1,1,4,0,8.0,7.0
10402,1994-1995,4,FC Volendam,sc Heerenveen,1,2,2,0,3,3,-1,7.0,9.0
10403,1994-1995,4,Vitesse,Roda JC Kerkrade,1,1,3,1,1,2,0,3.0,3.0
10404,1994-1995,4,FC Utrecht,FC Groningen,2,1,1,3,0,3,1,13.0,4.0
10405,1994-1995,4,NEC Nijmegen,FC Twente,0,1,2,0,3,1,-1,7.0,11.0
10406,1994-1995,4,Sparta Rotterdam,PSV,1,1,3,1,1,2,0,5.0,10.0
10407,1994-1995,4,Roda JC Kerkrade,AFC Ajax,1,1,3,1,1,2,0,4.0,10.0
10408,1994-1995,4,FC Groningen,MVV Maastricht,0,1,2,0,3,1,-1,3.0,9.0
10409,1994-1995,4,Dordrecht '90,Vitesse,0,0,3,1,1,0,0,3.0,3.0
10410,1994-1995,5,sc Heerenveen,Feyenoord,0,4,2,0,3,4,-4,6.0,11.0
10411,1994-1995,5,Go Ahead Eagles,RKC Waalwijk,4,2,1,3,0,6,2,4.0,5.0
10412,1994-1995,5,Willem II,FC Volendam,4,0,1,3,0,4,4,6.0,7.0
10413,1994-1995,5,AFC Ajax,Dordrecht '90,3,0,1,3,0,3,3,10.0,2.0
10414,1994-1995,5,NAC Breda,Roda JC Kerkrade,2,4,2,0,3,6,-2,5.0,7.0
10415,1994-1995,5,Vitesse,Sparta Rotterdam,2,0,1,3,0,2,2,6.0,2.0
10416,1994-1995,5,MVV Maastricht,FC Utrecht,3,2,1,3,0,5,1,12.0,12.0
10417,1994-1995,5,FC Twente,sc Heerenveen,4,3,1,3,0,7,1,13.0,3.0
10418,1994-1995,5,FC Volendam,FC Groningen,1,1,3,1,1,2,0,5.0,4.0
10419,1994-1995,6,RKC Waalwijk,NEC Nijmegen,1,3,2,0,3,4,-2,5.0,7.0
10420,1994-1995,6,Feyenoord,Willem II,0,2,2,0,3,2,-2,8.0,6.0
10421,1994-1995,6,NEC Nijmegen,PSV,2,2,3,1,1,4,0,8.0,11.0
10422,1994-1995,6,Willem II,FC Twente,2,2,3,1,1,4,0,7.0,13.0
10423,1994-1995,6,sc Heerenveen,RKC Waalwijk,1,0,1,3,0,1,1,6.0,4.0
10424,1994-1995,6,MVV Maastricht,NAC Breda,2,3,2,0,3,5,-1,12.0,7.0
10425,1994-1995,6,Dordrecht '90,Roda JC Kerkrade,0,3,2,0,3,3,-3,1.0,9.0
10426,1994-1995,6,Go Ahead Eagles,Vitesse,0,0,3,1,1,0,0,5.0,6.0
10427,1994-1995,6,Sparta Rotterdam,AFC Ajax,0,2,2,0,3,2,-2,2.0,13.0
10428,1994-1995,7,FC Groningen,Feyenoord,1,1,3,1,1,2,0,2.0,8.0
10429,1994-1995,7,FC Utrecht,FC Volendam,0,0,3,1,1,0,0,10.0,3.0
10430,1994-1995,7,Go Ahead Eagles,MVV Maastricht,1,1,3,1,1,2,0,6.0,10.0
10431,1994-1995,7,Sparta Rotterdam,FC Volendam,2,0,1,3,0,2,2,5.0,2.0
10432,1994-1995,7,FC Utrecht,NAC Breda,2,2,3,1,1,4,0,8.0,8.0
10433,1994-1995,7,Roda JC Kerkrade,Sparta Rotterdam,1,0,1,3,0,1,1,11.0,4.0
10434,1994-1995,7,PSV,sc Heerenveen,3,1,1,3,0,4,2,11.0,6.0
10435,1994-1995,7,NAC Breda,Dordrecht '90,1,1,3,1,1,2,0,8.0,2.0
10436,1994-1995,7,FC Twente,FC Groningen,2,2,3,1,1,4,0,11.0,3.0
10437,1994-1995,8,Vitesse,NEC Nijmegen,2,0,1,3,0,2,2,9.0,5.0
10438,1994-1995,8,Feyenoord,FC Utrecht,3,0,1,3,0,3,3,8.0,5.0
10439,1994-1995,8,AFC Ajax,Go Ahead Eagles,4,0,1,3,0,4,4,13.0,5.0
10440,1994-1995,8,RKC Waalwijk,Willem II,1,1,3,1,1,2,0,2.0,8.0
10441,1994-1995,8,FC Volendam,MVV Maastricht,1,1,3,1,1,2,0,3.0,8.0
10442,1994-1995,8,sc Heerenveen,Vitesse,3,0,1,3,0,3,3,6.0,8.0
10443,1994-1995,8,Roda JC Kerkrade,NEC Nijmegen,3,1,1,3,0,4,2,13.0,4.0
10444,1994-1995,8,NAC Breda,Sparta Rotterdam,1,3,2,0,3,4,-2,5.0,6.0
10445,1994-1995,8,PSV,AFC Ajax,1,4,2,0,3,5,-3,8.0,13.0
10446,1994-1995,9,MVV Maastricht,Feyenoord,1,4,2,0,3,5,-3,5.0,10.0
10447,1994-1995,9,Willem II,PSV,2,1,1,3,0,3,1,11.0,5.0
10448,1994-1995,9,Sparta Rotterdam,Dordrecht '90,3,1,1,3,0,4,2,9.0,2.0
10449,1994-1995,9,FC Groningen,RKC Waalwijk,3,1,1,3,0,4,2,6.0,1.0
10450,1994-1995,9,Go Ahead Eagles,Roda JC Kerkrade,0,4,2,0,3,4,-4,5.0,15.0
10451,1994-1995,9,AFC Ajax,sc Heerenveen,5,1,1,3,0,6,4,15.0,6.0
10452,1994-1995,9,FC Volendam,NAC Breda,1,1,3,1,1,2,0,4.0,6.0
10453,1994-1995,9,Dordrecht '90,Go Ahead Eagles,1,1,3,1,1,2,0,2.0,3.0
10454,1994-1995,9,PSV,FC Groningen,5,0,1,3,0,5,5,7.0,6.0
10455,1994-1995,10,Feyenoord,FC Volendam,5,2,1,3,0,7,3,10.0,3.0
10456,1994-1995,10,Roda JC Kerkrade,PSV,3,0,1,3,0,3,3,15.0,6.0
10457,1994-1995,10,sc Heerenveen,Roda JC Kerkrade,0,0,3,1,1,0,0,7.0,13.0
10458,1994-1995,10,Go Ahead Eagles,Sparta Rotterdam,1,1,3,1,1,2,0,3.0,10.0
10459,1994-1995,10,MVV Maastricht,RKC Waalwijk,2,1,1,3,0,3,1,5.0,1.0
10460,1994-1995,10,Willem II,AFC Ajax,1,4,2,0,3,5,-3,8.0,15.0
10461,1994-1995,10,NEC Nijmegen,Dordrecht '90,4,0,1,3,0,4,4,7.0,2.0
10462,1994-1995,10,Feyenoord,NAC Breda,1,0,1,3,0,1,1,13.0,3.0
10463,1994-1995,10,FC Groningen,Vitesse,1,1,3,1,1,2,0,6.0,8.0
10464,1994-1995,11,FC Volendam,FC Twente,0,2,2,0,3,2,-2,2.0,11.0
10465,1994-1995,11,FC Utrecht,PSV,1,2,2,0,3,3,-1,2.0,6.0
10466,1994-1995,11,NAC Breda,Go Ahead Eagles,3,0,1,3,0,3,3,5.0,2.0
10467,1994-1995,11,Vitesse,FC Utrecht,2,1,1,3,0,3,1,8.0,2.0
10468,1994-1995,11,Roda JC Kerkrade,Willem II,3,0,1,3,0,3,3,13.0,5.0
10469,1994-1995,11,PSV,MVV Maastricht,4,0,1,3,0,4,4,9.0,5.0
10470,1994-1995,11,AFC Ajax,FC Groningen,3,1,1,3,0,4,2,15.0,5.0
10471,1994-1995,11,RKC Waalwijk,FC Volendam,2,3,2,0,3,5,-1,1.0,5.0
10472,1994-1995,11,Feyenoord,NEC Nijmegen,3,2,1,3,0,5,1,15.0,4.0
10473,1994-1995,12,Dordrecht '90,sc Heerenveen,1,1,3,1,1,2,0,3.0,5.0
10474,1994-1995,12,Sparta Rotterdam,NEC Nijmegen,2,0,1,3,0,2,2,10.0,3.0
10475,1994-1995,12,FC Utrecht,FC Twente,0,4,2,0,3,4,-4,1.0,11.0
10476,1994-1995,12,sc Heerenveen,Sparta Rotterdam,1,0,1,3,0,1,1,8.0,10.0
10477,1994-1995,12,Willem II,Dordrecht '90,1,0,1,3,0,1,1,7.0,2.0
10478,1994-1995,12,FC Volendam,PSV,0,0,3,1,1,0,0,5.0,10.0
10479,1994-1995,12,MVV Maastricht,Vitesse,2,3,2,0,3,5,-1,4.0,10.0
10480,1994-1995,12,FC Utrecht,AFC Ajax,0,0,3,1,1,0,0,1.0,13.0
10481,1994-1995,12,NEC Nijmegen,Go Ahead Eagles,2,1,1,3,0,3,1,6.0,2.0
10482,1994-1995,13,FC Twente,Feyenoord,5,1,1,3,0,6,4,11.0,12.0
10483,1994-1995,13,FC Groningen,Roda JC Kerkrade,0,2,2,0,3,2,-2,4.0,13.0
10484,1994-1995,13,FC Twente,NAC Breda,2,1,1,3,0,3,1,13.0,4.0
10485,1994-1995,13,Dordrecht '90,FC Groningen,0,1,2,0,3,1,-1,2.0,4.0
10486,1994-1995,13,Go Ahead Eagles,sc Heerenveen,0,4,2,0,3,4,-4,2.0,8.0
10487,1994-1995,13,NAC Breda,NEC Nijmegen,2,0,1,3,0,2,2,7.0,6.0
10488,1994-1995,13,Roda JC Kerkrade,FC Utrecht,1,0,1,3,0,1,1,13.0,1.0
10489,1994-1995,13,PSV,Feyenoord,4,1,1,3,0,5,3,10.0,9.0
10490,1994-1995,13,Vitesse,FC Volendam,0,0,3,1,1,0,0,8.0,5.0
10491,1994-1995,14,Sparta Rotterdam,Willem II,0,2,2,0,3,2,-2,7.0,9.0
10492,1994-1995,14,RKC Waalwijk,FC Twente,1,0,1,3,0,1,1,4.0,12.0
10493,1994-1995,14,AFC Ajax,MVV Maastricht,3,1,1,3,0,4,2,13.0,3.0
10494,1994-1995,14,MVV Maastricht,Roda JC Kerkrade,1,1,3,1,1,2,0,4.0,11.0
10495,1994-1995,14,Willem II,Go Ahead Eagles,4,0,1,3,0,4,4,9.0,1.0
10496,1994-1995,14,sc Heerenveen,NEC Nijmegen,4,2,1,3,0,6,2,11.0,3.0
10497,1994-1995,14,FC Twente,PSV,2,2,3,1,1,4,0,10.0,11.0
10498,1994-1995,14,RKC Waalwijk,NAC Breda,2,0,1,3,0,2,2,6.0,6.0
10499,1994-1995,14,FC Volendam,AFC Ajax,2,2,3,1,1,4,0,6.0,11.0
10500,1994-1995,15,FC Utrecht,Dordrecht '90,3,1,1,3,0,4,2,4.0,1.0
10501,1994-1995,15,FC Groningen,Sparta Rotterdam,4,0,1,3,0,4,4,7.0,4.0
10502,1994-1995,15,Feyenoord,Vitesse,0,3,2,0,3,3,-3,6.0,11.0
10503,1994-1995,15,PSV,RKC Waalwijk,2,2,3,1,1,4,0,9.0,7.0
10504,1994-1995,15,sc Heerenveen,NAC Breda,4,3,1,3,0,7,1,13.0,6.0
10505,1994-1995,15,Vitesse,Willem II,3,1,1,3,0,4,2,13.0,9.0
10506,1994-1995,15,FC Twente,MVV Maastricht,3,0,1,3,0,3,3,10.0,1.0
10507,1994-1995,15,Sparta Rotterdam,FC Utrecht,5,0,1,3,0,5,5,6.0,4.0
10508,1994-1995,15,Dordrecht '90,MVV Maastricht,1,2,2,0,3,3,-1,1.0,4.0
10509,1994-1995,16,Roda JC Kerkrade,FC Volendam,2,1,1,3,0,3,1,13.0,6.0
10510,1994-1995,16,Go Ahead Eagles,FC Groningen,2,4,2,0,3,6,-2,0.0,9.0
10511,1994-1995,16,Vitesse,FC Twente,6,1,1,3,0,7,5,13.0,7.0
10512,1994-1995,16,NEC Nijmegen,Willem II,2,2,3,1,1,4,0,4.0,10.0
10513,1994-1995,16,NAC Breda,AFC Ajax,2,2,3,1,1,4,0,4.0,9.0
10514,1994-1995,16,Feyenoord,RKC Waalwijk,1,0,1,3,0,1,1,6.0,7.0
10515,1994-1995,16,NEC Nijmegen,AFC Ajax,0,2,2,0,3,2,-2,4.0,9.0
10516,1994-1995,16,RKC Waalwijk,AFC Ajax,1,1,3,1,1,2,0,8.0,9.0
10517,1994-1995,16,MVV Maastricht,Go Ahead Eagles,1,1,3,1,1,2,0,5.0,1.0
10518,1994-1995,17,NAC Breda,Willem II,0,0,3,1,1,0,0,5.0,8.0
10519,1994-1995,17,FC Utrecht,NEC Nijmegen,2,2,3,1,1,4,0,5.0,2.0
10520,1994-1995,17,FC Volendam,Sparta Rotterdam,1,0,1,3,0,1,1,6.0,3.0
10521,1994-1995,17,FC Groningen,sc Heerenveen,0,0,3,1,1,0,0,10.0,13.0
10522,1994-1995,17,Feyenoord,Dordrecht '90,5,4,1,3,0,9,1,6.0,0.0
10523,1994-1995,17,Willem II,FC Groningen,3,0,1,3,0,3,3,8.0,10.0
10524,1994-1995,17,Roda JC Kerkrade,RKC Waalwijk,2,0,1,3,0,2,2,13.0,5.0
10525,1994-1995,17,Go Ahead Eagles,FC Volendam,0,2,2,0,3,2,-2,1.0,8.0
10526,1994-1995,17,Dordrecht '90,FC Twente,1,2,2,0,3,3,-1,0.0,7.0
10527,1994-1995,18,sc Heerenveen,FC Utrecht,2,0,1,3,0,2,2,13.0,4.0
10528,1994-1995,18,Feyenoord,Sparta Rotterdam,4,0,1,3,0,4,4,9.0,3.0
10529,1994-1995,18,AFC Ajax,PSV,1,0,1,3,0,1,1,9.0,6.0
10530,1994-1995,18,Vitesse,NAC Breda,1,1,3,1,1,2,0,11.0,3.0
10531,1994-1995,18,NEC Nijmegen,MVV Maastricht,4,0,1,3,0,4,4,5.0,5.0
10532,1994-1995,18,FC Twente,Sparta Rotterdam,3,3,3,1,1,6,0,8.0,4.0
10533,1994-1995,18,PSV,Roda JC Kerkrade,5,0,1,3,0,5,5,8.0,10.0
10534,1994-1995,18,FC Utrecht,Willem II,0,0,3,1,1,0,0,5.0,6.0
10535,1994-1995,18,Vitesse,AFC Ajax,2,3,2,0,3,5,-1,10.0,11.0
10536,1994-1995,19,FC Volendam,NEC Nijmegen,5,1,1,3,0,6,4,10.0,5.0
10537,1994-1995,19,RKC Waalwijk,Dordrecht '90,4,1,1,3,0,5,3,5.0,0.0
10538,1994-1995,19,Dordrecht '90,PSV,0,2,2,0,3,2,-2,0.0,8.0
10539,1994-1995,19,sc Heerenveen,FC Volendam,4,0,1,3,0,4,4,13.0,9.0
10540,1994-1995,19,Roda JC Kerkrade,Vitesse,5,0,1,3,0,5,5,10.0,7.0
10541,1994-1995,19,Willem II,MVV Maastricht,1,0,1,3,0,1,1,9.0,4.0
10542,1994-1995,19,Sparta Rotterdam,RKC Waalwijk,5,2,1,3,0,7,3,7.0,4.0
10543,1994-1995,19,AFC Ajax,NAC Breda,3,1,1,3,0,4,2,13.0,3.0
10544,1994-1995,19,sc Heerenveen,FC Twente,1,4,2,0,3,5,-3,10.0,10.0
10545,1994-1995,20,FC Volendam,Willem II,0,0,3,1,1,0,0,10.0,9.0
10546,1994-1995,20,MVV Maastricht,Sparta Rotterdam,0,0,3,1,1,0,0,5.0,5.0
10547,1994-1995,20,PSV,Vitesse,3,2,1,3,0,5,1,10.0,4.0
10548,1994-1995,20,AFC Ajax,Feyenoord,4,1,1,3,0,5,3,13.0,9.0
10549,1994-1995,20,FC Groningen,NEC Nijmegen,2,2,3,1,1,4,0,8.0,5.0
10550,1994-1995,20,RKC Waalwijk,FC Utrecht,2,1,1,3,0,3,1,7.0,2.0
10551,1994-1995,20,MVV Maastricht,FC Groningen,0,1,2,0,3,1,-1,2.0,8.0
10552,1994-1995,20,Vitesse,Dordrecht '90,2,0,1,3,0,2,2,4.0,0.0
10553,1994-1995,20,FC Twente,NEC Nijmegen,1,1,3,1,1,2,0,8.0,6.0
10554,1994-1995,21,NAC Breda,FC Utrecht,4,0,1,3,0,4,4,6.0,2.0
10555,1994-1995,21,PSV,Sparta Rotterdam,4,0,1,3,0,4,4,12.0,5.0
10556,1994-1995,21,RKC Waalwijk,Go Ahead Eagles,2,1,1,3,0,3,1,9.0,1.0
10557,1994-1995,21,Feyenoord,sc Heerenveen,2,1,1,3,0,3,1,12.0,7.0
10558,1994-1995,21,AFC Ajax,Roda JC Kerkrade,1,1,3,1,1,2,0,13.0,10.0
10559,1994-1995,21,Roda JC Kerkrade,NAC Breda,2,0,1,3,0,2,2,10.0,5.0
10560,1994-1995,21,FC Groningen,FC Volendam,2,2,3,1,1,4,0,6.0,8.0
10561,1994-1995,21,NEC Nijmegen,RKC Waalwijk,1,2,2,0,3,3,-1,5.0,12.0
10562,1994-1995,21,Sparta Rotterdam,Vitesse,1,1,3,1,1,2,0,6.0,4.0
10563,1994-1995,22,FC Utrecht,MVV Maastricht,7,2,1,3,0,9,5,4.0,1.0
10564,1994-1995,22,Dordrecht '90,AFC Ajax,1,3,2,0,3,4,-2,0.0,13.0
10565,1994-1995,22,Willem II,Feyenoord,1,2,2,0,3,3,-1,8.0,12.0
10566,1994-1995,22,Go Ahead Eagles,PSV,1,1,3,1,1,2,0,2.0,13.0
10567,1994-1995,22,Feyenoord,Go Ahead Eagles,0,0,3,1,1,0,0,10.0,3.0
10568,1994-1995,22,FC Twente,Roda JC Kerkrade,1,2,2,0,3,3,-1,8.0,10.0
10569,1994-1995,22,FC Groningen,FC Utrecht,1,1,3,1,1,2,0,6.0,5.0
10570,1994-1995,22,RKC Waalwijk,sc Heerenveen,1,1,3,1,1,2,0,10.0,7.0
10571,1994-1995,22,PSV,NEC Nijmegen,3,0,1,3,0,3,3,13.0,2.0
10572,1994-1995,23,Roda JC Kerkrade,Dordrecht '90,2,0,1,3,0,2,2,13.0,0.0
10573,1994-1995,23,NAC Breda,MVV Maastricht,2,1,1,3,0,3,1,7.0,1.0
10574,1994-1995,23,FC Twente,Willem II,0,3,2,0,3,3,-3,5.0,8.0
10575,1994-1995,23,Vitesse,Go Ahead Eagles,5,0,1,3,0,5,5,7.0,2.0
10576,1994-1995,23,Feyenoord,FC Groningen,4,2,1,3,0,6,2,10.0,6.0
10577,1994-1995,23,NAC Breda,PSV,1,2,2,0,3,3,-1,6.0,13.0
10578,1994-1995,23,FC Volendam,Dordrecht '90,1,0,1,3,0,1,1,8.0,0.0
10579,1994-1995,23,RKC Waalwijk,Vitesse,0,0,3,1,1,0,0,11.0,8.0
10580,1994-1995,23,Willem II,sc Heerenveen,3,1,1,3,0,4,2,10.0,4.0
10581,1994-1995,24,Go Ahead Eagles,FC Twente,0,2,2,0,3,2,-2,2.0,7.0
10582,1994-1995,24,Willem II,RKC Waalwijk,1,0,1,3,0,1,1,10.0,8.0
10583,1994-1995,24,MVV Maastricht,FC Volendam,1,1,3,1,1,2,0,2.0,6.0
10584,1994-1995,24,sc Heerenveen,PSV,1,2,2,0,3,3,-1,1.0,13.0
10585,1994-1995,24,NEC Nijmegen,Vitesse,0,1,2,0,3,1,-1,2.0,11.0
10586,1994-1995,24,FC Groningen,FC Twente,1,2,2,0,3,3,-1,5.0,7.0
10587,1994-1995,24,Sparta Rotterdam,Roda JC Kerkrade,0,0,3,1,1,0,0,6.0,11.0
10588,1994-1995,24,Dordrecht '90,NAC Breda,2,5,2,0,3,7,-3,0.0,9.0
10589,1994-1995,24,Go Ahead Eagles,AFC Ajax,1,2,2,0,3,3,-1,2.0,13.0
10590,1994-1995,25,FC Utrecht,Feyenoord,0,0,3,1,1,0,0,5.0,11.0
10591,1994-1995,25,PSV,Willem II,3,2,1,3,0,5,1,13.0,9.0
10592,1994-1995,25,NAC Breda,FC Volendam,0,1,2,0,3,1,-1,6.0,9.0
10593,1994-1995,25,Dordrecht '90,Sparta Rotterdam,3,1,1,3,0,4,2,3.0,3.0
10594,1994-1995,25,Vitesse,sc Heerenveen,3,1,1,3,0,4,2,11.0,1.0
10595,1994-1995,25,FC Twente,FC Utrecht,2,1,1,3,0,3,1,9.0,5.0
10596,1994-1995,25,Roda JC Kerkrade,Go Ahead Eagles,3,2,1,3,0,5,1,13.0,1.0
10597,1994-1995,25,RKC Waalwijk,FC Groningen,3,0,1,3,0,3,3,8.0,2.0
10598,1994-1995,25,AFC Ajax,NEC Nijmegen,5,1,1,3,0,6,4,13.0,1.0
10599,1994-1995,26,Feyenoord,MVV Maastricht,6,1,1,3,0,7,5,11.0,1.0
10600,1994-1995,26,AFC Ajax,Sparta Rotterdam,8,0,1,3,0,8,8,13.0,2.0
10601,1994-1995,26,Dordrecht '90,Willem II,3,0,1,3,0,3,3,6.0,9.0
10602,1994-1995,26,MVV Maastricht,sc Heerenveen,1,0,1,3,0,1,1,4.0,1.0
10603,1994-1995,26,NAC Breda,FC Groningen,1,3,2,0,3,4,-2,6.0,4.0
10604,1994-1995,26,FC Twente,AFC Ajax,0,1,2,0,3,1,-1,9.0,15.0
10605,1994-1995,26,Feyenoord,Roda JC Kerkrade,1,2,2,0,3,3,-1,8.0,13.0
10606,1994-1995,26,FC Utrecht,Go Ahead Eagles,2,2,3,1,1,4,0,6.0,1.0
10607,1994-1995,26,Go Ahead Eagles,Dordrecht '90,1,3,2,0,3,4,-2,1.0,9.0
10608,1994-1995,27,Willem II,Vitesse,1,1,3,1,1,2,0,7.0,11.0
10609,1994-1995,27,MVV Maastricht,FC Twente,0,1,2,0,3,1,-1,4.0,12.0
10610,1994-1995,27,FC Groningen,PSV,3,2,1,3,0,5,1,6.0,12.0
10611,1994-1995,27,FC Volendam,Feyenoord,0,3,2,0,3,3,-3,8.0,10.0
10612,1994-1995,27,FC Utrecht,RKC Waalwijk,0,0,3,1,1,0,0,4.0,6.0
10613,1994-1995,27,NEC Nijmegen,Roda JC Kerkrade,3,1,1,3,0,4,2,3.0,10.0
10614,1994-1995,27,sc Heerenveen,AFC Ajax,3,3,3,1,1,6,0,1.0,13.0
10615,1994-1995,27,Sparta Rotterdam,NAC Breda,1,2,2,0,3,3,-1,2.0,6.0
10616,1994-1995,27,Roda JC Kerkrade,sc Heerenveen,1,0,1,3,0,1,1,10.0,1.0
10617,1994-1995,28,Dordrecht '90,NEC Nijmegen,1,0,1,3,0,1,1,12.0,3.0
10618,1994-1995,28,FC Twente,FC Volendam,2,0,1,3,0,2,2,12.0,7.0
10619,1994-1995,28,RKC Waalwijk,MVV Maastricht,1,1,3,1,1,2,0,6.0,5.0
10620,1994-1995,28,Vitesse,FC Groningen,0,0,3,1,1,0,0,9.0,7.0
10621,1994-1995,28,NAC Breda,Feyenoord,1,2,2,0,3,3,-1,6.0,10.0
10622,1994-1995,28,AFC Ajax,Willem II,7,0,1,3,0,7,7,13.0,4.0
10623,1994-1995,28,PSV,FC Utrecht,4,0,1,3,0,4,4,12.0,3.0
10624,1994-1995,28,Sparta Rotterdam,Go Ahead Eagles,1,2,2,0,3,3,-1,1.0,4.0
10625,1994-1995,28,NEC Nijmegen,Feyenoord,0,1,2,0,3,1,-1,3.0,12.0
10626,1994-1995,29,MVV Maastricht,PSV,2,3,2,0,3,5,-1,4.0,12.0
10627,1994-1995,29,Go Ahead Eagles,NAC Breda,5,1,1,3,0,6,4,7.0,3.0
10628,1994-1995,29,FC Groningen,AFC Ajax,2,4,2,0,3,6,-2,7.0,13.0
10629,1994-1995,29,sc Heerenveen,Dordrecht '90,1,1,3,1,1,2,0,2.0,13.0
10630,1994-1995,29,Willem II,Roda JC Kerkrade,0,0,3,1,1,0,0,2.0,10.0
10631,1994-1995,29,FC Volendam,RKC Waalwijk,0,2,2,0,3,2,-2,4.0,8.0
10632,1994-1995,29,FC Utrecht,Vitesse,1,4,2,0,3,5,-3,2.0,11.0
10633,1994-1995,29,Feyenoord,FC Twente,0,3,2,0,3,3,-3,9.0,12.0
10634,1994-1995,29,NEC Nijmegen,Sparta Rotterdam,1,1,3,1,1,2,0,4.0,1.0
10635,1994-1995,30,Go Ahead Eagles,NEC Nijmegen,3,2,1,3,0,5,1,10.0,4.0
10636,1994-1995,30,FC Volendam,FC Utrecht,0,1,2,0,3,1,-1,3.0,5.0
10637,1994-1995,30,NAC Breda,FC Twente,2,1,1,3,0,3,1,6.0,9.0
10638,1994-1995,30,Roda JC Kerkrade,FC Groningen,2,1,1,3,0,3,1,10.0,7.0
10639,1994-1995,30,PSV,FC Volendam,1,1,3,1,1,2,0,10.0,1.0
10640,1994-1995,30,RKC Waalwijk,Feyenoord,2,1,1,3,0,3,1,11.0,9.0
10641,1994-1995,30,Sparta Rotterdam,sc Heerenveen,2,0,1,3,0,2,2,4.0,2.0
10642,1994-1995,30,Vitesse,MVV Maastricht,2,1,1,3,0,3,1,11.0,4.0
10643,1994-1995,30,MVV Maastricht,AFC Ajax,0,3,2,0,3,3,-3,1.0,13.0
10644,1994-1995,31,Willem II,Sparta Rotterdam,1,0,1,3,0,1,1,5.0,4.0
10645,1994-1995,31,FC Groningen,Dordrecht '90,2,2,3,1,1,4,0,5.0,11.0
10646,1994-1995,31,sc Heerenveen,Go Ahead Eagles,0,1,2,0,3,1,-1,2.0,12.0
10647,1994-1995,31,Feyenoord,PSV,3,2,1,3,0,5,1,9.0,7.0
10648,1994-1995,31,FC Volendam,Vitesse,3,2,1,3,0,5,1,4.0,8.0
10649,1994-1995,31,FC Utrecht,Roda JC Kerkrade,2,4,2,0,3,6,-2,4.0,10.0
10650,1994-1995,31,NEC Nijmegen,NAC Breda,0,1,2,0,3,1,-1,1.0,9.0
10651,1994-1995,31,FC Twente,RKC Waalwijk,1,1,3,1,1,2,0,10.0,9.0
10652,1994-1995,31,AFC Ajax,FC Utrecht,2,1,1,3,0,3,1,13.0,3.0
10653,1994-1995,32,Roda JC Kerkrade,MVV Maastricht,4,0,1,3,0,4,4,13.0,1.0
10654,1994-1995,32,NAC Breda,RKC Waalwijk,1,2,2,0,3,3,-1,6.0,11.0
10655,1994-1995,32,Go Ahead Eagles,Willem II,4,2,1,3,0,6,2,15.0,5.0
10656,1994-1995,32,AFC Ajax,FC Volendam,4,1,1,3,0,5,3,15.0,4.0
10657,1994-1995,32,NEC Nijmegen,sc Heerenveen,3,0,1,3,0,3,3,4.0,1.0
10658,1994-1995,32,Vitesse,Feyenoord,0,3,2,0,3,3,-3,7.0,9.0
10659,1994-1995,32,Dordrecht '90,FC Utrecht,1,1,3,1,1,2,0,9.0,4.0
10660,1994-1995,32,Sparta Rotterdam,FC Groningen,3,1,1,3,0,4,2,7.0,2.0
10661,1994-1995,32,PSV,FC Twente,3,1,1,3,0,4,2,10.0,7.0
10662,1994-1995,33,Feyenoord,AFC Ajax,0,5,2,0,3,5,-5,6.0,15.0
10663,1994-1995,33,FC Utrecht,Sparta Rotterdam,0,0,3,1,1,0,0,5.0,8.0
10664,1994-1995,33,NAC Breda,sc Heerenveen,2,3,2,0,3,5,-1,6.0,4.0
10665,1994-1995,33,FC Twente,Vitesse,1,3,2,0,3,4,-2,4.0,9.0
10666,1994-1995,33,FC Volendam,Roda JC Kerkrade,3,3,3,1,1,6,0,5.0,11.0
10667,1994-1995,33,RKC Waalwijk,PSV,2,4,2,0,3,6,-2,10.0,10.0
10668,1994-1995,33,MVV Maastricht,Dordrecht '90,3,3,3,1,1,6,0,1.0,7.0
10669,1994-1995,33,Willem II,NEC Nijmegen,1,3,2,0,3,4,-2,4.0,7.0
10670,1994-1995,33,FC Groningen,Go Ahead Eagles,2,3,2,0,3,5,-1,1.0,15.0
10671,1994-1995,34,Vitesse,RKC Waalwijk,1,1,3,1,1,2,0,7.0,8.0
10672,1994-1995,34,sc Heerenveen,Willem II,1,0,1,3,0,1,1,6.0,4.0
10673,1994-1995,34,Roda JC Kerkrade,Feyenoord,5,0,1,3,0,5,5,13.0,6.0
10674,1994-1995,34,AFC Ajax,FC Twente,3,1,1,3,0,4,2,15.0,1.0
10675,1994-1995,34,Dordrecht '90,FC Volendam,5,1,1,3,0,6,4,7.0,5.0
10676,1994-1995,34,Go Ahead Eagles,FC Utrecht,2,4,2,0,3,6,-2,12.0,5.0
10677,1994-1995,34,NEC Nijmegen,FC Groningen,2,1,1,3,0,3,1,9.0,1.0
10678,1994-1995,34,PSV,NAC Breda,2,4,2,0,3,6,-2,7.0,9.0
10679,1994-1995,34,Sparta Rotterdam,MVV Maastricht,2,2,3,1,1,4,0,8.0,2.0
10680,1995-1996,1,Fortuna Sittard,PSV,1,3,2,0,3,4,-2,5.0,9.0
10681,1995-1996,1,Willem II,Sparta Rotterdam,6,0,1,3,0,6,6,6.0,5.0
10682,1995-1996,1,Roda JC Kerkrade,sc Heerenveen,2,2,3,1,1,4,0,11.0,7.0
10683,1995-1996,1,Go Ahead Eagles,FC Groningen,2,2,3,1,1,4,0,10.0,2.0
10684,1995-1996,1,AFC Ajax,FC Utrecht,4,0,1,3,0,4,4,15.0,5.0
10685,1995-1996,1,FC Volendam,FC Twente,1,3,2,0,3,4,-2,4.0,4.0
10686,1995-1996,1,De Graafschap,NEC Nijmegen,2,3,2,0,3,5,-1,4.0,12.0
10687,1995-1996,1,Feyenoord,Vitesse,5,2,1,3,0,7,3,9.0,4.0
10688,1995-1996,1,Feyenoord,NAC Breda,2,2,3,1,1,4,0,7.0,7.0
10689,1995-1996,2,RKC Waalwijk,NAC Breda,2,2,3,1,1,4,0,6.0,5.0
10690,1995-1996,2,FC Groningen,Fortuna Sittard,2,0,1,3,0,2,2,4.0,2.0
10691,1995-1996,2,NEC Nijmegen,AFC Ajax,0,6,2,0,3,6,-6,12.0,15.0
10692,1995-1996,2,Go Ahead Eagles,Willem II,0,2,2,0,3,2,-2,7.0,6.0
10693,1995-1996,2,sc Heerenveen,RKC Waalwijk,2,1,1,3,0,3,1,10.0,5.0
10694,1995-1996,2,FC Utrecht,FC Volendam,2,2,3,1,1,4,0,6.0,2.0
10695,1995-1996,2,NAC Breda,PSV,3,0,1,3,0,3,3,8.0,9.0
10696,1995-1996,2,Vitesse,Roda JC Kerkrade,0,0,3,1,1,0,0,5.0,9.0
10697,1995-1996,2,FC Twente,Feyenoord,2,2,3,1,1,4,0,4.0,5.0
10698,1995-1996,3,Sparta Rotterdam,De Graafschap,4,1,1,3,0,5,3,8.0,1.0
10699,1995-1996,3,sc Heerenveen,FC Groningen,1,0,1,3,0,1,1,13.0,4.0
10700,1995-1996,3,RKC Waalwijk,Vitesse,0,2,2,0,3,2,-2,2.0,8.0
10701,1995-1996,3,Roda JC Kerkrade,FC Twente,0,0,3,1,1,0,0,7.0,5.0
10702,1995-1996,3,NEC Nijmegen,FC Utrecht,2,0,1,3,0,2,2,12.0,5.0
10703,1995-1996,3,Willem II,Fortuna Sittard,4,0,1,3,0,4,4,9.0,1.0
10704,1995-1996,3,PSV,sc Heerenveen,5,1,1,3,0,6,4,9.0,10.0
10705,1995-1996,3,Feyenoord,FC Volendam,5,1,1,3,0,6,4,8.0,2.0
10706,1995-1996,3,AFC Ajax,Sparta Rotterdam,4,0,1,3,0,4,4,15.0,5.0
10707,1995-1996,4,De Graafschap,Go Ahead Eagles,3,2,1,3,0,5,1,4.0,4.0
10708,1995-1996,4,FC Groningen,NAC Breda,3,1,1,3,0,4,2,7.0,8.0
10709,1995-1996,4,Sparta Rotterdam,NEC Nijmegen,3,1,1,3,0,4,2,7.0,9.0
10710,1995-1996,4,Vitesse,PSV,0,1,2,0,3,1,-1,5.0,9.0
10711,1995-1996,4,NAC Breda,Willem II,0,1,2,0,3,1,-1,5.0,12.0
10712,1995-1996,4,Fortuna Sittard,De Graafschap,1,0,1,3,0,1,1,4.0,3.0
10713,1995-1996,4,FC Utrecht,Feyenoord,1,0,1,3,0,1,1,7.0,8.0
10714,1995-1996,4,FC Twente,RKC Waalwijk,0,1,2,0,3,1,-1,5.0,5.0
10715,1995-1996,4,FC Volendam,Roda JC Kerkrade,1,0,1,3,0,1,1,4.0,6.0
10716,1995-1996,5,Go Ahead Eagles,AFC Ajax,0,4,2,0,3,4,-4,1.0,15.0
10717,1995-1996,5,De Graafschap,NAC Breda,1,1,3,1,1,2,0,4.0,5.0
10718,1995-1996,5,Sparta Rotterdam,FC Utrecht,0,0,3,1,1,0,0,7.0,5.0
10719,1995-1996,5,Willem II,sc Heerenveen,1,1,3,1,1,2,0,13.0,8.0
10720,1995-1996,5,PSV,FC Twente,3,0,1,3,0,3,3,12.0,5.0
10721,1995-1996,5,NEC Nijmegen,Go Ahead Eagles,0,2,2,0,3,2,-2,6.0,4.0
10722,1995-1996,5,RKC Waalwijk,FC Volendam,2,0,1,3,0,2,2,7.0,4.0
10723,1995-1996,5,Roda JC Kerkrade,Feyenoord,1,1,3,1,1,2,0,4.0,6.0
10724,1995-1996,5,FC Groningen,Vitesse,2,0,1,3,0,2,2,10.0,4.0
10725,1995-1996,6,AFC Ajax,Fortuna Sittard,4,0,1,3,0,4,4,15.0,3.0
10726,1995-1996,6,FC Volendam,PSV,0,5,2,0,3,5,-5,4.0,12.0
10727,1995-1996,6,FC Utrecht,Roda JC Kerkrade,0,1,2,0,3,1,-1,5.0,6.0
10728,1995-1996,6,sc Heerenveen,De Graafschap,2,2,3,1,1,4,0,8.0,5.0
10729,1995-1996,6,Go Ahead Eagles,Sparta Rotterdam,1,3,2,0,3,4,-2,3.0,10.0
10730,1995-1996,6,Fortuna Sittard,NEC Nijmegen,1,1,3,1,1,2,0,4.0,4.0
10731,1995-1996,6,Vitesse,Willem II,2,2,3,1,1,4,0,5.0,11.0
10732,1995-1996,6,FC Twente,FC Groningen,2,2,3,1,1,4,0,3.0,10.0
10733,1995-1996,6,Feyenoord,RKC Waalwijk,4,2,1,3,0,6,2,8.0,6.0
10734,1995-1996,7,NAC Breda,AFC Ajax,0,1,2,0,3,1,-1,4.0,15.0
10735,1995-1996,7,Willem II,FC Twente,5,2,1,3,0,7,3,11.0,2.0
10736,1995-1996,7,NEC Nijmegen,NAC Breda,1,3,2,0,3,4,-2,4.0,4.0
10737,1995-1996,7,Go Ahead Eagles,FC Utrecht,2,3,2,0,3,5,-1,3.0,7.0
10738,1995-1996,7,FC Groningen,FC Volendam,2,1,1,3,0,3,1,10.0,3.0
10739,1995-1996,7,RKC Waalwijk,Roda JC Kerkrade,2,0,1,3,0,2,2,9.0,5.0
10740,1995-1996,7,PSV,Feyenoord,3,0,1,3,0,3,3,15.0,7.0
10741,1995-1996,7,Sparta Rotterdam,Fortuna Sittard,0,1,2,0,3,1,-1,7.0,7.0
10742,1995-1996,7,De Graafschap,Vitesse,2,3,2,0,3,5,-1,5.0,7.0
10743,1995-1996,8,sc Heerenveen,AFC Ajax,0,4,2,0,3,4,-4,5.0,15.0
10744,1995-1996,8,Roda JC Kerkrade,PSV,1,1,3,1,1,2,0,5.0,13.0
10745,1995-1996,8,RKC Waalwijk,FC Utrecht,1,0,1,3,0,1,1,12.0,7.0
10746,1995-1996,8,NAC Breda,Sparta Rotterdam,0,0,3,1,1,0,0,5.0,8.0
10747,1995-1996,8,NEC Nijmegen,sc Heerenveen,1,3,2,0,3,4,-2,1.0,5.0
10748,1995-1996,8,FC Volendam,Willem II,0,0,3,1,1,0,0,4.0,9.0
10749,1995-1996,8,AFC Ajax,Vitesse,3,0,1,3,0,3,3,15.0,4.0
10750,1995-1996,8,Fortuna Sittard,Go Ahead Eagles,2,2,3,1,1,4,0,8.0,4.0
10751,1995-1996,8,De Graafschap,FC Twente,0,3,2,0,3,3,-3,2.0,4.0
10752,1995-1996,9,Feyenoord,FC Groningen,4,1,1,3,0,5,3,7.0,10.0
10753,1995-1996,9,FC Utrecht,Fortuna Sittard,2,3,2,0,3,5,-1,4.0,8.0
10754,1995-1996,9,sc Heerenveen,Sparta Rotterdam,4,0,1,3,0,4,4,8.0,5.0
10755,1995-1996,9,Go Ahead Eagles,NAC Breda,1,1,3,1,1,2,0,5.0,6.0
10756,1995-1996,9,PSV,RKC Waalwijk,4,0,1,3,0,4,4,13.0,9.0
10757,1995-1996,9,FC Groningen,Roda JC Kerkrade,0,1,2,0,3,1,-1,7.0,8.0
10758,1995-1996,9,FC Volendam,De Graafschap,1,1,3,1,1,2,0,2.0,3.0
10759,1995-1996,9,Willem II,Feyenoord,2,2,3,1,1,4,0,7.0,8.0
10760,1995-1996,9,FC Twente,AFC Ajax,0,3,2,0,3,3,-3,4.0,15.0
10761,1995-1996,10,Vitesse,NEC Nijmegen,2,2,3,1,1,4,0,5.0,2.0
10762,1995-1996,10,NAC Breda,FC Utrecht,3,0,1,3,0,3,3,8.0,3.0
10763,1995-1996,10,Sparta Rotterdam,FC Twente,4,2,1,3,0,6,2,7.0,4.0
10764,1995-1996,10,NEC Nijmegen,FC Volendam,2,1,1,3,0,3,1,5.0,2.0
10765,1995-1996,10,PSV,FC Groningen,7,1,1,3,0,8,6,13.0,4.0
10766,1995-1996,10,Go Ahead Eagles,Vitesse,1,3,2,0,3,4,-2,2.0,8.0
10767,1995-1996,10,Fortuna Sittard,sc Heerenveen,1,2,2,0,3,3,-1,8.0,10.0
10768,1995-1996,10,De Graafschap,Roda JC Kerkrade,0,2,2,0,3,2,-2,2.0,10.0
10769,1995-1996,10,Willem II,RKC Waalwijk,1,2,2,0,3,3,-1,6.0,9.0
10770,1995-1996,11,Feyenoord,AFC Ajax,2,4,2,0,3,6,-2,7.0,15.0
10771,1995-1996,11,FC Utrecht,PSV,1,4,2,0,3,5,-3,3.0,13.0
10772,1995-1996,11,RKC Waalwijk,FC Groningen,1,3,2,0,3,4,-2,9.0,6.0
10773,1995-1996,11,NAC Breda,Fortuna Sittard,2,0,1,3,0,2,2,11.0,7.0
10774,1995-1996,11,sc Heerenveen,Go Ahead Eagles,2,1,1,3,0,3,1,12.0,2.0
10775,1995-1996,11,Roda JC Kerkrade,Willem II,1,1,3,1,1,2,0,8.0,6.0
10776,1995-1996,11,FC Twente,NEC Nijmegen,2,0,1,3,0,2,2,6.0,4.0
10777,1995-1996,11,AFC Ajax,FC Volendam,4,0,1,3,0,4,4,15.0,2.0
10778,1995-1996,11,Sparta Rotterdam,Vitesse,3,0,1,3,0,3,3,7.0,7.0
10779,1995-1996,12,Feyenoord,De Graafschap,2,0,1,3,0,2,2,7.0,1.0
10780,1995-1996,12,AFC Ajax,Roda JC Kerkrade,6,1,1,3,0,7,5,15.0,8.0
10781,1995-1996,12,sc Heerenveen,NAC Breda,1,1,3,1,1,2,0,13.0,9.0
10782,1995-1996,12,PSV,Willem II,2,0,1,3,0,2,2,13.0,3.0
10783,1995-1996,12,De Graafschap,RKC Waalwijk,1,1,3,1,1,2,0,2.0,7.0
10784,1995-1996,12,NEC Nijmegen,Feyenoord,1,3,2,0,3,4,-2,4.0,10.0
10785,1995-1996,12,FC Volendam,Sparta Rotterdam,1,1,3,1,1,2,0,3.0,8.0
10786,1995-1996,12,FC Groningen,FC Utrecht,0,0,3,1,1,0,0,4.0,1.0
10787,1995-1996,12,FC Twente,Go Ahead Eagles,2,1,1,3,0,3,1,9.0,2.0
10788,1995-1996,13,Vitesse,Fortuna Sittard,5,1,1,3,0,6,4,7.0,4.0
10789,1995-1996,13,Go Ahead Eagles,FC Volendam,1,2,2,0,3,3,-1,1.0,5.0
10790,1995-1996,13,Fortuna Sittard,FC Twente,1,1,3,1,1,2,0,4.0,7.0
10791,1995-1996,13,Willem II,FC Groningen,5,2,1,3,0,7,3,5.0,4.0
10792,1995-1996,13,NEC Nijmegen,Roda JC Kerkrade,1,4,2,0,3,5,-3,4.0,10.0
10793,1995-1996,13,FC Utrecht,sc Heerenveen,1,1,3,1,1,2,0,2.0,11.0
10794,1995-1996,13,AFC Ajax,PSV,1,1,3,1,1,2,0,13.0,13.0
10795,1995-1996,13,Sparta Rotterdam,Feyenoord,3,2,1,3,0,5,1,10.0,7.0
10796,1995-1996,13,NAC Breda,Vitesse,2,2,3,1,1,4,0,9.0,8.0
10797,1995-1996,14,FC Groningen,De Graafschap,3,0,1,3,0,3,3,7.0,2.0
10798,1995-1996,14,RKC Waalwijk,AFC Ajax,0,3,2,0,3,3,-3,4.0,13.0
10799,1995-1996,14,PSV,De Graafschap,8,0,1,3,0,8,8,13.0,1.0
10800,1995-1996,14,Roda JC Kerkrade,Sparta Rotterdam,1,0,1,3,0,1,1,10.0,10.0
10801,1995-1996,14,RKC Waalwijk,NEC Nijmegen,4,0,1,3,0,4,4,7.0,3.0
10802,1995-1996,14,Vitesse,sc Heerenveen,2,2,3,1,1,4,0,8.0,9.0
10803,1995-1996,14,FC Utrecht,Willem II,3,3,3,1,1,6,0,3.0,5.0
10804,1995-1996,14,Feyenoord,Go Ahead Eagles,2,2,3,1,1,4,0,7.0,1.0
10805,1995-1996,14,AFC Ajax,FC Groningen,4,1,1,3,0,5,3,13.0,7.0
10806,1995-1996,15,FC Volendam,Fortuna Sittard,2,0,1,3,0,2,2,7.0,1.0
10807,1995-1996,15,FC Twente,NAC Breda,0,3,2,0,3,3,-3,7.0,11.0
10808,1995-1996,15,sc Heerenveen,FC Twente,1,1,3,1,1,2,0,7.0,8.0
10809,1995-1996,15,Fortuna Sittard,Feyenoord,1,0,1,3,0,1,1,4.0,7.0
10810,1995-1996,15,De Graafschap,Willem II,1,2,2,0,3,3,-1,1.0,8.0
10811,1995-1996,15,NAC Breda,FC Volendam,4,0,1,3,0,4,4,11.0,7.0
10812,1995-1996,15,Go Ahead Eagles,Roda JC Kerkrade,1,2,2,0,3,3,-1,1.0,10.0
10813,1995-1996,15,Vitesse,FC Utrecht,2,1,1,3,0,3,1,8.0,3.0
10814,1995-1996,15,Sparta Rotterdam,RKC Waalwijk,1,0,1,3,0,1,1,10.0,4.0
10815,1995-1996,16,NEC Nijmegen,PSV,0,5,2,0,3,5,-5,0.0,13.0
10816,1995-1996,16,Roda JC Kerkrade,Fortuna Sittard,1,1,3,1,1,2,0,10.0,5.0
10817,1995-1996,16,PSV,Sparta Rotterdam,1,2,2,0,3,3,-1,10.0,10.0
10818,1995-1996,16,FC Groningen,NEC Nijmegen,0,0,3,1,1,0,0,5.0,1.0
10819,1995-1996,16,RKC Waalwijk,Go Ahead Eagles,1,1,3,1,1,2,0,5.0,2.0
10820,1995-1996,16,FC Volendam,sc Heerenveen,1,1,3,1,1,2,0,8.0,5.0
10821,1995-1996,16,FC Twente,Vitesse,1,0,1,3,0,1,1,8.0,8.0
10822,1995-1996,16,De Graafschap,FC Utrecht,3,0,1,3,0,3,3,4.0,3.0
10823,1995-1996,16,sc Heerenveen,Feyenoord,0,1,2,0,3,1,-1,4.0,7.0
10824,1995-1996,17,NEC Nijmegen,Willem II,1,1,3,1,1,2,0,2.0,8.0
10825,1995-1996,17,Fortuna Sittard,RKC Waalwijk,0,0,3,1,1,0,0,6.0,5.0
10826,1995-1996,17,Sparta Rotterdam,FC Groningen,1,1,3,1,1,2,0,10.0,5.0
10827,1995-1996,17,FC Utrecht,FC Twente,0,3,2,0,3,3,-3,2.0,8.0
10828,1995-1996,17,Vitesse,FC Volendam,2,1,1,3,0,3,1,8.0,7.0
10829,1995-1996,17,Sparta Rotterdam,Willem II,1,1,3,1,1,2,0,8.0,9.0
10830,1995-1996,17,sc Heerenveen,Roda JC Kerkrade,3,2,1,3,0,5,1,6.0,10.0
10831,1995-1996,17,PSV,Fortuna Sittard,3,0,1,3,0,3,3,10.0,5.0
10832,1995-1996,17,NAC Breda,RKC Waalwijk,0,1,2,0,3,1,-1,8.0,8.0
10833,1995-1996,18,NEC Nijmegen,De Graafschap,1,1,3,1,1,2,0,3.0,4.0
10834,1995-1996,18,FC Groningen,Go Ahead Eagles,0,0,3,1,1,0,0,6.0,3.0
10835,1995-1996,18,Vitesse,Feyenoord,0,2,2,0,3,2,-2,7.0,7.0
10836,1995-1996,18,FC Twente,FC Volendam,2,1,1,3,0,3,1,10.0,4.0
10837,1995-1996,18,FC Utrecht,AFC Ajax,0,3,2,0,3,3,-3,1.0,13.0
10838,1995-1996,18,Go Ahead Eagles,PSV,0,5,2,0,3,5,-5,3.0,12.0
10839,1995-1996,18,AFC Ajax,De Graafschap,1,0,1,3,0,1,1,13.0,4.0
10840,1995-1996,18,NAC Breda,Roda JC Kerkrade,0,0,3,1,1,0,0,8.0,8.0
10841,1995-1996,18,Fortuna Sittard,FC Groningen,0,0,3,1,1,0,0,6.0,4.0
10842,1995-1996,19,Willem II,Go Ahead Eagles,1,2,2,0,3,3,-1,6.0,5.0
10843,1995-1996,19,Roda JC Kerkrade,Vitesse,0,1,2,0,3,1,-1,5.0,9.0
10844,1995-1996,19,De Graafschap,Sparta Rotterdam,5,2,1,3,0,7,3,7.0,8.0
10845,1995-1996,19,RKC Waalwijk,sc Heerenveen,2,3,2,0,3,5,-1,5.0,8.0
10846,1995-1996,19,Feyenoord,FC Twente,1,0,1,3,0,1,1,10.0,10.0
10847,1995-1996,19,AFC Ajax,NEC Nijmegen,3,1,1,3,0,4,2,15.0,3.0
10848,1995-1996,19,Willem II,AFC Ajax,1,0,1,3,0,1,1,8.0,12.0
10849,1995-1996,19,FC Volendam,FC Utrecht,0,1,2,0,3,1,-1,1.0,3.0
10850,1995-1996,19,PSV,NAC Breda,4,1,1,3,0,5,3,12.0,7.0
10851,1995-1996,20,sc Heerenveen,PSV,1,3,2,0,3,4,-2,7.0,12.0
10852,1995-1996,20,Fortuna Sittard,Willem II,0,0,3,1,1,0,0,4.0,6.0
10853,1995-1996,20,NAC Breda,FC Groningen,1,1,3,1,1,2,0,5.0,5.0
10854,1995-1996,20,FC Twente,Roda JC Kerkrade,0,3,2,0,3,3,-3,9.0,5.0
10855,1995-1996,20,Sparta Rotterdam,AFC Ajax,3,3,3,1,1,6,0,6.0,10.0
10856,1995-1996,20,FC Utrecht,NEC Nijmegen,1,2,2,0,3,3,-1,3.0,6.0
10857,1995-1996,20,FC Volendam,Feyenoord,0,3,2,0,3,3,-3,1.0,12.0
10858,1995-1996,20,Vitesse,RKC Waalwijk,2,1,1,3,0,3,1,9.0,5.0
10859,1995-1996,20,NAC Breda,De Graafschap,2,1,1,3,0,3,1,5.0,7.0
10860,1995-1996,21,Feyenoord,Roda JC Kerkrade,2,0,1,3,0,2,2,15.0,4.0
10861,1995-1996,21,FC Utrecht,Sparta Rotterdam,0,0,3,1,1,0,0,4.0,4.0
10862,1995-1996,21,Vitesse,FC Groningen,0,0,3,1,1,0,0,10.0,5.0
10863,1995-1996,21,RKC Waalwijk,FC Twente,1,0,1,3,0,1,1,7.0,6.0
10864,1995-1996,21,De Graafschap,Fortuna Sittard,1,1,3,1,1,2,0,5.0,4.0
10865,1995-1996,21,NEC Nijmegen,Sparta Rotterdam,2,2,3,1,1,4,0,6.0,4.0
10866,1995-1996,21,Willem II,Vitesse,0,5,2,0,3,5,-5,5.0,10.0
10867,1995-1996,21,NEC Nijmegen,Fortuna Sittard,0,2,2,0,3,2,-2,5.0,6.0
10868,1995-1996,21,PSV,FC Volendam,7,0,1,3,0,7,7,15.0,0.0
10869,1995-1996,22,RKC Waalwijk,Feyenoord,1,1,3,1,1,2,0,7.0,13.0
10870,1995-1996,22,NAC Breda,NEC Nijmegen,2,1,1,3,0,3,1,8.0,4.0
10871,1995-1996,22,Fortuna Sittard,Sparta Rotterdam,0,1,2,0,3,1,-1,6.0,6.0
10872,1995-1996,22,Feyenoord,PSV,0,0,3,1,1,0,0,11.0,13.0
10873,1995-1996,22,AFC Ajax,sc Heerenveen,6,2,1,3,0,8,4,10.0,6.0
10874,1995-1996,22,De Graafschap,sc Heerenveen,2,2,3,1,1,4,0,5.0,7.0
10875,1995-1996,22,Go Ahead Eagles,NEC Nijmegen,2,2,3,1,1,4,0,6.0,5.0
10876,1995-1996,22,sc Heerenveen,NEC Nijmegen,4,1,1,3,0,5,3,7.0,2.0
10877,1995-1996,22,PSV,Roda JC Kerkrade,3,0,1,3,0,3,3,13.0,4.0
10878,1995-1996,23,Go Ahead Eagles,Fortuna Sittard,2,0,1,3,0,2,2,8.0,5.0
10879,1995-1996,23,Willem II,FC Volendam,1,0,1,3,0,1,1,7.0,0.0
10880,1995-1996,23,FC Utrecht,RKC Waalwijk,0,0,3,1,1,0,0,5.0,5.0
10881,1995-1996,23,FC Twente,De Graafschap,1,0,1,3,0,1,1,6.0,5.0
10882,1995-1996,23,Sparta Rotterdam,NAC Breda,3,1,1,3,0,4,2,9.0,7.0
10883,1995-1996,23,Vitesse,AFC Ajax,2,1,1,3,0,3,1,13.0,7.0
10884,1995-1996,23,FC Groningen,Feyenoord,1,0,1,3,0,1,1,7.0,8.0
10885,1995-1996,23,RKC Waalwijk,PSV,1,3,2,0,3,4,-2,5.0,13.0
10886,1995-1996,23,Sparta Rotterdam,sc Heerenveen,5,2,1,3,0,7,3,11.0,4.0
10887,1995-1996,24,De Graafschap,FC Volendam,1,0,1,3,0,1,1,5.0,0.0
10888,1995-1996,24,NAC Breda,Go Ahead Eagles,2,0,1,3,0,2,2,10.0,7.0
10889,1995-1996,24,Roda JC Kerkrade,FC Groningen,0,0,3,1,1,0,0,4.0,7.0
10890,1995-1996,24,NEC Nijmegen,Vitesse,0,1,2,0,3,1,-1,1.0,13.0
10891,1995-1996,24,AFC Ajax,FC Twente,6,1,1,3,0,7,5,7.0,3.0
10892,1995-1996,24,Feyenoord,FC Utrecht,3,0,1,3,0,3,3,8.0,5.0
10893,1995-1996,24,Roda JC Kerkrade,RKC Waalwijk,2,2,3,1,1,4,0,5.0,6.0
10894,1995-1996,24,FC Groningen,sc Heerenveen,1,1,3,1,1,2,0,7.0,5.0
10895,1995-1996,24,Go Ahead Eagles,De Graafschap,4,0,1,3,0,4,4,10.0,5.0
10896,1995-1996,25,Fortuna Sittard,AFC Ajax,1,2,2,0,3,3,-1,4.0,10.0
10897,1995-1996,25,Willem II,NAC Breda,1,3,2,0,3,4,-2,7.0,12.0
10898,1995-1996,25,NEC Nijmegen,FC Twente,1,4,2,0,3,5,-3,1.0,6.0
10899,1995-1996,25,Go Ahead Eagles,sc Heerenveen,2,3,2,0,3,5,-1,7.0,8.0
10900,1995-1996,25,Fortuna Sittard,NAC Breda,2,2,3,1,1,4,0,4.0,10.0
10901,1995-1996,25,PSV,FC Utrecht,0,0,3,1,1,0,0,11.0,3.0
10902,1995-1996,25,Willem II,Roda JC Kerkrade,1,2,2,0,3,3,-1,4.0,5.0
10903,1995-1996,25,De Graafschap,Feyenoord,1,1,3,1,1,2,0,5.0,6.0
10904,1995-1996,25,FC Volendam,AFC Ajax,0,0,3,1,1,0,0,1.0,10.0
10905,1995-1996,26,FC Groningen,RKC Waalwijk,1,1,3,1,1,2,0,7.0,4.0
10906,1995-1996,26,Vitesse,Sparta Rotterdam,3,2,1,3,0,5,1,13.0,10.0
10907,1995-1996,26,Roda JC Kerkrade,FC Utrecht,3,1,1,3,0,4,2,8.0,3.0
10908,1995-1996,26,FC Groningen,FC Twente,2,2,3,1,1,4,0,7.0,7.0
10909,1995-1996,26,Vitesse,Go Ahead Eagles,0,3,2,0,3,3,-3,12.0,9.0
10910,1995-1996,26,Roda JC Kerkrade,De Graafschap,3,1,1,3,0,4,2,11.0,4.0
10911,1995-1996,26,sc Heerenveen,Fortuna Sittard,5,1,1,3,0,6,4,10.0,1.0
10912,1995-1996,26,FC Groningen,PSV,1,0,1,3,0,1,1,7.0,8.0
10913,1995-1996,26,AFC Ajax,Feyenoord,2,0,1,3,0,2,2,10.0,5.0
10914,1995-1996,27,RKC Waalwijk,Willem II,3,2,1,3,0,5,1,6.0,3.0
10915,1995-1996,27,FC Volendam,NEC Nijmegen,1,0,1,3,0,1,1,4.0,1.0
10916,1995-1996,27,FC Utrecht,NAC Breda,0,4,2,0,3,4,-4,2.0,10.0
10917,1995-1996,27,FC Twente,Sparta Rotterdam,1,0,1,3,0,1,1,10.0,9.0
10918,1995-1996,27,Sparta Rotterdam,Roda JC Kerkrade,2,2,3,1,1,4,0,7.0,11.0
10919,1995-1996,27,Fortuna Sittard,FC Utrecht,2,1,1,3,0,3,1,4.0,1.0
10920,1995-1996,27,Feyenoord,Willem II,2,0,1,3,0,2,2,7.0,3.0
10921,1995-1996,27,Vitesse,De Graafschap,0,1,2,0,3,1,-1,9.0,7.0
10922,1995-1996,27,FC Volendam,FC Groningen,2,1,1,3,0,3,1,7.0,6.0
10923,1995-1996,28,FC Twente,PSV,3,2,1,3,0,5,1,10.0,7.0
10924,1995-1996,28,AFC Ajax,Go Ahead Eagles,2,1,1,3,0,3,1,13.0,6.0
10925,1995-1996,28,Sparta Rotterdam,FC Volendam,1,0,1,3,0,1,1,7.0,7.0
10926,1995-1996,28,Roda JC Kerkrade,AFC Ajax,2,0,1,3,0,2,2,13.0,10.0
10927,1995-1996,28,NAC Breda,sc Heerenveen,5,1,1,3,0,6,4,13.0,7.0
10928,1995-1996,28,Fortuna Sittard,Vitesse,0,0,3,1,1,0,0,5.0,7.0
10929,1995-1996,28,Willem II,PSV,2,5,2,0,3,7,-3,0.0,7.0
10930,1995-1996,28,Feyenoord,NEC Nijmegen,2,1,1,3,0,3,1,10.0,0.0
10931,1995-1996,28,Go Ahead Eagles,FC Twente,1,3,2,0,3,4,-2,6.0,13.0
10932,1995-1996,29,RKC Waalwijk,De Graafschap,5,0,1,3,0,5,5,8.0,4.0
10933,1995-1996,29,FC Utrecht,FC Groningen,0,1,2,0,3,1,-1,1.0,8.0
10934,1995-1996,29,FC Twente,Willem II,2,1,1,3,0,3,1,13.0,0.0
10935,1995-1996,29,FC Volendam,Go Ahead Eagles,2,1,1,3,0,3,1,10.0,3.0
10936,1995-1996,29,FC Groningen,Willem II,3,0,1,3,0,3,3,10.0,0.0
10937,1995-1996,29,sc Heerenveen,FC Utrecht,4,2,1,3,0,6,2,10.0,0.0
10938,1995-1996,29,NEC Nijmegen,RKC Waalwijk,2,1,1,3,0,3,1,3.0,8.0
10939,1995-1996,29,PSV,Vitesse,1,0,1,3,0,1,1,7.0,4.0
10940,1995-1996,29,AFC Ajax,NAC Breda,2,0,1,3,0,2,2,10.0,10.0
10941,1995-1996,30,FC Twente,Fortuna Sittard,1,0,1,3,0,1,1,15.0,5.0
10942,1995-1996,30,Vitesse,NAC Breda,2,0,1,3,0,2,2,4.0,7.0
10943,1995-1996,30,sc Heerenveen,Willem II,2,2,3,1,1,4,0,10.0,1.0
10944,1995-1996,30,PSV,AFC Ajax,1,1,3,1,1,2,0,7.0,10.0
10945,1995-1996,30,Roda JC Kerkrade,FC Volendam,2,0,1,3,0,2,2,13.0,9.0
10946,1995-1996,30,FC Utrecht,Go Ahead Eagles,1,0,1,3,0,1,1,3.0,3.0
10947,1995-1996,30,Feyenoord,Sparta Rotterdam,1,1,3,1,1,2,0,8.0,5.0
10948,1995-1996,30,De Graafschap,PSV,1,2,2,0,3,3,-1,4.0,10.0
10949,1995-1996,30,Fortuna Sittard,FC Volendam,2,2,3,1,1,4,0,5.0,7.0
10950,1995-1996,31,Willem II,FC Utrecht,1,1,3,1,1,2,0,2.0,4.0
10951,1995-1996,31,AFC Ajax,RKC Waalwijk,1,0,1,3,0,1,1,10.0,7.0
10952,1995-1996,31,sc Heerenveen,Vitesse,1,2,2,0,3,3,-1,7.0,7.0
10953,1995-1996,31,Roda JC Kerkrade,NEC Nijmegen,1,0,1,3,0,1,1,13.0,3.0
10954,1995-1996,31,De Graafschap,FC Groningen,3,1,1,3,0,4,2,6.0,9.0
10955,1995-1996,31,Go Ahead Eagles,Feyenoord,0,3,2,0,3,3,-3,0.0,10.0
10956,1995-1996,31,NAC Breda,FC Twente,4,1,1,3,0,5,3,9.0,12.0
10957,1995-1996,31,FC Volendam,RKC Waalwijk,1,1,3,1,1,2,0,5.0,7.0
10958,1995-1996,31,Sparta Rotterdam,Go Ahead Eagles,2,0,1,3,0,2,2,8.0,0.0
10959,1995-1996,32,Roda JC Kerkrade,Go Ahead Eagles,5,0,1,3,0,5,5,13.0,0.0
10960,1995-1996,32,PSV,NEC Nijmegen,1,0,1,3,0,1,1,13.0,3.0
10961,1995-1996,32,Willem II,De Graafschap,1,1,3,1,1,2,0,3.0,7.0
10962,1995-1996,32,FC Groningen,AFC Ajax,3,4,2,0,3,7,-1,6.0,10.0
10963,1995-1996,32,RKC Waalwijk,Sparta Rotterdam,0,0,3,1,1,0,0,5.0,9.0
10964,1995-1996,32,Feyenoord,Fortuna Sittard,1,0,1,3,0,1,1,13.0,5.0
10965,1995-1996,32,FC Volendam,NAC Breda,1,2,2,0,3,3,-1,5.0,9.0
10966,1995-1996,32,FC Utrecht,Vitesse,2,0,1,3,0,2,2,7.0,7.0
10967,1995-1996,32,FC Twente,sc Heerenveen,0,1,2,0,3,1,-1,9.0,7.0
10968,1995-1996,33,Sparta Rotterdam,PSV,2,1,1,3,0,3,1,11.0,10.0
10969,1995-1996,33,sc Heerenveen,FC Volendam,4,3,1,3,0,7,1,10.0,2.0
10970,1995-1996,33,NAC Breda,Feyenoord,0,3,2,0,3,3,-3,6.0,13.0
10971,1995-1996,33,Vitesse,FC Twente,2,0,1,3,0,2,2,9.0,6.0
10972,1995-1996,33,NEC Nijmegen,FC Groningen,0,2,2,0,3,2,-2,3.0,9.0
10973,1995-1996,33,AFC Ajax,Willem II,5,1,1,3,0,6,4,13.0,3.0
10974,1995-1996,33,FC Utrecht,De Graafschap,1,1,3,1,1,2,0,8.0,5.0
10975,1995-1996,33,Fortuna Sittard,Roda JC Kerkrade,1,1,3,1,1,2,0,3.0,13.0
10976,1995-1996,33,Go Ahead Eagles,RKC Waalwijk,1,3,2,0,3,4,-2,0.0,5.0
10977,1995-1996,34,Roda JC Kerkrade,NAC Breda,5,1,1,3,0,6,4,13.0,6.0
10978,1995-1996,34,Willem II,NEC Nijmegen,1,3,2,0,3,4,-2,3.0,6.0
10979,1995-1996,34,FC Groningen,Sparta Rotterdam,5,1,1,3,0,6,4,9.0,8.0
10980,1995-1996,34,RKC Waalwijk,Fortuna Sittard,1,1,3,1,1,2,0,6.0,3.0
10981,1995-1996,34,Feyenoord,sc Heerenveen,4,1,1,3,0,5,3,13.0,7.0
10982,1995-1996,34,FC Volendam,Vitesse,1,1,3,1,1,2,0,3.0,10.0
10983,1995-1996,34,De Graafschap,AFC Ajax,0,0,3,1,1,0,0,6.0,11.0
10984,1995-1996,34,FC Twente,FC Utrecht,1,2,2,0,3,3,-1,3.0,11.0
10985,1995-1996,34,PSV,Go Ahead Eagles,3,1,1,3,0,4,2,10.0,0.0
10986,1996-1997,1,Roda JC Kerkrade,Feyenoord,1,1,3,1,1,2,0,11.0,13.0
10987,1996-1997,1,Sparta Rotterdam,Fortuna Sittard,0,0,3,1,1,0,0,8.0,4.0
10988,1996-1997,1,AFC Ajax,NAC Breda,1,0,1,3,0,1,1,13.0,6.0
10989,1996-1997,1,FC Utrecht,RKC Waalwijk,2,2,3,1,1,4,0,9.0,7.0
10990,1996-1997,1,sc Heerenveen,FC Twente,1,3,2,0,3,4,-2,6.0,3.0
10991,1996-1997,1,FC Groningen,Willem II,0,0,3,1,1,0,0,7.0,3.0
10992,1996-1997,1,FC Volendam,De Graafschap,1,1,3,1,1,2,0,3.0,7.0
10993,1996-1997,1,AZ Alkmaar,Vitesse,0,2,2,0,3,2,-2,6.0,10.0
10994,1996-1997,1,NEC Nijmegen,PSV,1,4,2,0,3,5,-3,3.0,12.0
10995,1996-1997,2,NAC Breda,Sparta Rotterdam,1,0,1,3,0,1,1,6.0,5.0
10996,1996-1997,2,sc Heerenveen,AFC Ajax,2,0,1,3,0,2,2,9.0,10.0
10997,1996-1997,2,Willem II,Fortuna Sittard,0,1,2,0,3,1,-1,2.0,6.0
10998,1996-1997,2,De Graafschap,RKC Waalwijk,3,2,1,3,0,5,1,7.0,6.0
10999,1996-1997,2,PSV,FC Groningen,4,1,1,3,0,5,3,12.0,7.0
11000,1996-1997,2,FC Twente,Roda JC Kerkrade,1,1,3,1,1,2,0,4.0,9.0
11001,1996-1997,2,Vitesse,FC Utrecht,1,0,1,3,0,1,1,10.0,8.0
11002,1996-1997,2,Feyenoord,FC Volendam,3,0,1,3,0,3,3,13.0,2.0
11003,1996-1997,2,NEC Nijmegen,AZ Alkmaar,0,0,3,1,1,0,0,4.0,7.0
11004,1996-1997,3,Fortuna Sittard,sc Heerenveen,2,4,2,0,3,6,-2,6.0,9.0
11005,1996-1997,3,FC Volendam,PSV,1,3,2,0,3,4,-2,2.0,12.0
11006,1996-1997,3,FC Utrecht,FC Twente,0,0,3,1,1,0,0,6.0,5.0
11007,1996-1997,3,AFC Ajax,AZ Alkmaar,1,0,1,3,0,1,1,10.0,4.0
11008,1996-1997,3,Willem II,RKC Waalwijk,1,3,2,0,3,4,-2,1.0,8.0
11009,1996-1997,3,Vitesse,Sparta Rotterdam,1,1,3,1,1,2,0,11.0,5.0
11010,1996-1997,3,Feyenoord,De Graafschap,2,1,1,3,0,3,1,13.0,6.0
11011,1996-1997,3,FC Groningen,Roda JC Kerkrade,1,1,3,1,1,2,0,8.0,7.0
11012,1996-1997,3,NAC Breda,NEC Nijmegen,1,1,3,1,1,2,0,4.0,5.0
11013,1996-1997,4,FC Utrecht,FC Groningen,0,0,3,1,1,0,0,6.0,6.0
11014,1996-1997,4,sc Heerenveen,NAC Breda,0,1,2,0,3,1,-1,6.0,7.0
11015,1996-1997,4,Fortuna Sittard,Feyenoord,0,2,2,0,3,2,-2,5.0,13.0
11016,1996-1997,4,Willem II,Vitesse,2,1,1,3,0,3,1,4.0,8.0
11017,1996-1997,4,Sparta Rotterdam,FC Twente,1,2,2,0,3,3,-1,2.0,8.0
11018,1996-1997,4,De Graafschap,NEC Nijmegen,4,0,1,3,0,4,4,8.0,5.0
11019,1996-1997,4,Roda JC Kerkrade,AFC Ajax,0,0,3,1,1,0,0,7.0,8.0
11020,1996-1997,4,AZ Alkmaar,FC Volendam,2,1,1,3,0,3,1,7.0,2.0
11021,1996-1997,4,PSV,RKC Waalwijk,4,0,1,3,0,4,4,15.0,5.0
11022,1996-1997,5,FC Groningen,sc Heerenveen,1,5,2,0,3,6,-4,3.0,9.0
11023,1996-1997,5,Feyenoord,Willem II,4,1,1,3,0,5,3,13.0,4.0
11024,1996-1997,5,Roda JC Kerkrade,FC Volendam,3,0,1,3,0,3,3,7.0,1.0
11025,1996-1997,5,AZ Alkmaar,Fortuna Sittard,0,1,2,0,3,1,-1,4.0,7.0
11026,1996-1997,5,FC Twente,De Graafschap,1,0,1,3,0,1,1,11.0,7.0
11027,1996-1997,5,Sparta Rotterdam,FC Utrecht,3,2,1,3,0,5,1,5.0,3.0
11028,1996-1997,5,PSV,NAC Breda,5,0,1,3,0,5,5,15.0,7.0
11029,1996-1997,5,NEC Nijmegen,AFC Ajax,2,0,1,3,0,2,2,5.0,7.0
11030,1996-1997,5,Vitesse,sc Heerenveen,1,1,3,1,1,2,0,8.0,10.0
11031,1996-1997,6,NAC Breda,AZ Alkmaar,1,0,1,3,0,1,1,10.0,4.0
11032,1996-1997,6,Fortuna Sittard,FC Utrecht,1,3,2,0,3,4,-2,6.0,5.0
11033,1996-1997,6,FC Volendam,Willem II,2,1,1,3,0,3,1,3.0,3.0
11034,1996-1997,6,De Graafschap,PSV,2,1,1,3,0,3,1,9.0,12.0
11035,1996-1997,6,FC Twente,Feyenoord,0,1,2,0,3,1,-1,8.0,15.0
11036,1996-1997,6,RKC Waalwijk,Roda JC Kerkrade,0,2,2,0,3,2,-2,4.0,9.0
11037,1996-1997,6,FC Groningen,NEC Nijmegen,2,4,2,0,3,6,-2,2.0,8.0
11038,1996-1997,6,AFC Ajax,Sparta Rotterdam,2,0,1,3,0,2,2,7.0,4.0
11039,1996-1997,6,sc Heerenveen,NEC Nijmegen,1,1,3,1,1,2,0,8.0,8.0
11040,1996-1997,7,Willem II,FC Twente,1,2,2,0,3,3,-1,3.0,10.0
11041,1996-1997,7,Sparta Rotterdam,Feyenoord,0,1,2,0,3,1,-1,4.0,15.0
11042,1996-1997,7,NAC Breda,Roda JC Kerkrade,0,1,2,0,3,1,-1,7.0,11.0
11043,1996-1997,7,Fortuna Sittard,FC Volendam,1,1,3,1,1,2,0,4.0,4.0
11044,1996-1997,7,FC Groningen,RKC Waalwijk,1,2,2,0,3,3,-1,2.0,6.0
11045,1996-1997,7,AFC Ajax,De Graafschap,1,1,3,1,1,2,0,8.0,7.0
11046,1996-1997,7,AZ Alkmaar,FC Utrecht,3,1,1,3,0,4,2,6.0,5.0
11047,1996-1997,7,PSV,Vitesse,0,0,3,1,1,0,0,10.0,6.0
11048,1996-1997,7,RKC Waalwijk,Vitesse,0,1,2,0,3,1,-1,6.0,6.0
11049,1996-1997,8,Roda JC Kerkrade,Fortuna Sittard,0,1,2,0,3,1,-1,10.0,7.0
11050,1996-1997,8,De Graafschap,Willem II,2,2,3,1,1,4,0,8.0,4.0
11051,1996-1997,8,FC Utrecht,PSV,2,2,3,1,1,4,0,5.0,8.0
11052,1996-1997,8,FC Twente,AFC Ajax,1,1,3,1,1,2,0,10.0,6.0
11053,1996-1997,8,RKC Waalwijk,NAC Breda,1,2,2,0,3,3,-1,3.0,9.0
11054,1996-1997,8,FC Volendam,sc Heerenveen,2,2,3,1,1,4,0,5.0,6.0
11055,1996-1997,8,Sparta Rotterdam,NEC Nijmegen,1,0,1,3,0,1,1,6.0,7.0
11056,1996-1997,8,FC Groningen,AZ Alkmaar,1,0,1,3,0,1,1,4.0,6.0
11057,1996-1997,8,Vitesse,Feyenoord,4,2,1,3,0,6,2,8.0,12.0
11058,1996-1997,9,Fortuna Sittard,De Graafschap,0,3,2,0,3,3,-3,7.0,8.0
11059,1996-1997,9,PSV,FC Twente,2,0,1,3,0,2,2,8.0,7.0
11060,1996-1997,9,NAC Breda,FC Utrecht,3,3,3,1,1,6,0,7.0,5.0
11061,1996-1997,9,NEC Nijmegen,sc Heerenveen,1,1,3,1,1,2,0,8.0,7.0
11062,1996-1997,9,RKC Waalwijk,FC Volendam,0,0,3,1,1,0,0,4.0,6.0
11063,1996-1997,9,Feyenoord,FC Groningen,3,1,1,3,0,4,2,12.0,3.0
11064,1996-1997,9,AFC Ajax,Willem II,3,0,1,3,0,3,3,8.0,1.0
11065,1996-1997,9,AZ Alkmaar,Sparta Rotterdam,1,2,2,0,3,3,-1,3.0,9.0
11066,1996-1997,9,Vitesse,Roda JC Kerkrade,1,2,2,0,3,3,-1,8.0,12.0
11067,1996-1997,10,Fortuna Sittard,PSV,1,1,3,1,1,2,0,5.0,6.0
11068,1996-1997,10,sc Heerenveen,Sparta Rotterdam,0,0,3,1,1,0,0,5.0,7.0
11069,1996-1997,10,NAC Breda,FC Twente,1,2,2,0,3,3,-1,7.0,7.0
11070,1996-1997,10,Roda JC Kerkrade,AZ Alkmaar,0,2,2,0,3,2,-2,9.0,6.0
11071,1996-1997,10,RKC Waalwijk,Feyenoord,1,1,3,1,1,2,0,5.0,10.0
11072,1996-1997,10,Willem II,FC Groningen,3,1,1,3,0,4,2,4.0,3.0
11073,1996-1997,10,FC Utrecht,AFC Ajax,1,1,3,1,1,2,0,6.0,9.0
11074,1996-1997,10,FC Volendam,NEC Nijmegen,1,0,1,3,0,1,1,9.0,5.0
11075,1996-1997,10,De Graafschap,Vitesse,2,1,1,3,0,3,1,11.0,7.0
11076,1996-1997,11,NEC Nijmegen,FC Utrecht,2,2,3,1,1,4,0,3.0,4.0
11077,1996-1997,11,AZ Alkmaar,De Graafschap,2,3,2,0,3,5,-1,6.0,11.0
11078,1996-1997,11,Willem II,sc Heerenveen,2,2,3,1,1,4,0,5.0,5.0
11079,1996-1997,11,FC Twente,RKC Waalwijk,3,0,1,3,0,3,3,10.0,2.0
11080,1996-1997,11,Sparta Rotterdam,Roda JC Kerkrade,4,0,1,3,0,4,4,10.0,6.0
11081,1996-1997,11,Vitesse,NAC Breda,3,0,1,3,0,3,3,9.0,4.0
11082,1996-1997,11,AFC Ajax,FC Volendam,1,1,3,1,1,2,0,7.0,7.0
11083,1996-1997,11,FC Groningen,Fortuna Sittard,2,0,1,3,0,2,2,6.0,5.0
11084,1996-1997,11,PSV,Feyenoord,7,2,1,3,0,9,5,9.0,7.0
11085,1996-1997,12,FC Utrecht,Willem II,0,0,3,1,1,0,0,5.0,6.0
11086,1996-1997,12,Roda JC Kerkrade,Vitesse,1,1,3,1,1,2,0,4.0,7.0
11087,1996-1997,12,NEC Nijmegen,Fortuna Sittard,1,1,3,1,1,2,0,3.0,5.0
11088,1996-1997,12,Feyenoord,AZ Alkmaar,1,0,1,3,0,1,1,7.0,3.0
11089,1996-1997,12,NAC Breda,FC Groningen,1,1,3,1,1,2,0,5.0,7.0
11090,1996-1997,12,Sparta Rotterdam,FC Volendam,0,3,2,0,3,3,-3,10.0,9.0
11091,1996-1997,12,sc Heerenveen,PSV,0,1,2,0,3,1,-1,4.0,11.0
11092,1996-1997,12,AFC Ajax,RKC Waalwijk,2,0,1,3,0,2,2,9.0,2.0
11093,1996-1997,12,PSV,Roda JC Kerkrade,8,0,1,3,0,8,8,13.0,4.0
11094,1996-1997,13,De Graafschap,Fortuna Sittard,2,0,1,3,0,2,2,13.0,2.0
11095,1996-1997,13,Feyenoord,FC Utrecht,2,1,1,3,0,3,1,10.0,4.0
11096,1996-1997,13,RKC Waalwijk,sc Heerenveen,0,3,2,0,3,3,-3,2.0,6.0
11097,1996-1997,13,AZ Alkmaar,NEC Nijmegen,2,2,3,1,1,4,0,4.0,4.0
11098,1996-1997,13,FC Volendam,FC Groningen,2,2,3,1,1,4,0,9.0,5.0
11099,1996-1997,13,Willem II,NAC Breda,2,0,1,3,0,2,2,8.0,2.0
11100,1996-1997,13,Vitesse,AFC Ajax,1,4,2,0,3,5,-3,4.0,11.0
11101,1996-1997,13,FC Twente,Sparta Rotterdam,0,2,2,0,3,2,-2,7.0,10.0
11102,1996-1997,13,Fortuna Sittard,Vitesse,1,5,2,0,3,6,-4,2.0,7.0
11103,1996-1997,14,Roda JC Kerkrade,De Graafschap,3,0,1,3,0,3,3,4.0,12.0
11104,1996-1997,14,AZ Alkmaar,sc Heerenveen,0,2,2,0,3,2,-2,4.0,8.0
11105,1996-1997,14,NEC Nijmegen,Sparta Rotterdam,3,2,1,3,0,5,1,6.0,7.0
11106,1996-1997,14,FC Utrecht,NAC Breda,3,1,1,3,0,4,2,6.0,1.0
11107,1996-1997,14,FC Groningen,Feyenoord,0,1,2,0,3,1,-1,5.0,10.0
11108,1996-1997,14,FC Twente,PSV,1,2,2,0,3,3,-1,6.0,13.0
11109,1996-1997,14,Willem II,AFC Ajax,0,1,2,0,3,1,-1,8.0,11.0
11110,1996-1997,14,FC Volendam,RKC Waalwijk,1,0,1,3,0,1,1,11.0,1.0
11111,1996-1997,14,Sparta Rotterdam,AZ Alkmaar,1,2,2,0,3,3,-1,6.0,4.0
11112,1996-1997,15,FC Utrecht,FC Volendam,1,0,1,3,0,1,1,8.0,8.0
11113,1996-1997,15,Feyenoord,NAC Breda,1,0,1,3,0,1,1,12.0,1.0
11114,1996-1997,15,sc Heerenveen,De Graafschap,2,1,1,3,0,3,1,10.0,9.0
11115,1996-1997,15,AFC Ajax,Fortuna Sittard,2,2,3,1,1,4,0,11.0,2.0
11116,1996-1997,15,FC Twente,Willem II,5,0,1,3,0,5,5,9.0,5.0
11117,1996-1997,15,Vitesse,RKC Waalwijk,2,2,3,1,1,4,0,8.0,1.0
11118,1996-1997,15,Roda JC Kerkrade,NEC Nijmegen,2,0,1,3,0,2,2,7.0,6.0
11119,1996-1997,15,PSV,Sparta Rotterdam,2,1,1,3,0,3,1,15.0,3.0
11120,1996-1997,15,sc Heerenveen,Feyenoord,1,0,1,3,0,1,1,12.0,12.0
11121,1996-1997,16,AZ Alkmaar,RKC Waalwijk,2,1,1,3,0,3,1,7.0,1.0
11122,1996-1997,16,De Graafschap,FC Volendam,1,0,1,3,0,1,1,9.0,7.0
11123,1996-1997,16,FC Utrecht,Roda JC Kerkrade,1,1,3,1,1,2,0,8.0,8.0
11124,1996-1997,16,Fortuna Sittard,FC Twente,1,1,3,1,1,2,0,3.0,7.0
11125,1996-1997,16,NEC Nijmegen,Vitesse,0,1,2,0,3,1,-1,5.0,8.0
11126,1996-1997,16,Sparta Rotterdam,FC Groningen,0,2,2,0,3,2,-2,3.0,8.0
11127,1996-1997,16,Willem II,PSV,1,0,1,3,0,1,1,7.0,12.0
11128,1996-1997,16,NAC Breda,AFC Ajax,2,0,1,3,0,2,2,4.0,10.0
11129,1996-1997,16,FC Twente,sc Heerenveen,2,1,1,3,0,3,1,7.0,12.0
11130,1996-1997,17,De Graafschap,FC Groningen,2,0,1,3,0,2,2,9.0,5.0
11131,1996-1997,17,Sparta Rotterdam,Willem II,3,1,1,3,0,4,2,3.0,6.0
11132,1996-1997,17,NEC Nijmegen,FC Twente,0,3,2,0,3,3,-3,4.0,10.0
11133,1996-1997,17,Feyenoord,AFC Ajax,2,2,3,1,1,4,0,10.0,8.0
11134,1996-1997,17,AZ Alkmaar,PSV,0,2,2,0,3,2,-2,7.0,12.0
11135,1996-1997,17,FC Groningen,Vitesse,3,2,1,3,0,5,1,7.0,7.0
11136,1996-1997,17,RKC Waalwijk,Fortuna Sittard,1,1,3,1,1,2,0,2.0,3.0
11137,1996-1997,17,FC Utrecht,De Graafschap,2,0,1,3,0,2,2,10.0,6.0
11138,1996-1997,17,FC Volendam,NAC Breda,4,1,1,3,0,5,3,7.0,3.0
11139,1996-1997,18,Willem II,Roda JC Kerkrade,0,1,2,0,3,1,-1,3.0,10.0
11140,1996-1997,18,NAC Breda,De Graafschap,2,1,1,3,0,3,1,6.0,6.0
11141,1996-1997,18,sc Heerenveen,FC Utrecht,2,2,3,1,1,4,0,10.0,11.0
11142,1996-1997,18,PSV,NEC Nijmegen,4,1,1,3,0,5,3,12.0,3.0
11143,1996-1997,18,Vitesse,AZ Alkmaar,1,0,1,3,0,1,1,10.0,6.0
11144,1996-1997,18,RKC Waalwijk,Sparta Rotterdam,2,0,1,3,0,2,2,5.0,3.0
11145,1996-1997,18,AFC Ajax,FC Groningen,1,1,3,1,1,2,0,6.0,7.0
11146,1996-1997,18,FC Volendam,FC Twente,0,1,2,0,3,1,-1,6.0,13.0
11147,1996-1997,18,RKC Waalwijk,Willem II,1,2,2,0,3,3,-1,5.0,6.0
11148,1996-1997,19,Roda JC Kerkrade,FC Groningen,2,0,1,3,0,2,2,13.0,7.0
11149,1996-1997,19,PSV,FC Volendam,6,0,1,3,0,6,6,12.0,3.0
11150,1996-1997,19,sc Heerenveen,Fortuna Sittard,2,2,3,1,1,4,0,8.0,4.0
11151,1996-1997,19,NEC Nijmegen,NAC Breda,0,3,2,0,3,3,-3,0.0,9.0
11152,1996-1997,19,De Graafschap,Feyenoord,0,4,2,0,3,4,-4,6.0,10.0
11153,1996-1997,19,FC Twente,FC Utrecht,2,0,1,3,0,2,2,13.0,8.0
11154,1996-1997,19,AZ Alkmaar,AFC Ajax,1,1,3,1,1,2,0,7.0,4.0
11155,1996-1997,19,Sparta Rotterdam,Vitesse,1,2,2,0,3,3,-1,3.0,10.0
11156,1996-1997,19,Fortuna Sittard,NAC Breda,2,2,3,1,1,4,0,5.0,10.0
11157,1996-1997,20,Feyenoord,Roda JC Kerkrade,1,0,1,3,0,1,1,10.0,10.0
11158,1996-1997,20,Willem II,FC Utrecht,3,0,1,3,0,3,3,9.0,5.0
11159,1996-1997,20,Roda JC Kerkrade,sc Heerenveen,6,1,1,3,0,7,5,10.0,5.0
11160,1996-1997,20,Fortuna Sittard,RKC Waalwijk,0,0,3,1,1,0,0,5.0,5.0
11161,1996-1997,20,NEC Nijmegen,Feyenoord,1,2,2,0,3,3,-1,0.0,10.0
11162,1996-1997,20,AFC Ajax,PSV,0,2,2,0,3,2,-2,3.0,12.0
11163,1996-1997,20,FC Twente,AZ Alkmaar,1,0,1,3,0,1,1,15.0,4.0
11164,1996-1997,20,FC Volendam,Vitesse,1,1,3,1,1,2,0,4.0,10.0
11165,1996-1997,20,FC Groningen,De Graafschap,2,4,2,0,3,6,-2,4.0,6.0
11166,1996-1997,21,Willem II,NEC Nijmegen,3,1,1,3,0,4,2,9.0,0.0
11167,1996-1997,21,sc Heerenveen,AZ Alkmaar,0,0,3,1,1,0,0,3.0,2.0
11168,1996-1997,21,Roda JC Kerkrade,FC Twente,1,3,2,0,3,4,-2,9.0,15.0
11169,1996-1997,21,FC Utrecht,Fortuna Sittard,0,1,2,0,3,1,-1,4.0,7.0
11170,1996-1997,21,Sparta Rotterdam,NAC Breda,2,4,2,0,3,6,-2,3.0,10.0
11171,1996-1997,21,FC Volendam,Feyenoord,0,2,2,0,3,2,-2,4.0,13.0
11172,1996-1997,21,Vitesse,PSV,1,0,1,3,0,1,1,10.0,12.0
11173,1996-1997,21,De Graafschap,AFC Ajax,0,2,2,0,3,2,-2,3.0,6.0
11174,1996-1997,21,RKC Waalwijk,FC Groningen,1,1,3,1,1,2,0,6.0,5.0
11175,1996-1997,22,PSV,AZ Alkmaar,2,1,1,3,0,3,1,12.0,2.0
11176,1996-1997,22,De Graafschap,FC Twente,1,2,2,0,3,3,-1,3.0,15.0
11177,1996-1997,22,Roda JC Kerkrade,Willem II,2,1,1,3,0,3,1,9.0,9.0
11178,1996-1997,22,NAC Breda,sc Heerenveen,2,2,3,1,1,4,0,11.0,4.0
11179,1996-1997,22,FC Volendam,Fortuna Sittard,2,0,1,3,0,2,2,4.0,6.0
11180,1996-1997,22,AFC Ajax,Feyenoord,3,0,1,3,0,3,3,8.0,12.0
11181,1996-1997,22,Vitesse,FC Groningen,6,1,1,3,0,7,5,13.0,2.0
11182,1996-1997,22,FC Utrecht,Sparta Rotterdam,0,1,2,0,3,1,-1,1.0,6.0
11183,1996-1997,22,RKC Waalwijk,NEC Nijmegen,3,1,1,3,0,4,2,8.0,0.0
11184,1996-1997,23,Feyenoord,NEC Nijmegen,2,0,1,3,0,2,2,12.0,0.0
11185,1996-1997,23,Fortuna Sittard,Willem II,2,0,1,3,0,2,2,8.0,9.0
11186,1996-1997,23,FC Twente,Vitesse,1,0,1,3,0,1,1,15.0,10.0
11187,1996-1997,23,RKC Waalwijk,PSV,1,4,2,0,3,5,-3,5.0,12.0
11188,1996-1997,23,De Graafschap,FC Utrecht,1,2,2,0,3,3,-1,3.0,3.0
11189,1996-1997,23,FC Groningen,FC Volendam,1,1,3,1,1,2,0,2.0,5.0
11190,1996-1997,23,sc Heerenveen,Roda JC Kerkrade,3,1,1,3,0,4,2,6.0,6.0
11191,1996-1997,23,AZ Alkmaar,NAC Breda,0,1,2,0,3,1,-1,2.0,11.0
11192,1996-1997,23,sc Heerenveen,Vitesse,3,0,1,3,0,3,3,8.0,7.0
11193,1996-1997,24,Willem II,AZ Alkmaar,2,2,3,1,1,4,0,7.0,2.0
11194,1996-1997,24,Sparta Rotterdam,De Graafschap,1,1,3,1,1,2,0,4.0,4.0
11195,1996-1997,24,NAC Breda,FC Volendam,3,0,1,3,0,3,3,11.0,5.0
11196,1996-1997,24,NEC Nijmegen,RKC Waalwijk,3,1,1,3,0,4,2,3.0,5.0
11197,1996-1997,24,Fortuna Sittard,Roda JC Kerkrade,0,3,2,0,3,3,-3,7.0,9.0
11198,1996-1997,24,Feyenoord,PSV,0,0,3,1,1,0,0,10.0,10.0
11199,1996-1997,24,AFC Ajax,FC Utrecht,1,0,1,3,0,1,1,10.0,3.0
11200,1996-1997,24,FC Groningen,FC Twente,2,1,1,3,0,3,1,5.0,12.0
11201,1996-1997,24,AFC Ajax,Roda JC Kerkrade,3,1,1,3,0,4,2,12.0,6.0
11202,1996-1997,25,NEC Nijmegen,FC Groningen,0,0,3,1,1,0,0,4.0,6.0
11203,1996-1997,25,PSV,Fortuna Sittard,1,0,1,3,0,1,1,10.0,6.0
11204,1996-1997,25,Feyenoord,RKC Waalwijk,5,0,1,3,0,5,5,10.0,4.0
11205,1996-1997,25,NAC Breda,Willem II,0,1,2,0,3,1,-1,10.0,7.0
11206,1996-1997,25,Vitesse,De Graafschap,3,2,1,3,0,5,1,9.0,1.0
11207,1996-1997,25,FC Twente,FC Volendam,4,0,1,3,0,4,4,12.0,4.0
11208,1996-1997,25,FC Utrecht,AZ Alkmaar,2,0,1,3,0,2,2,6.0,2.0
11209,1996-1997,25,FC Groningen,NAC Breda,2,2,3,1,1,4,0,6.0,8.0
11210,1996-1997,25,PSV,sc Heerenveen,0,1,2,0,3,1,-1,10.0,11.0
11211,1996-1997,26,Fortuna Sittard,Sparta Rotterdam,2,1,1,3,0,3,1,6.0,4.0
11212,1996-1997,26,RKC Waalwijk,AFC Ajax,1,2,2,0,3,3,-1,3.0,15.0
11213,1996-1997,26,AZ Alkmaar,Feyenoord,0,2,2,0,3,2,-2,1.0,10.0
11214,1996-1997,26,FC Volendam,Roda JC Kerkrade,2,1,1,3,0,3,1,7.0,6.0
11215,1996-1997,26,FC Twente,NEC Nijmegen,3,0,1,3,0,3,3,12.0,4.0
11216,1996-1997,26,De Graafschap,AZ Alkmaar,1,1,3,1,1,2,0,2.0,2.0
11217,1996-1997,26,NEC Nijmegen,FC Volendam,3,0,1,3,0,3,3,7.0,4.0
11218,1996-1997,26,Roda JC Kerkrade,FC Utrecht,1,1,3,1,1,2,0,4.0,7.0
11219,1996-1997,26,Sparta Rotterdam,sc Heerenveen,0,3,2,0,3,3,-3,4.0,13.0
11220,1996-1997,27,Fortuna Sittard,FC Groningen,0,2,2,0,3,2,-2,6.0,9.0
11221,1996-1997,27,De Graafschap,Sparta Rotterdam,0,2,2,0,3,2,-2,2.0,7.0
11222,1996-1997,27,sc Heerenveen,Willem II,3,1,1,3,0,4,2,15.0,4.0
11223,1996-1997,27,FC Volendam,AFC Ajax,0,3,2,0,3,3,-3,3.0,15.0
11224,1996-1997,27,NAC Breda,PSV,2,2,3,1,1,4,0,8.0,8.0
11225,1996-1997,27,FC Utrecht,NEC Nijmegen,1,1,3,1,1,2,0,8.0,8.0
11226,1996-1997,27,Feyenoord,Vitesse,0,0,3,1,1,0,0,11.0,7.0
11227,1996-1997,27,RKC Waalwijk,FC Twente,3,2,1,3,0,5,1,3.0,9.0
11228,1996-1997,27,Fortuna Sittard,AZ Alkmaar,1,0,1,3,0,1,1,6.0,2.0
11229,1996-1997,28,Roda JC Kerkrade,Sparta Rotterdam,4,1,1,3,0,5,3,7.0,4.0
11230,1996-1997,28,PSV,AFC Ajax,2,0,1,3,0,2,2,8.0,12.0
11231,1996-1997,28,De Graafschap,NAC Breda,2,2,3,1,1,4,0,3.0,6.0
11232,1996-1997,28,Vitesse,FC Volendam,1,1,3,1,1,2,0,5.0,4.0
11233,1996-1997,28,FC Utrecht,sc Heerenveen,2,2,3,1,1,4,0,6.0,13.0
11234,1996-1997,28,Willem II,Feyenoord,0,2,2,0,3,2,-2,4.0,11.0
11235,1996-1997,28,FC Twente,FC Groningen,0,1,2,0,3,1,-1,6.0,11.0
11236,1996-1997,28,AFC Ajax,NEC Nijmegen,5,0,1,3,0,5,5,12.0,5.0
11237,1996-1997,28,NAC Breda,Vitesse,1,1,3,1,1,2,0,4.0,6.0
11238,1996-1997,29,Willem II,Sparta Rotterdam,1,1,3,1,1,2,0,5.0,4.0
11239,1996-1997,29,Feyenoord,Fortuna Sittard,4,4,3,1,1,8,0,11.0,7.0
11240,1996-1997,29,PSV,De Graafschap,5,0,1,3,0,5,5,10.0,2.0
11241,1996-1997,29,AZ Alkmaar,Roda JC Kerkrade,1,3,2,0,3,4,-2,1.0,7.0
11242,1996-1997,29,FC Groningen,FC Utrecht,2,2,3,1,1,4,0,9.0,7.0
11243,1996-1997,29,sc Heerenveen,RKC Waalwijk,2,0,1,3,0,2,2,13.0,3.0
11244,1996-1997,29,Vitesse,FC Twente,4,2,1,3,0,6,2,9.0,6.0
11245,1996-1997,29,NEC Nijmegen,Willem II,0,0,3,1,1,0,0,5.0,5.0
11246,1996-1997,29,Roda JC Kerkrade,RKC Waalwijk,4,0,1,3,0,4,4,10.0,3.0
11247,1996-1997,30,RKC Waalwijk,FC Utrecht,1,0,1,3,0,1,1,6.0,4.0
11248,1996-1997,30,FC Twente,Fortuna Sittard,2,1,1,3,0,3,1,6.0,7.0
11249,1996-1997,30,De Graafschap,sc Heerenveen,2,1,1,3,0,3,1,5.0,10.0
11250,1996-1997,30,Sparta Rotterdam,AFC Ajax,2,1,1,3,0,3,1,7.0,9.0
11251,1996-1997,30,Vitesse,Willem II,2,0,1,3,0,2,2,9.0,2.0
11252,1996-1997,30,NAC Breda,Feyenoord,0,2,2,0,3,2,-2,4.0,11.0
11253,1996-1997,30,FC Volendam,AZ Alkmaar,2,2,3,1,1,4,0,5.0,2.0
11254,1996-1997,30,Sparta Rotterdam,PSV,1,3,2,0,3,4,-2,7.0,10.0
11255,1996-1997,30,FC Groningen,AFC Ajax,1,1,3,1,1,2,0,9.0,7.0
11256,1996-1997,31,AZ Alkmaar,Willem II,1,0,1,3,0,1,1,5.0,2.0
11257,1996-1997,31,Fortuna Sittard,NEC Nijmegen,3,1,1,3,0,4,2,7.0,5.0
11258,1996-1997,31,RKC Waalwijk,De Graafschap,0,3,2,0,3,3,-3,6.0,7.0
11259,1996-1997,31,FC Volendam,Sparta Rotterdam,0,2,2,0,3,2,-2,2.0,7.0
11260,1996-1997,31,FC Utrecht,Vitesse,1,0,1,3,0,1,1,6.0,8.0
11261,1996-1997,31,FC Groningen,PSV,0,1,2,0,3,1,-1,8.0,13.0
11262,1996-1997,31,AFC Ajax,sc Heerenveen,2,1,1,3,0,3,1,7.0,7.0
11263,1996-1997,31,Feyenoord,FC Twente,1,1,3,1,1,2,0,9.0,4.0
11264,1996-1997,31,Roda JC Kerkrade,NAC Breda,2,1,1,3,0,3,1,13.0,3.0
11265,1996-1997,32,NEC Nijmegen,Roda JC Kerkrade,2,1,1,3,0,3,1,5.0,12.0
11266,1996-1997,32,NAC Breda,RKC Waalwijk,0,2,2,0,3,2,-2,2.0,6.0
11267,1996-1997,32,sc Heerenveen,FC Volendam,1,2,2,0,3,3,-1,4.0,5.0
11268,1996-1997,32,AZ Alkmaar,FC Groningen,1,4,2,0,3,5,-3,4.0,8.0
11269,1996-1997,32,PSV,FC Utrecht,6,1,1,3,0,7,5,15.0,5.0
11270,1996-1997,32,Vitesse,Fortuna Sittard,2,1,1,3,0,3,1,10.0,7.0
11271,1996-1997,32,AFC Ajax,FC Twente,3,2,1,3,0,5,1,10.0,4.0
11272,1996-1997,32,Willem II,De Graafschap,2,0,1,3,0,2,2,5.0,7.0
11273,1996-1997,32,Feyenoord,Sparta Rotterdam,6,1,1,3,0,7,5,11.0,7.0
11274,1996-1997,33,FC Groningen,Sparta Rotterdam,1,2,2,0,3,3,-1,5.0,9.0
11275,1996-1997,33,PSV,Willem II,3,1,1,3,0,4,2,15.0,4.0
11276,1996-1997,33,FC Volendam,FC Utrecht,5,2,1,3,0,7,3,8.0,4.0
11277,1996-1997,33,RKC Waalwijk,AZ Alkmaar,5,0,1,3,0,5,5,9.0,4.0
11278,1996-1997,33,Vitesse,NEC Nijmegen,1,1,3,1,1,2,0,10.0,5.0
11279,1996-1997,33,De Graafschap,Roda JC Kerkrade,5,2,1,3,0,7,3,9.0,9.0
11280,1996-1997,33,FC Twente,NAC Breda,4,0,1,3,0,4,4,7.0,1.0
11281,1996-1997,33,Fortuna Sittard,AFC Ajax,2,1,1,3,0,3,1,7.0,7.0
11282,1996-1997,33,Feyenoord,sc Heerenveen,4,2,1,3,0,6,2,11.0,3.0
11283,1996-1997,34,NEC Nijmegen,De Graafschap,2,1,1,3,0,3,1,8.0,9.0
11284,1996-1997,34,Sparta Rotterdam,RKC Waalwijk,1,3,2,0,3,4,-2,6.0,12.0
11285,1996-1997,34,Roda JC Kerkrade,PSV,3,1,1,3,0,4,2,9.0,12.0
11286,1996-1997,34,Willem II,FC Volendam,0,0,3,1,1,0,0,4.0,8.0
11287,1996-1997,34,sc Heerenveen,FC Groningen,1,3,2,0,3,4,-2,0.0,7.0
11288,1996-1997,34,AZ Alkmaar,FC Twente,1,2,2,0,3,3,-1,4.0,10.0
11289,1996-1997,34,NAC Breda,Fortuna Sittard,1,1,3,1,1,2,0,1.0,7.0
11290,1996-1997,34,AFC Ajax,Vitesse,4,0,1,3,0,4,4,10.0,7.0
11291,1996-1997,34,FC Utrecht,Feyenoord,2,1,1,3,0,3,1,6.0,10.0
11292,1997-1998,1,FC Twente,Fortuna Sittard,4,1,1,3,0,5,3,10.0,7.0
11293,1997-1998,1,AFC Ajax,Vitesse,5,0,1,3,0,5,5,12.0,4.0
11294,1997-1998,1,FC Groningen,FC Volendam,3,0,1,3,0,3,3,9.0,7.0
11295,1997-1998,1,sc Heerenveen,NAC Breda,3,1,1,3,0,4,2,3.0,1.0
11296,1997-1998,1,Roda JC Kerkrade,FC Utrecht,1,0,1,3,0,1,1,9.0,6.0
11297,1997-1998,1,PSV,RKC Waalwijk,5,1,1,3,0,6,4,12.0,9.0
11298,1997-1998,1,Sparta Rotterdam,De Graafschap,1,1,3,1,1,2,0,7.0,7.0
11299,1997-1998,1,Willem II,NEC Nijmegen,1,2,2,0,3,3,-1,4.0,10.0
11300,1997-1998,1,MVV Maastricht,Feyenoord,0,3,2,0,3,3,-3,2.0,10.0
11301,1997-1998,2,Fortuna Sittard,AFC Ajax,0,5,2,0,3,5,-5,4.0,12.0
11302,1997-1998,2,De Graafschap,Willem II,3,1,1,3,0,4,2,7.0,4.0
11303,1997-1998,2,NEC Nijmegen,sc Heerenveen,0,1,2,0,3,1,-1,10.0,6.0
11304,1997-1998,2,FC Volendam,FC Twente,0,0,3,1,1,0,0,8.0,10.0
11305,1997-1998,2,Vitesse,Roda JC Kerkrade,3,1,1,3,0,4,2,7.0,6.0
11306,1997-1998,2,FC Utrecht,MVV Maastricht,6,1,1,3,0,7,5,6.0,2.0
11307,1997-1998,2,RKC Waalwijk,FC Groningen,1,1,3,1,1,2,0,10.0,10.0
11308,1997-1998,2,NAC Breda,PSV,3,3,3,1,1,6,0,2.0,10.0
11309,1997-1998,2,Feyenoord,Sparta Rotterdam,3,1,1,3,0,4,2,12.0,4.0
11310,1997-1998,3,sc Heerenveen,MVV Maastricht,3,1,1,3,0,4,2,9.0,2.0
11311,1997-1998,3,Fortuna Sittard,RKC Waalwijk,0,3,2,0,3,3,-3,4.0,10.0
11312,1997-1998,3,NAC Breda,NEC Nijmegen,0,1,2,0,3,1,-1,2.0,10.0
11313,1997-1998,3,PSV,Willem II,3,0,1,3,0,3,3,10.0,1.0
11314,1997-1998,3,Roda JC Kerkrade,FC Groningen,4,1,1,3,0,5,3,9.0,7.0
11315,1997-1998,3,Feyenoord,De Graafschap,2,0,1,3,0,2,2,12.0,7.0
11316,1997-1998,3,FC Utrecht,AFC Ajax,1,7,2,0,3,8,-6,6.0,12.0
11317,1997-1998,3,FC Twente,Sparta Rotterdam,2,1,1,3,0,3,1,13.0,4.0
11318,1997-1998,3,FC Volendam,Vitesse,1,1,3,1,1,2,0,6.0,5.0
11319,1997-1998,4,MVV Maastricht,NAC Breda,0,1,2,0,3,1,-1,1.0,5.0
11320,1997-1998,4,Roda JC Kerkrade,FC Volendam,0,2,2,0,3,2,-2,9.0,6.0
11321,1997-1998,4,FC Groningen,NEC Nijmegen,4,0,1,3,0,4,4,10.0,9.0
11322,1997-1998,4,AFC Ajax,RKC Waalwijk,3,0,1,3,0,3,3,15.0,7.0
11323,1997-1998,4,FC Utrecht,FC Twente,1,1,3,1,1,2,0,7.0,11.0
11324,1997-1998,4,Vitesse,Willem II,3,1,1,3,0,4,2,7.0,1.0
11325,1997-1998,4,PSV,De Graafschap,0,0,3,1,1,0,0,8.0,5.0
11326,1997-1998,4,Sparta Rotterdam,Fortuna Sittard,1,1,3,1,1,2,0,2.0,2.0
11327,1997-1998,4,sc Heerenveen,Feyenoord,0,0,3,1,1,0,0,10.0,10.0
11328,1997-1998,5,MVV Maastricht,Roda JC Kerkrade,1,2,2,0,3,3,-1,0.0,9.0
11329,1997-1998,5,AFC Ajax,FC Groningen,4,1,1,3,0,5,3,15.0,7.0
11330,1997-1998,5,Willem II,Fortuna Sittard,0,0,3,1,1,0,0,1.0,2.0
11331,1997-1998,5,Sparta Rotterdam,FC Volendam,5,0,1,3,0,5,5,5.0,5.0
11332,1997-1998,5,Vitesse,FC Utrecht,5,0,1,3,0,5,5,10.0,4.0
11333,1997-1998,5,NEC Nijmegen,FC Twente,1,2,2,0,3,3,-1,6.0,11.0
11334,1997-1998,5,Feyenoord,PSV,1,1,3,1,1,2,0,11.0,9.0
11335,1997-1998,5,RKC Waalwijk,sc Heerenveen,1,1,3,1,1,2,0,5.0,11.0
11336,1997-1998,5,De Graafschap,NAC Breda,0,1,2,0,3,1,-1,5.0,7.0
11337,1997-1998,6,Fortuna Sittard,De Graafschap,1,0,1,3,0,1,1,5.0,4.0
11338,1997-1998,6,Willem II,FC Volendam,5,2,1,3,0,7,3,4.0,5.0
11339,1997-1998,6,PSV,Sparta Rotterdam,4,2,1,3,0,6,2,9.0,4.0
11340,1997-1998,6,FC Groningen,Vitesse,1,1,3,1,1,2,0,5.0,11.0
11341,1997-1998,6,FC Twente,MVV Maastricht,1,0,1,3,0,1,1,11.0,0.0
11342,1997-1998,6,Roda JC Kerkrade,sc Heerenveen,0,2,2,0,3,2,-2,6.0,11.0
11343,1997-1998,6,NEC Nijmegen,AFC Ajax,1,4,2,0,3,5,-3,3.0,15.0
11344,1997-1998,6,RKC Waalwijk,FC Utrecht,3,1,1,3,0,4,2,8.0,4.0
11345,1997-1998,6,PSV,Fortuna Sittard,3,2,1,3,0,5,1,11.0,5.0
11346,1997-1998,7,NAC Breda,FC Groningen,0,0,3,1,1,0,0,8.0,5.0
11347,1997-1998,7,Willem II,RKC Waalwijk,3,2,1,3,0,5,1,7.0,7.0
11348,1997-1998,7,sc Heerenveen,FC Twente,2,1,1,3,0,3,1,11.0,10.0
11349,1997-1998,7,Feyenoord,Vitesse,5,1,1,3,0,6,4,11.0,8.0
11350,1997-1998,7,AFC Ajax,MVV Maastricht,7,0,1,3,0,7,7,15.0,0.0
11351,1997-1998,7,FC Volendam,De Graafschap,0,5,2,0,3,5,-5,4.0,4.0
11352,1997-1998,7,Roda JC Kerkrade,NEC Nijmegen,4,0,1,3,0,4,4,9.0,3.0
11353,1997-1998,7,Sparta Rotterdam,FC Utrecht,4,2,1,3,0,6,2,7.0,1.0
11354,1997-1998,7,MVV Maastricht,NEC Nijmegen,2,0,1,3,0,2,2,3.0,0.0
11355,1997-1998,8,FC Twente,NAC Breda,1,1,3,1,1,2,0,8.0,8.0
11356,1997-1998,8,De Graafschap,RKC Waalwijk,1,0,1,3,0,1,1,7.0,4.0
11357,1997-1998,8,Fortuna Sittard,Vitesse,1,7,2,0,3,8,-6,5.0,10.0
11358,1997-1998,8,sc Heerenveen,AFC Ajax,0,1,2,0,3,1,-1,8.0,15.0
11359,1997-1998,8,FC Volendam,PSV,0,6,2,0,3,6,-6,3.0,11.0
11360,1997-1998,8,FC Utrecht,Willem II,2,2,3,1,1,4,0,2.0,8.0
11361,1997-1998,8,FC Groningen,Feyenoord,2,0,1,3,0,2,2,8.0,8.0
11362,1997-1998,8,Sparta Rotterdam,Roda JC Kerkrade,3,1,1,3,0,4,2,10.0,6.0
11363,1997-1998,8,MVV Maastricht,Sparta Rotterdam,2,2,3,1,1,4,0,4.0,10.0
11364,1997-1998,9,NEC Nijmegen,FC Volendam,4,1,1,3,0,5,3,3.0,0.0
11365,1997-1998,9,PSV,sc Heerenveen,3,1,1,3,0,4,2,13.0,7.0
11366,1997-1998,9,Feyenoord,NAC Breda,2,1,1,3,0,3,1,8.0,8.0
11367,1997-1998,9,Vitesse,RKC Waalwijk,3,2,1,3,0,5,1,10.0,4.0
11368,1997-1998,9,Willem II,AFC Ajax,0,1,2,0,3,1,-1,8.0,15.0
11369,1997-1998,9,De Graafschap,FC Utrecht,0,1,2,0,3,1,-1,6.0,4.0
11370,1997-1998,9,FC Twente,FC Groningen,2,0,1,3,0,2,2,10.0,5.0
11371,1997-1998,9,FC Groningen,Willem II,2,2,3,1,1,4,0,6.0,8.0
11372,1997-1998,9,Feyenoord,MVV Maastricht,2,1,1,3,0,3,1,10.0,4.0
11373,1997-1998,10,FC Volendam,Fortuna Sittard,0,3,2,0,3,3,-3,0.0,7.0
11374,1997-1998,10,Roda JC Kerkrade,PSV,2,2,3,1,1,4,0,7.0,13.0
11375,1997-1998,10,De Graafschap,Sparta Rotterdam,2,2,3,1,1,4,0,7.0,8.0
11376,1997-1998,10,RKC Waalwijk,NEC Nijmegen,0,0,3,1,1,0,0,4.0,4.0
11377,1997-1998,10,AFC Ajax,NAC Breda,1,0,1,3,0,1,1,15.0,5.0
11378,1997-1998,10,FC Utrecht,sc Heerenveen,2,4,2,0,3,6,-2,4.0,9.0
11379,1997-1998,10,Fortuna Sittard,FC Groningen,4,1,1,3,0,5,3,9.0,5.0
11380,1997-1998,10,Roda JC Kerkrade,Vitesse,1,1,3,1,1,2,0,5.0,8.0
11381,1997-1998,10,NAC Breda,RKC Waalwijk,4,0,1,3,0,4,4,5.0,1.0
11382,1997-1998,11,sc Heerenveen,Sparta Rotterdam,1,1,3,1,1,2,0,7.0,9.0
11383,1997-1998,11,FC Twente,De Graafschap,1,1,3,1,1,2,0,8.0,8.0
11384,1997-1998,11,Willem II,Feyenoord,2,0,1,3,0,2,2,8.0,9.0
11385,1997-1998,11,NEC Nijmegen,PSV,0,4,2,0,3,4,-4,4.0,13.0
11386,1997-1998,11,De Graafschap,sc Heerenveen,1,2,2,0,3,3,-1,5.0,7.0
11387,1997-1998,11,PSV,MVV Maastricht,5,0,1,3,0,5,5,13.0,4.0
11388,1997-1998,11,FC Twente,Roda JC Kerkrade,1,2,2,0,3,3,-1,5.0,8.0
11389,1997-1998,11,Vitesse,Fortuna Sittard,1,0,1,3,0,1,1,10.0,6.0
11390,1997-1998,11,FC Utrecht,NEC Nijmegen,2,4,2,0,3,6,-2,4.0,7.0
11391,1997-1998,12,Sparta Rotterdam,FC Groningen,1,1,3,1,1,2,0,7.0,5.0
11392,1997-1998,12,RKC Waalwijk,FC Volendam,1,1,3,1,1,2,0,2.0,1.0
11393,1997-1998,12,AFC Ajax,Feyenoord,4,0,1,3,0,4,4,15.0,6.0
11394,1997-1998,12,Feyenoord,Fortuna Sittard,1,3,2,0,3,4,-2,6.0,9.0
11395,1997-1998,12,NEC Nijmegen,De Graafschap,0,4,2,0,3,4,-4,7.0,5.0
11396,1997-1998,12,Roda JC Kerkrade,AFC Ajax,1,1,3,1,1,2,0,6.0,13.0
11397,1997-1998,12,sc Heerenveen,PSV,1,1,3,1,1,2,0,8.0,11.0
11398,1997-1998,12,MVV Maastricht,Willem II,1,0,1,3,0,1,1,7.0,5.0
11399,1997-1998,12,FC Twente,Vitesse,1,1,3,1,1,2,0,6.0,11.0
11400,1997-1998,13,NAC Breda,De Graafschap,2,0,1,3,0,2,2,7.0,5.0
11401,1997-1998,13,Fortuna Sittard,NEC Nijmegen,0,2,2,0,3,2,-2,9.0,7.0
11402,1997-1998,13,FC Volendam,FC Utrecht,0,1,2,0,3,1,-1,1.0,7.0
11403,1997-1998,13,Feyenoord,RKC Waalwijk,2,1,1,3,0,3,1,6.0,2.0
11404,1997-1998,13,MVV Maastricht,FC Volendam,4,1,1,3,0,5,3,7.0,1.0
11405,1997-1998,13,FC Utrecht,FC Groningen,2,0,1,3,0,2,2,9.0,2.0
11406,1997-1998,13,Vitesse,sc Heerenveen,4,2,1,3,0,6,2,11.0,8.0
11407,1997-1998,13,FC Volendam,Feyenoord,0,0,3,1,1,0,0,2.0,4.0
11408,1997-1998,13,Sparta Rotterdam,AFC Ajax,0,5,2,0,3,5,-5,4.0,13.0
11409,1997-1998,14,RKC Waalwijk,Roda JC Kerkrade,3,3,3,1,1,6,0,3.0,7.0
11410,1997-1998,14,PSV,NAC Breda,5,1,1,3,0,6,4,11.0,6.0
11411,1997-1998,14,NEC Nijmegen,Roda JC Kerkrade,2,1,1,3,0,3,1,9.0,6.0
11412,1997-1998,14,sc Heerenveen,FC Volendam,3,1,1,3,0,4,2,8.0,2.0
11413,1997-1998,14,AFC Ajax,FC Twente,1,0,1,3,0,1,1,13.0,5.0
11414,1997-1998,14,Vitesse,Sparta Rotterdam,2,0,1,3,0,2,2,11.0,3.0
11415,1997-1998,14,De Graafschap,MVV Maastricht,1,2,2,0,3,3,-1,4.0,9.0
11416,1997-1998,14,Willem II,FC Twente,3,1,1,3,0,4,2,7.0,2.0
11417,1997-1998,14,Fortuna Sittard,sc Heerenveen,3,1,1,3,0,4,2,9.0,7.0
11418,1997-1998,15,NEC Nijmegen,Vitesse,0,2,2,0,3,2,-2,9.0,13.0
11419,1997-1998,15,FC Utrecht,RKC Waalwijk,6,1,1,3,0,7,5,9.0,2.0
11420,1997-1998,15,De Graafschap,Feyenoord,0,0,3,1,1,0,0,4.0,5.0
11421,1997-1998,15,Sparta Rotterdam,MVV Maastricht,4,0,1,3,0,4,4,5.0,9.0
11422,1997-1998,15,FC Groningen,PSV,1,1,3,1,1,2,0,3.0,11.0
11423,1997-1998,15,NAC Breda,Willem II,0,2,2,0,3,2,-2,6.0,10.0
11424,1997-1998,15,Roda JC Kerkrade,Willem II,0,1,2,0,3,1,-1,5.0,12.0
11425,1997-1998,15,Vitesse,FC Groningen,5,1,1,3,0,6,4,13.0,2.0
11426,1997-1998,15,PSV,FC Twente,3,0,1,3,0,3,3,11.0,1.0
11427,1997-1998,16,AFC Ajax,De Graafschap,1,0,1,3,0,1,1,13.0,4.0
11428,1997-1998,16,NAC Breda,Fortuna Sittard,3,1,1,3,0,4,2,9.0,6.0
11429,1997-1998,16,MVV Maastricht,RKC Waalwijk,1,1,3,1,1,2,0,10.0,3.0
11430,1997-1998,16,Feyenoord,FC Utrecht,3,1,1,3,0,4,2,8.0,9.0
11431,1997-1998,16,FC Volendam,FC Groningen,3,1,1,3,0,4,2,4.0,2.0
11432,1997-1998,16,RKC Waalwijk,NAC Breda,1,0,1,3,0,1,1,5.0,6.0
11433,1997-1998,16,De Graafschap,NEC Nijmegen,3,2,1,3,0,5,1,4.0,6.0
11434,1997-1998,16,Willem II,NAC Breda,2,0,1,3,0,2,2,12.0,3.0
11435,1997-1998,16,Sparta Rotterdam,Feyenoord,0,3,2,0,3,3,-3,4.0,11.0
11436,1997-1998,17,Vitesse,PSV,2,2,3,1,1,4,0,13.0,9.0
11437,1997-1998,17,FC Twente,FC Volendam,1,1,3,1,1,2,0,2.0,5.0
11438,1997-1998,17,AFC Ajax,Fortuna Sittard,2,0,1,3,0,2,2,13.0,6.0
11439,1997-1998,17,FC Utrecht,Roda JC Kerkrade,1,0,1,3,0,1,1,12.0,2.0
11440,1997-1998,17,FC Groningen,sc Heerenveen,0,1,2,0,3,1,-1,1.0,7.0
11441,1997-1998,17,NAC Breda,Roda JC Kerkrade,1,0,1,3,0,1,1,6.0,1.0
11442,1997-1998,17,RKC Waalwijk,Sparta Rotterdam,1,3,2,0,3,4,-2,5.0,6.0
11443,1997-1998,17,MVV Maastricht,AFC Ajax,0,3,2,0,3,3,-3,7.0,15.0
11444,1997-1998,17,Fortuna Sittard,FC Volendam,3,0,1,3,0,3,3,6.0,5.0
11445,1997-1998,18,NEC Nijmegen,Willem II,0,3,2,0,3,3,-3,6.0,15.0
11446,1997-1998,18,Fortuna Sittard,FC Twente,1,0,1,3,0,1,1,9.0,1.0
11447,1997-1998,18,AFC Ajax,Roda JC Kerkrade,1,0,1,3,0,1,1,15.0,0.0
11448,1997-1998,18,NAC Breda,Sparta Rotterdam,1,2,2,0,3,3,-1,6.0,9.0
11449,1997-1998,18,sc Heerenveen,De Graafschap,0,0,3,1,1,0,0,7.0,5.0
11450,1997-1998,18,NEC Nijmegen,Feyenoord,3,2,1,3,0,5,1,6.0,8.0
11451,1997-1998,18,FC Groningen,MVV Maastricht,2,3,2,0,3,5,-1,1.0,7.0
11452,1997-1998,18,FC Utrecht,Vitesse,5,3,1,3,0,8,2,12.0,10.0
11453,1997-1998,18,Willem II,PSV,4,1,1,3,0,5,3,15.0,8.0
11454,1997-1998,19,Sparta Rotterdam,Willem II,4,1,1,3,0,5,3,12.0,12.0
11455,1997-1998,19,Roda JC Kerkrade,MVV Maastricht,3,0,1,3,0,3,3,3.0,4.0
11456,1997-1998,19,sc Heerenveen,Vitesse,3,2,1,3,0,5,1,10.0,7.0
11457,1997-1998,19,RKC Waalwijk,Fortuna Sittard,1,2,2,0,3,3,-1,4.0,9.0
11458,1997-1998,19,Feyenoord,FC Twente,2,2,3,1,1,4,0,8.0,2.0
11459,1997-1998,19,FC Volendam,AFC Ajax,0,3,2,0,3,3,-3,4.0,15.0
11460,1997-1998,19,FC Groningen,NAC Breda,1,1,3,1,1,2,0,1.0,4.0
11461,1997-1998,19,Fortuna Sittard,Roda JC Kerkrade,1,1,3,1,1,2,0,10.0,4.0
11462,1997-1998,19,MVV Maastricht,FC Utrecht,0,0,3,1,1,0,0,5.0,10.0
11463,1997-1998,20,NEC Nijmegen,Sparta Rotterdam,2,0,1,3,0,2,2,6.0,9.0
11464,1997-1998,20,De Graafschap,FC Groningen,2,3,2,0,3,5,-1,5.0,4.0
11465,1997-1998,20,AFC Ajax,PSV,3,4,2,0,3,7,-1,12.0,8.0
11466,1997-1998,20,FC Volendam,NAC Breda,0,3,2,0,3,3,-3,4.0,7.0
11467,1997-1998,20,Feyenoord,Willem II,4,2,1,3,0,6,2,10.0,9.0
11468,1997-1998,20,Vitesse,FC Twente,2,1,1,3,0,3,1,7.0,2.0
11469,1997-1998,20,Fortuna Sittard,Sparta Rotterdam,2,1,1,3,0,3,1,13.0,9.0
11470,1997-1998,20,FC Twente,NEC Nijmegen,1,0,1,3,0,1,1,5.0,6.0
11471,1997-1998,20,MVV Maastricht,FC Groningen,1,0,1,3,0,1,1,7.0,4.0
11472,1997-1998,21,Willem II,Vitesse,1,0,1,3,0,1,1,9.0,4.0
11473,1997-1998,21,NAC Breda,sc Heerenveen,0,2,2,0,3,2,-2,7.0,10.0
11474,1997-1998,21,RKC Waalwijk,AFC Ajax,1,5,2,0,3,6,-4,4.0,12.0
11475,1997-1998,21,FC Utrecht,Feyenoord,2,3,2,0,3,5,-1,7.0,10.0
11476,1997-1998,21,De Graafschap,PSV,1,2,2,0,3,3,-1,4.0,10.0
11477,1997-1998,21,FC Volendam,Roda JC Kerkrade,1,4,2,0,3,5,-3,1.0,7.0
11478,1997-1998,21,PSV,FC Utrecht,4,1,1,3,0,5,3,10.0,7.0
11479,1997-1998,21,Fortuna Sittard,Willem II,2,1,1,3,0,3,1,13.0,6.0
11480,1997-1998,21,NAC Breda,MVV Maastricht,2,0,1,3,0,2,2,7.0,7.0
11481,1997-1998,22,NEC Nijmegen,FC Groningen,0,2,2,0,3,2,-2,6.0,7.0
11482,1997-1998,22,Roda JC Kerkrade,RKC Waalwijk,1,2,2,0,3,3,-1,7.0,6.0
11483,1997-1998,22,De Graafschap,Vitesse,3,3,3,1,1,6,0,5.0,4.0
11484,1997-1998,22,PSV,AFC Ajax,1,1,3,1,1,2,0,10.0,10.0
11485,1997-1998,22,FC Utrecht,FC Volendam,4,1,1,3,0,5,3,7.0,0.0
11486,1997-1998,22,FC Twente,Feyenoord,0,0,3,1,1,0,0,5.0,8.0
11487,1997-1998,22,Sparta Rotterdam,sc Heerenveen,2,4,2,0,3,6,-2,6.0,13.0
11488,1997-1998,22,FC Groningen,De Graafschap,0,3,2,0,3,3,-3,7.0,5.0
11489,1997-1998,22,sc Heerenveen,Roda JC Kerkrade,3,1,1,3,0,4,2,13.0,7.0
11490,1997-1998,23,RKC Waalwijk,Vitesse,0,1,2,0,3,1,-1,3.0,7.0
11491,1997-1998,23,MVV Maastricht,FC Twente,2,2,3,1,1,4,0,5.0,6.0
11492,1997-1998,23,De Graafschap,Fortuna Sittard,1,0,1,3,0,1,1,7.0,10.0
11493,1997-1998,23,AFC Ajax,NEC Nijmegen,3,0,1,3,0,3,3,10.0,6.0
11494,1997-1998,23,FC Volendam,Willem II,4,1,1,3,0,5,3,3.0,3.0
11495,1997-1998,23,FC Utrecht,NAC Breda,1,3,2,0,3,4,-2,4.0,10.0
11496,1997-1998,23,Feyenoord,sc Heerenveen,2,0,1,3,0,2,2,11.0,12.0
11497,1997-1998,23,FC Groningen,Sparta Rotterdam,1,1,3,1,1,2,0,7.0,4.0
11498,1997-1998,23,FC Twente,RKC Waalwijk,2,0,1,3,0,2,2,8.0,3.0
11499,1997-1998,24,Fortuna Sittard,MVV Maastricht,4,1,1,3,0,5,3,10.0,5.0
11500,1997-1998,24,Willem II,De Graafschap,1,1,3,1,1,2,0,4.0,8.0
11501,1997-1998,24,sc Heerenveen,NEC Nijmegen,0,3,2,0,3,3,-3,9.0,6.0
11502,1997-1998,24,FC Groningen,RKC Waalwijk,3,1,1,3,0,4,2,7.0,3.0
11503,1997-1998,24,FC Volendam,Sparta Rotterdam,1,1,3,1,1,2,0,4.0,2.0
11504,1997-1998,24,FC Utrecht,PSV,0,1,2,0,3,1,-1,3.0,13.0
11505,1997-1998,24,Roda JC Kerkrade,Feyenoord,1,2,2,0,3,3,-1,4.0,13.0
11506,1997-1998,24,Roda JC Kerkrade,Fortuna Sittard,0,0,3,1,1,0,0,4.0,10.0
11507,1997-1998,24,sc Heerenveen,Willem II,1,3,2,0,3,4,-2,6.0,7.0
11508,1997-1998,25,NAC Breda,FC Twente,1,0,1,3,0,1,1,12.0,8.0
11509,1997-1998,25,NEC Nijmegen,MVV Maastricht,2,1,1,3,0,3,1,6.0,4.0
11510,1997-1998,25,AFC Ajax,FC Volendam,6,1,1,3,0,7,5,10.0,4.0
11511,1997-1998,25,FC Utrecht,Sparta Rotterdam,3,0,1,3,0,3,3,6.0,2.0
11512,1997-1998,25,RKC Waalwijk,PSV,0,1,2,0,3,1,-1,3.0,13.0
11513,1997-1998,25,Fortuna Sittard,FC Utrecht,3,1,1,3,0,4,2,10.0,6.0
11514,1997-1998,25,PSV,Vitesse,3,2,1,3,0,5,1,13.0,7.0
11515,1997-1998,25,De Graafschap,FC Volendam,2,1,1,3,0,3,1,11.0,4.0
11516,1997-1998,25,Willem II,MVV Maastricht,2,0,1,3,0,2,2,7.0,1.0
11517,1997-1998,26,Sparta Rotterdam,RKC Waalwijk,1,0,1,3,0,1,1,5.0,0.0
11518,1997-1998,26,NAC Breda,AFC Ajax,0,2,2,0,3,2,-2,9.0,13.0
11519,1997-1998,26,FC Groningen,FC Twente,0,1,2,0,3,1,-1,7.0,8.0
11520,1997-1998,26,PSV,Roda JC Kerkrade,2,0,1,3,0,2,2,13.0,1.0
11521,1997-1998,26,Fortuna Sittard,Feyenoord,0,2,2,0,3,2,-2,7.0,13.0
11522,1997-1998,26,Vitesse,NAC Breda,4,1,1,3,0,5,3,7.0,9.0
11523,1997-1998,26,Willem II,FC Groningen,4,2,1,3,0,6,2,10.0,4.0
11524,1997-1998,26,MVV Maastricht,De Graafschap,2,1,1,3,0,3,1,4.0,10.0
11525,1997-1998,26,RKC Waalwijk,FC Twente,5,1,1,3,0,6,4,3.0,7.0
11526,1997-1998,27,FC Volendam,NEC Nijmegen,2,0,1,3,0,2,2,7.0,6.0
11527,1997-1998,27,sc Heerenveen,FC Utrecht,1,0,1,3,0,1,1,6.0,3.0
11528,1997-1998,27,Roda JC Kerkrade,NAC Breda,0,0,3,1,1,0,0,2.0,7.0
11529,1997-1998,27,Sparta Rotterdam,Vitesse,1,1,3,1,1,2,0,6.0,8.0
11530,1997-1998,27,PSV,NEC Nijmegen,2,1,1,3,0,3,1,15.0,6.0
11531,1997-1998,27,Willem II,FC Utrecht,3,2,1,3,0,5,1,13.0,3.0
11532,1997-1998,27,RKC Waalwijk,De Graafschap,4,1,1,3,0,5,3,6.0,7.0
11533,1997-1998,27,FC Twente,AFC Ajax,1,2,2,0,3,3,-1,6.0,13.0
11534,1997-1998,27,Feyenoord,FC Volendam,5,0,1,3,0,5,5,13.0,4.0
11535,1997-1998,28,Feyenoord,FC Groningen,3,0,1,3,0,3,3,15.0,4.0
11536,1997-1998,28,Sparta Rotterdam,NAC Breda,1,1,3,1,1,2,0,6.0,5.0
11537,1997-1998,28,MVV Maastricht,sc Heerenveen,1,2,2,0,3,3,-1,3.0,6.0
11538,1997-1998,28,Vitesse,NEC Nijmegen,2,1,1,3,0,3,1,10.0,6.0
11539,1997-1998,28,Feyenoord,AFC Ajax,0,1,2,0,3,1,-1,12.0,15.0
11540,1997-1998,28,FC Volendam,RKC Waalwijk,3,4,2,0,3,7,-1,3.0,9.0
11541,1997-1998,28,FC Twente,FC Utrecht,1,2,2,0,3,3,-1,3.0,6.0
11542,1997-1998,28,FC Groningen,Roda JC Kerkrade,1,1,3,1,1,2,0,4.0,3.0
11543,1997-1998,28,MVV Maastricht,PSV,2,1,1,3,0,3,1,6.0,12.0
11544,1997-1998,29,NEC Nijmegen,RKC Waalwijk,2,1,1,3,0,3,1,6.0,9.0
11545,1997-1998,29,Vitesse,FC Volendam,6,0,1,3,0,6,6,10.0,3.0
11546,1997-1998,29,FC Twente,Willem II,2,0,1,3,0,2,2,6.0,12.0
11547,1997-1998,29,sc Heerenveen,FC Groningen,1,1,3,1,1,2,0,7.0,2.0
11548,1997-1998,29,De Graafschap,Roda JC Kerkrade,2,0,1,3,0,2,2,7.0,3.0
11549,1997-1998,29,AFC Ajax,Sparta Rotterdam,4,0,1,3,0,4,4,15.0,5.0
11550,1997-1998,29,FC Utrecht,Fortuna Sittard,1,0,1,3,0,1,1,6.0,7.0
11551,1997-1998,29,NEC Nijmegen,Fortuna Sittard,2,2,3,1,1,4,0,4.0,5.0
11552,1997-1998,29,NAC Breda,FC Utrecht,2,1,1,3,0,3,1,5.0,6.0
11553,1997-1998,30,Vitesse,De Graafschap,4,1,1,3,0,5,3,13.0,6.0
11554,1997-1998,30,Roda JC Kerkrade,FC Twente,2,0,1,3,0,2,2,5.0,3.0
11555,1997-1998,30,AFC Ajax,sc Heerenveen,7,2,1,3,0,9,5,15.0,7.0
11556,1997-1998,30,RKC Waalwijk,Feyenoord,3,2,1,3,0,5,1,12.0,9.0
11557,1997-1998,30,Sparta Rotterdam,PSV,3,1,1,3,0,4,2,8.0,9.0
11558,1997-1998,30,Vitesse,MVV Maastricht,3,1,1,3,0,4,2,13.0,6.0
11559,1997-1998,30,MVV Maastricht,Fortuna Sittard,1,4,2,0,3,5,-3,6.0,7.0
11560,1997-1998,30,Willem II,sc Heerenveen,5,2,1,3,0,7,3,12.0,7.0
11561,1997-1998,30,PSV,FC Volendam,10,0,1,3,0,10,10,9.0,3.0
11562,1997-1998,31,Sparta Rotterdam,NEC Nijmegen,1,0,1,3,0,1,1,8.0,4.0
11563,1997-1998,31,FC Utrecht,De Graafschap,0,0,3,1,1,0,0,7.0,4.0
11564,1997-1998,31,NAC Breda,Feyenoord,1,3,2,0,3,4,-2,5.0,9.0
11565,1997-1998,31,FC Groningen,AFC Ajax,2,4,2,0,3,6,-2,2.0,15.0
11566,1997-1998,31,FC Twente,sc Heerenveen,3,1,1,3,0,4,2,6.0,4.0
11567,1997-1998,31,NAC Breda,Vitesse,1,3,2,0,3,4,-2,5.0,15.0
11568,1997-1998,31,Feyenoord,Roda JC Kerkrade,1,0,1,3,0,1,1,9.0,5.0
11569,1997-1998,31,Fortuna Sittard,PSV,1,2,2,0,3,3,-1,4.0,9.0
11570,1997-1998,31,AFC Ajax,Willem II,6,1,1,3,0,7,5,15.0,9.0
11571,1997-1998,32,FC Volendam,MVV Maastricht,1,2,2,0,3,3,-1,0.0,6.0
11572,1997-1998,32,Roda JC Kerkrade,Sparta Rotterdam,2,0,1,3,0,2,2,7.0,7.0
11573,1997-1998,32,sc Heerenveen,Fortuna Sittard,2,2,3,1,1,4,0,2.0,5.0
11574,1997-1998,32,NEC Nijmegen,NAC Breda,2,0,1,3,0,2,2,7.0,4.0
11575,1997-1998,32,FC Groningen,FC Utrecht,1,2,2,0,3,3,-1,2.0,10.0
11576,1997-1998,32,RKC Waalwijk,Willem II,1,4,2,0,3,5,-3,9.0,9.0
11577,1997-1998,32,Vitesse,AFC Ajax,2,0,1,3,0,2,2,15.0,12.0
11578,1997-1998,32,PSV,Feyenoord,3,3,3,1,1,6,0,7.0,7.0
11579,1997-1998,32,De Graafschap,FC Twente,2,1,1,3,0,3,1,7.0,6.0
11580,1997-1998,33,FC Volendam,sc Heerenveen,4,1,1,3,0,5,3,3.0,1.0
11581,1997-1998,33,Fortuna Sittard,NAC Breda,4,1,1,3,0,5,3,8.0,3.0
11582,1997-1998,33,Willem II,Roda JC Kerkrade,2,4,2,0,3,6,-2,6.0,9.0
11583,1997-1998,33,Vitesse,Feyenoord,2,1,1,3,0,3,1,15.0,7.0
11584,1997-1998,33,Sparta Rotterdam,FC Twente,1,1,3,1,1,2,0,7.0,7.0
11585,1997-1998,33,PSV,FC Groningen,6,2,1,3,0,8,4,10.0,2.0
11586,1997-1998,33,NEC Nijmegen,FC Utrecht,1,0,1,3,0,1,1,10.0,7.0
11587,1997-1998,33,De Graafschap,AFC Ajax,1,8,2,0,3,9,-7,7.0,12.0
11588,1997-1998,33,RKC Waalwijk,MVV Maastricht,1,1,3,1,1,2,0,7.0,7.0
11589,1997-1998,34,sc Heerenveen,RKC Waalwijk,3,2,1,3,0,5,1,4.0,4.0
11590,1997-1998,34,FC Twente,PSV,3,0,1,3,0,3,3,7.0,10.0
11591,1997-1998,34,Roda JC Kerkrade,De Graafschap,1,2,2,0,3,3,-1,9.0,7.0
11592,1997-1998,34,AFC Ajax,FC Utrecht,1,2,2,0,3,3,-1,9.0,7.0
11593,1997-1998,34,NAC Breda,FC Volendam,4,1,1,3,0,5,3,3.0,3.0
11594,1997-1998,34,FC Groningen,Fortuna Sittard,1,0,1,3,0,1,1,4.0,7.0
11595,1997-1998,34,Feyenoord,NEC Nijmegen,0,2,2,0,3,2,-2,7.0,10.0
11596,1997-1998,34,Willem II,Sparta Rotterdam,3,0,1,3,0,3,3,9.0,7.0
11597,1997-1998,34,MVV Maastricht,Vitesse,1,3,2,0,3,4,-2,4.0,15.0
11598,1998-1999,1,sc Heerenveen,FC Twente,1,0,1,3,0,1,1,7.0,7.0
11599,1998-1999,1,Fortuna Sittard,Feyenoord,1,2,2,0,3,3,-1,4.0,7.0
11600,1998-1999,1,AZ Alkmaar,Sparta Rotterdam,2,0,1,3,0,2,2,6.0,4.0
11601,1998-1999,1,RKC Waalwijk,NEC Nijmegen,0,1,2,0,3,1,-1,4.0,12.0
11602,1998-1999,1,MVV Maastricht,De Graafschap,1,2,2,0,3,3,-1,4.0,10.0
11603,1998-1999,1,Vitesse,Roda JC Kerkrade,1,0,1,3,0,1,1,15.0,6.0
11604,1998-1999,1,SC Cambuur,PSV,1,1,3,1,1,2,0,5.0,8.0
11605,1998-1999,1,AFC Ajax,Willem II,2,0,1,3,0,2,2,9.0,6.0
11606,1998-1999,1,NAC Breda,FC Utrecht,2,4,2,0,3,6,-2,3.0,10.0
11607,1998-1999,2,Roda JC Kerkrade,AFC Ajax,0,2,2,0,3,2,-2,6.0,9.0
11608,1998-1999,2,AZ Alkmaar,Vitesse,0,0,3,1,1,0,0,4.0,13.0
11609,1998-1999,2,Willem II,Fortuna Sittard,1,0,1,3,0,1,1,9.0,4.0
11610,1998-1999,2,PSV,sc Heerenveen,1,2,2,0,3,3,-1,5.0,10.0
11611,1998-1999,2,NEC Nijmegen,NAC Breda,1,1,3,1,1,2,0,13.0,4.0
11612,1998-1999,2,FC Twente,Sparta Rotterdam,1,0,1,3,0,1,1,7.0,1.0
11613,1998-1999,2,FC Utrecht,SC Cambuur,3,0,1,3,0,3,3,12.0,4.0
11614,1998-1999,2,Feyenoord,MVV Maastricht,3,1,1,3,0,4,2,7.0,4.0
11615,1998-1999,2,De Graafschap,RKC Waalwijk,2,2,3,1,1,4,0,10.0,2.0
11616,1998-1999,3,Sparta Rotterdam,Roda JC Kerkrade,1,1,3,1,1,2,0,2.0,4.0
11617,1998-1999,3,sc Heerenveen,Willem II,2,2,3,1,1,4,0,10.0,7.0
11618,1998-1999,3,RKC Waalwijk,PSV,3,4,2,0,3,7,-1,2.0,7.0
11619,1998-1999,3,Feyenoord,De Graafschap,5,0,1,3,0,5,5,9.0,7.0
11620,1998-1999,3,NAC Breda,FC Twente,1,1,3,1,1,2,0,5.0,8.0
11621,1998-1999,3,Fortuna Sittard,Vitesse,0,2,2,0,3,2,-2,3.0,13.0
11622,1998-1999,3,SC Cambuur,NEC Nijmegen,2,2,3,1,1,4,0,5.0,11.0
11623,1998-1999,3,MVV Maastricht,FC Utrecht,1,4,2,0,3,5,-3,1.0,12.0
11624,1998-1999,3,AFC Ajax,AZ Alkmaar,5,1,1,3,0,6,4,12.0,4.0
11625,1998-1999,4,sc Heerenveen,Feyenoord,0,1,2,0,3,1,-1,10.0,12.0
11626,1998-1999,4,PSV,MVV Maastricht,2,0,1,3,0,2,2,7.0,0.0
11627,1998-1999,4,Fortuna Sittard,AZ Alkmaar,2,2,3,1,1,4,0,1.0,5.0
11628,1998-1999,4,Roda JC Kerkrade,NAC Breda,3,1,1,3,0,4,2,4.0,5.0
11629,1998-1999,4,Vitesse,SC Cambuur,4,2,1,3,0,6,2,13.0,2.0
11630,1998-1999,4,Willem II,Sparta Rotterdam,3,2,1,3,0,5,1,10.0,1.0
11631,1998-1999,4,FC Utrecht,AFC Ajax,2,2,3,1,1,4,0,13.0,10.0
11632,1998-1999,4,FC Twente,RKC Waalwijk,1,0,1,3,0,1,1,10.0,1.0
11633,1998-1999,4,De Graafschap,NEC Nijmegen,2,1,1,3,0,3,1,10.0,8.0
11634,1998-1999,5,NEC Nijmegen,Roda JC Kerkrade,3,1,1,3,0,4,2,8.0,4.0
11635,1998-1999,5,AZ Alkmaar,Willem II,1,1,3,1,1,2,0,6.0,8.0
11636,1998-1999,5,MVV Maastricht,Vitesse,4,2,1,3,0,6,2,3.0,10.0
11637,1998-1999,5,SC Cambuur,FC Twente,0,2,2,0,3,2,-2,2.0,10.0
11638,1998-1999,5,AFC Ajax,De Graafschap,1,1,3,1,1,2,0,11.0,8.0
11639,1998-1999,5,FC Utrecht,Fortuna Sittard,1,1,3,1,1,2,0,11.0,2.0
11640,1998-1999,5,Sparta Rotterdam,NAC Breda,0,2,2,0,3,2,-2,1.0,5.0
11641,1998-1999,5,RKC Waalwijk,sc Heerenveen,0,4,2,0,3,4,-4,1.0,10.0
11642,1998-1999,5,PSV,Feyenoord,1,2,2,0,3,3,-1,7.0,15.0
11643,1998-1999,6,sc Heerenveen,FC Utrecht,1,0,1,3,0,1,1,10.0,8.0
11644,1998-1999,6,NAC Breda,AZ Alkmaar,1,1,3,1,1,2,0,6.0,4.0
11645,1998-1999,6,FC Twente,MVV Maastricht,2,1,1,3,0,3,1,13.0,3.0
11646,1998-1999,6,De Graafschap,Sparta Rotterdam,0,3,2,0,3,3,-3,5.0,4.0
11647,1998-1999,6,Willem II,SC Cambuur,2,1,1,3,0,3,1,11.0,1.0
11648,1998-1999,6,Fortuna Sittard,AFC Ajax,1,0,1,3,0,1,1,5.0,8.0
11649,1998-1999,6,Vitesse,RKC Waalwijk,2,0,1,3,0,2,2,10.0,1.0
11650,1998-1999,7,Fortuna Sittard,MVV Maastricht,0,1,2,0,3,1,-1,5.0,6.0
11651,1998-1999,7,Vitesse,Sparta Rotterdam,5,1,1,3,0,6,4,12.0,4.0
11652,1998-1999,7,Feyenoord,Willem II,3,2,1,3,0,5,1,15.0,8.0
11653,1998-1999,7,NEC Nijmegen,sc Heerenveen,2,0,1,3,0,2,2,8.0,7.0
11654,1998-1999,7,Roda JC Kerkrade,RKC Waalwijk,0,0,3,1,1,0,0,5.0,1.0
11655,1998-1999,7,SC Cambuur,De Graafschap,2,0,1,3,0,2,2,4.0,4.0
11656,1998-1999,7,FC Utrecht,FC Twente,0,3,2,0,3,3,-3,5.0,13.0
11657,1998-1999,7,AFC Ajax,NAC Breda,1,0,1,3,0,1,1,8.0,5.0
11658,1998-1999,7,AZ Alkmaar,PSV,4,1,1,3,0,5,3,6.0,6.0
11659,1998-1999,8,MVV Maastricht,SC Cambuur,3,0,1,3,0,3,3,9.0,3.0
11660,1998-1999,8,PSV,Fortuna Sittard,2,0,1,3,0,2,2,9.0,5.0
11661,1998-1999,8,Willem II,Roda JC Kerkrade,1,2,2,0,3,3,-1,7.0,8.0
11662,1998-1999,8,sc Heerenveen,NAC Breda,2,1,1,3,0,3,1,9.0,4.0
11663,1998-1999,8,De Graafschap,Vitesse,0,0,3,1,1,0,0,5.0,10.0
11664,1998-1999,8,RKC Waalwijk,AZ Alkmaar,2,3,2,0,3,5,-1,1.0,9.0
11665,1998-1999,8,FC Utrecht,NEC Nijmegen,2,3,2,0,3,5,-1,2.0,10.0
11666,1998-1999,8,Sparta Rotterdam,AFC Ajax,2,0,1,3,0,2,2,6.0,5.0
11667,1998-1999,8,FC Twente,Feyenoord,1,1,3,1,1,2,0,13.0,13.0
11668,1998-1999,9,AZ Alkmaar,sc Heerenveen,1,3,2,0,3,4,-2,8.0,12.0
11669,1998-1999,9,Feyenoord,Roda JC Kerkrade,0,0,3,1,1,0,0,11.0,8.0
11670,1998-1999,9,SC Cambuur,RKC Waalwijk,1,1,3,1,1,2,0,4.0,2.0
11671,1998-1999,9,Vitesse,Willem II,3,2,1,3,0,5,1,10.0,4.0
11672,1998-1999,9,Fortuna Sittard,Sparta Rotterdam,2,1,1,3,0,3,1,7.0,6.0
11673,1998-1999,9,NAC Breda,MVV Maastricht,2,0,1,3,0,2,2,7.0,9.0
11674,1998-1999,9,AFC Ajax,FC Twente,5,0,1,3,0,5,5,7.0,10.0
11675,1998-1999,9,De Graafschap,FC Utrecht,0,0,3,1,1,0,0,3.0,2.0
11676,1998-1999,9,NEC Nijmegen,PSV,2,2,3,1,1,4,0,10.0,7.0
11677,1998-1999,10,NEC Nijmegen,AZ Alkmaar,2,2,3,1,1,4,0,11.0,8.0
11678,1998-1999,10,Roda JC Kerkrade,Fortuna Sittard,5,3,1,3,0,8,2,8.0,6.0
11679,1998-1999,10,FC Twente,De Graafschap,2,1,1,3,0,3,1,10.0,2.0
11680,1998-1999,10,MVV Maastricht,RKC Waalwijk,1,0,1,3,0,1,1,9.0,2.0
11681,1998-1999,10,Sparta Rotterdam,sc Heerenveen,3,1,1,3,0,4,2,9.0,9.0
11682,1998-1999,10,Willem II,PSV,4,2,1,3,0,6,2,6.0,4.0
11683,1998-1999,10,AFC Ajax,SC Cambuur,4,0,1,3,0,4,4,9.0,4.0
11684,1998-1999,10,FC Utrecht,Feyenoord,2,3,2,0,3,5,-1,1.0,11.0
11685,1998-1999,10,NAC Breda,Vitesse,0,2,2,0,3,2,-2,4.0,13.0
11686,1998-1999,11,Fortuna Sittard,FC Twente,0,3,2,0,3,3,-3,3.0,10.0
11687,1998-1999,11,sc Heerenveen,Vitesse,2,1,1,3,0,3,1,9.0,10.0
11688,1998-1999,11,Feyenoord,AZ Alkmaar,1,2,2,0,3,3,-1,8.0,10.0
11689,1998-1999,11,PSV,Sparta Rotterdam,4,0,1,3,0,4,4,7.0,6.0
11690,1998-1999,11,MVV Maastricht,Willem II,1,1,3,1,1,2,0,10.0,4.0
11691,1998-1999,11,SC Cambuur,NAC Breda,3,1,1,3,0,4,2,7.0,3.0
11692,1998-1999,11,NEC Nijmegen,AFC Ajax,0,4,2,0,3,4,-4,8.0,12.0
11693,1998-1999,11,FC Utrecht,Roda JC Kerkrade,0,3,2,0,3,3,-3,1.0,11.0
11694,1998-1999,11,RKC Waalwijk,De Graafschap,1,2,2,0,3,3,-1,2.0,5.0
11695,1998-1999,12,RKC Waalwijk,FC Utrecht,2,5,2,0,3,7,-3,1.0,4.0
11696,1998-1999,12,Roda JC Kerkrade,SC Cambuur,1,0,1,3,0,1,1,13.0,4.0
11697,1998-1999,12,De Graafschap,Willem II,2,2,3,1,1,4,0,6.0,5.0
11698,1998-1999,12,sc Heerenveen,Fortuna Sittard,2,0,1,3,0,2,2,12.0,3.0
11699,1998-1999,12,Sparta Rotterdam,MVV Maastricht,0,0,3,1,1,0,0,7.0,8.0
11700,1998-1999,12,FC Twente,PSV,2,2,3,1,1,4,0,8.0,8.0
11701,1998-1999,12,Vitesse,NEC Nijmegen,1,0,1,3,0,1,1,10.0,5.0
11702,1998-1999,12,AZ Alkmaar,AFC Ajax,1,1,3,1,1,2,0,8.0,10.0
11703,1998-1999,13,Willem II,RKC Waalwijk,3,0,1,3,0,3,3,8.0,1.0
11704,1998-1999,13,NAC Breda,NEC Nijmegen,1,2,2,0,3,3,-1,3.0,5.0
11705,1998-1999,13,FC Twente,sc Heerenveen,1,2,2,0,3,3,-1,7.0,12.0
11706,1998-1999,13,Fortuna Sittard,De Graafschap,0,0,3,1,1,0,0,4.0,6.0
11707,1998-1999,13,SC Cambuur,AZ Alkmaar,0,0,3,1,1,0,0,5.0,6.0
11708,1998-1999,13,AFC Ajax,Roda JC Kerkrade,2,1,1,3,0,3,1,13.0,10.0
11709,1998-1999,13,MVV Maastricht,Feyenoord,1,3,2,0,3,4,-2,5.0,8.0
11710,1998-1999,13,PSV,Vitesse,3,1,1,3,0,4,2,8.0,9.0
11711,1998-1999,14,NEC Nijmegen,FC Twente,2,2,3,1,1,4,0,5.0,8.0
11712,1998-1999,14,De Graafschap,Roda JC Kerkrade,2,3,2,0,3,5,-1,5.0,12.0
11713,1998-1999,14,MVV Maastricht,AZ Alkmaar,2,1,1,3,0,3,1,8.0,6.0
11714,1998-1999,14,AFC Ajax,PSV,2,2,3,1,1,4,0,11.0,8.0
11715,1998-1999,14,Willem II,NAC Breda,2,1,1,3,0,3,1,11.0,3.0
11716,1998-1999,14,Feyenoord,Fortuna Sittard,4,1,1,3,0,5,3,10.0,1.0
11717,1998-1999,14,RKC Waalwijk,Sparta Rotterdam,5,1,1,3,0,6,4,3.0,4.0
11718,1998-1999,14,Vitesse,FC Utrecht,2,0,1,3,0,2,2,9.0,4.0
11719,1998-1999,15,MVV Maastricht,NEC Nijmegen,0,3,2,0,3,3,-3,5.0,7.0
11720,1998-1999,15,Roda JC Kerkrade,Vitesse,3,1,1,3,0,4,2,12.0,6.0
11721,1998-1999,15,NAC Breda,Fortuna Sittard,1,1,3,1,1,2,0,1.0,2.0
11722,1998-1999,15,FC Twente,Willem II,5,1,1,3,0,6,4,8.0,8.0
11723,1998-1999,15,De Graafschap,sc Heerenveen,1,1,3,1,1,2,0,6.0,10.0
11724,1998-1999,15,Feyenoord,SC Cambuur,4,0,1,3,0,4,4,12.0,4.0
11725,1998-1999,15,Sparta Rotterdam,AZ Alkmaar,0,0,3,1,1,0,0,5.0,6.0
11726,1998-1999,15,RKC Waalwijk,AFC Ajax,0,1,2,0,3,1,-1,3.0,11.0
11727,1998-1999,15,PSV,FC Utrecht,5,0,1,3,0,5,5,11.0,3.0
11728,1998-1999,16,sc Heerenveen,SC Cambuur,1,1,3,1,1,2,0,11.0,5.0
11729,1998-1999,16,SC Cambuur,Fortuna Sittard,3,1,1,3,0,4,2,5.0,2.0
11730,1998-1999,16,Roda JC Kerkrade,MVV Maastricht,2,1,1,3,0,3,1,12.0,4.0
11731,1998-1999,16,PSV,De Graafschap,2,2,3,1,1,4,0,9.0,4.0
11732,1998-1999,16,Vitesse,AFC Ajax,3,2,1,3,0,5,1,9.0,8.0
11733,1998-1999,16,FC Utrecht,Willem II,2,0,1,3,0,2,2,6.0,7.0
11734,1998-1999,16,Sparta Rotterdam,Feyenoord,1,2,2,0,3,3,-1,2.0,12.0
11735,1998-1999,16,sc Heerenveen,PSV,3,3,3,1,1,6,0,9.0,9.0
11736,1998-1999,16,NEC Nijmegen,Sparta Rotterdam,3,1,1,3,0,4,2,10.0,2.0
11737,1998-1999,16,SC Cambuur,FC Utrecht,1,1,3,1,1,2,0,6.0,7.0
11738,1998-1999,16,AZ Alkmaar,Roda JC Kerkrade,1,0,1,3,0,1,1,6.0,9.0
11739,1998-1999,16,Fortuna Sittard,RKC Waalwijk,3,2,1,3,0,5,1,5.0,3.0
11740,1998-1999,16,Willem II,Vitesse,3,5,2,0,3,8,-2,6.0,9.0
11741,1998-1999,16,AZ Alkmaar,FC Twente,1,1,3,1,1,2,0,6.0,6.0
11742,1998-1999,16,Feyenoord,NEC Nijmegen,1,0,1,3,0,1,1,15.0,10.0
11743,1998-1999,17,FC Utrecht,De Graafschap,2,1,1,3,0,3,1,7.0,3.0
11744,1998-1999,17,Sparta Rotterdam,SC Cambuur,1,2,2,0,3,3,-1,1.0,8.0
11745,1998-1999,17,NAC Breda,PSV,3,4,2,0,3,7,-1,1.0,9.0
11746,1998-1999,17,AFC Ajax,MVV Maastricht,1,1,3,1,1,2,0,8.0,4.0
11747,1998-1999,17,RKC Waalwijk,Feyenoord,0,5,2,0,3,5,-5,3.0,15.0
11748,1998-1999,17,MVV Maastricht,Fortuna Sittard,3,3,3,1,1,6,0,5.0,5.0
11749,1998-1999,17,PSV,Roda JC Kerkrade,3,3,3,1,1,6,0,9.0,10.0
11750,1998-1999,17,Willem II,NEC Nijmegen,1,0,1,3,0,1,1,6.0,7.0
11751,1998-1999,18,De Graafschap,NAC Breda,0,1,2,0,3,1,-1,2.0,4.0
11752,1998-1999,18,Sparta Rotterdam,FC Twente,4,2,1,3,0,6,2,4.0,5.0
11753,1998-1999,18,AZ Alkmaar,FC Utrecht,4,3,1,3,0,7,1,8.0,7.0
11754,1998-1999,18,Vitesse,Feyenoord,1,1,3,1,1,2,0,10.0,13.0
11755,1998-1999,18,AFC Ajax,sc Heerenveen,0,0,3,1,1,0,0,6.0,7.0
11756,1998-1999,18,Roda JC Kerkrade,FC Twente,2,0,1,3,0,2,2,10.0,5.0
11757,1998-1999,18,NEC Nijmegen,RKC Waalwijk,1,1,3,1,1,2,0,7.0,4.0
11758,1998-1999,18,NAC Breda,SC Cambuur,2,3,2,0,3,5,-1,4.0,11.0
11759,1998-1999,18,sc Heerenveen,MVV Maastricht,1,1,3,1,1,2,0,5.0,3.0
11760,1998-1999,19,FC Twente,Vitesse,0,0,3,1,1,0,0,5.0,8.0
11761,1998-1999,19,De Graafschap,AZ Alkmaar,1,1,3,1,1,2,0,3.0,9.0
11762,1998-1999,19,PSV,Willem II,1,0,1,3,0,1,1,9.0,3.0
11763,1998-1999,19,Feyenoord,AFC Ajax,1,1,3,1,1,2,0,11.0,6.0
11764,1998-1999,19,NEC Nijmegen,Fortuna Sittard,0,3,2,0,3,3,-3,4.0,8.0
11765,1998-1999,19,RKC Waalwijk,NAC Breda,2,1,1,3,0,3,1,4.0,4.0
11766,1998-1999,19,FC Utrecht,Sparta Rotterdam,4,1,1,3,0,5,3,10.0,3.0
11767,1998-1999,19,NEC Nijmegen,De Graafschap,1,1,3,1,1,2,0,2.0,3.0
11768,1998-1999,19,FC Twente,AZ Alkmaar,0,3,2,0,3,3,-3,2.0,11.0
11769,1998-1999,20,Fortuna Sittard,NAC Breda,2,0,1,3,0,2,2,10.0,3.0
11770,1998-1999,20,Willem II,sc Heerenveen,3,2,1,3,0,5,1,6.0,4.0
11771,1998-1999,20,RKC Waalwijk,MVV Maastricht,2,2,3,1,1,4,0,5.0,4.0
11772,1998-1999,20,Roda JC Kerkrade,NEC Nijmegen,5,2,1,3,0,7,3,10.0,2.0
11773,1998-1999,20,FC Twente,AFC Ajax,2,1,1,3,0,3,1,4.0,3.0
11774,1998-1999,20,Sparta Rotterdam,FC Utrecht,0,1,2,0,3,1,-1,3.0,10.0
11775,1998-1999,20,Vitesse,NAC Breda,3,1,1,3,0,4,2,11.0,3.0
11776,1998-1999,20,RKC Waalwijk,Fortuna Sittard,0,0,3,1,1,0,0,6.0,11.0
11777,1998-1999,20,sc Heerenveen,AFC Ajax,2,2,3,1,1,4,0,4.0,4.0
11778,1998-1999,21,NEC Nijmegen,Willem II,0,3,2,0,3,3,-3,2.0,9.0
11779,1998-1999,21,PSV,FC Twente,3,0,1,3,0,3,3,11.0,4.0
11780,1998-1999,21,Fortuna Sittard,SC Cambuur,2,0,1,3,0,2,2,11.0,10.0
11781,1998-1999,21,Vitesse,MVV Maastricht,2,1,1,3,0,3,1,11.0,4.0
11782,1998-1999,21,Roda JC Kerkrade,Sparta Rotterdam,1,0,1,3,0,1,1,10.0,3.0
11783,1998-1999,21,AZ Alkmaar,RKC Waalwijk,2,1,1,3,0,3,1,11.0,6.0
11784,1998-1999,21,De Graafschap,FC Twente,0,2,2,0,3,2,-2,2.0,7.0
11785,1998-1999,21,FC Utrecht,sc Heerenveen,2,2,3,1,1,4,0,10.0,4.0
11786,1998-1999,21,Feyenoord,PSV,3,1,1,3,0,4,2,11.0,10.0
11787,1998-1999,22,NAC Breda,De Graafschap,0,1,2,0,3,1,-1,0.0,5.0
11788,1998-1999,22,Feyenoord,RKC Waalwijk,1,0,1,3,0,1,1,11.0,5.0
11789,1998-1999,22,SC Cambuur,Vitesse,2,2,3,1,1,4,0,8.0,9.0
11790,1998-1999,22,NEC Nijmegen,MVV Maastricht,1,1,3,1,1,2,0,2.0,4.0
11791,1998-1999,22,Willem II,FC Utrecht,1,0,1,3,0,1,1,12.0,7.0
11792,1998-1999,22,PSV,NAC Breda,2,0,1,3,0,2,2,10.0,0.0
11793,1998-1999,22,Roda JC Kerkrade,AZ Alkmaar,8,2,1,3,0,10,6,13.0,10.0
11794,1998-1999,22,Feyenoord,sc Heerenveen,2,1,1,3,0,3,1,11.0,3.0
11795,1998-1999,22,AFC Ajax,Sparta Rotterdam,5,1,1,3,0,6,4,6.0,3.0
11796,1998-1999,23,Roda JC Kerkrade,PSV,1,3,2,0,3,4,-2,12.0,12.0
11797,1998-1999,23,NAC Breda,sc Heerenveen,2,2,3,1,1,4,0,1.0,3.0
11798,1998-1999,23,Vitesse,Fortuna Sittard,1,2,2,0,3,3,-1,8.0,13.0
11799,1998-1999,23,AZ Alkmaar,SC Cambuur,3,1,1,3,0,4,2,10.0,7.0
11800,1998-1999,23,MVV Maastricht,FC Twente,2,5,2,0,3,7,-3,3.0,9.0
11801,1998-1999,23,De Graafschap,Feyenoord,3,4,2,0,3,7,-1,5.0,13.0
11802,1998-1999,23,Sparta Rotterdam,NEC Nijmegen,1,0,1,3,0,1,1,3.0,2.0
11803,1998-1999,23,RKC Waalwijk,Willem II,1,3,2,0,3,4,-2,2.0,12.0
11804,1998-1999,23,AFC Ajax,FC Utrecht,5,2,1,3,0,7,3,8.0,7.0
11805,1998-1999,24,sc Heerenveen,RKC Waalwijk,2,0,1,3,0,2,2,6.0,1.0
11806,1998-1999,24,PSV,SC Cambuur,3,0,1,3,0,3,3,12.0,4.0
11807,1998-1999,24,Willem II,De Graafschap,2,0,1,3,0,2,2,15.0,4.0
11808,1998-1999,24,Sparta Rotterdam,Vitesse,1,3,2,0,3,4,-2,3.0,10.0
11809,1998-1999,24,FC Twente,Roda JC Kerkrade,0,0,3,1,1,0,0,10.0,10.0
11810,1998-1999,24,FC Utrecht,AZ Alkmaar,2,2,3,1,1,4,0,5.0,10.0
11811,1998-1999,24,MVV Maastricht,AFC Ajax,1,4,2,0,3,5,-3,2.0,10.0
11812,1998-1999,24,SC Cambuur,Feyenoord,1,5,2,0,3,6,-4,1.0,15.0
11813,1998-1999,24,NAC Breda,RKC Waalwijk,0,2,2,0,3,2,-2,1.0,3.0
11814,1998-1999,25,Fortuna Sittard,FC Utrecht,3,2,1,3,0,5,1,13.0,2.0
11815,1998-1999,25,Roda JC Kerkrade,Willem II,0,2,2,0,3,2,-2,7.0,15.0
11816,1998-1999,25,FC Twente,NEC Nijmegen,2,0,1,3,0,2,2,10.0,1.0
11817,1998-1999,25,sc Heerenveen,De Graafschap,4,1,1,3,0,5,3,8.0,3.0
11818,1998-1999,25,SC Cambuur,MVV Maastricht,1,0,1,3,0,1,1,4.0,1.0
11819,1998-1999,25,AZ Alkmaar,Fortuna Sittard,0,3,2,0,3,3,-3,7.0,13.0
11820,1998-1999,25,Willem II,Feyenoord,4,1,1,3,0,5,3,15.0,12.0
11821,1998-1999,25,Sparta Rotterdam,PSV,0,5,2,0,3,5,-5,3.0,12.0
11822,1998-1999,25,FC Utrecht,NAC Breda,2,0,1,3,0,2,2,4.0,1.0
11823,1998-1999,26,AFC Ajax,Vitesse,0,1,2,0,3,1,-1,10.0,10.0
11824,1998-1999,26,Roda JC Kerkrade,sc Heerenveen,2,1,1,3,0,3,1,7.0,7.0
11825,1998-1999,26,De Graafschap,MVV Maastricht,3,1,1,3,0,4,2,6.0,1.0
11826,1998-1999,26,MVV Maastricht,Roda JC Kerkrade,0,0,3,1,1,0,0,1.0,5.0
11827,1998-1999,26,NEC Nijmegen,SC Cambuur,1,0,1,3,0,1,1,4.0,3.0
11828,1998-1999,26,Fortuna Sittard,sc Heerenveen,1,0,1,3,0,1,1,15.0,7.0
11829,1998-1999,26,AZ Alkmaar,Feyenoord,0,2,2,0,3,2,-2,4.0,12.0
11830,1998-1999,26,Sparta Rotterdam,De Graafschap,2,3,2,0,3,5,-1,3.0,6.0
11831,1998-1999,26,RKC Waalwijk,Vitesse,0,2,2,0,3,2,-2,3.0,10.0
11832,1998-1999,27,PSV,AFC Ajax,3,1,1,3,0,4,2,15.0,9.0
11833,1998-1999,27,NAC Breda,Willem II,2,2,3,1,1,4,0,2.0,13.0
11834,1998-1999,27,FC Twente,FC Utrecht,1,1,3,1,1,2,0,11.0,5.0
11835,1998-1999,27,Feyenoord,Sparta Rotterdam,1,0,1,3,0,1,1,12.0,3.0
11836,1998-1999,27,SC Cambuur,Roda JC Kerkrade,1,1,3,1,1,2,0,4.0,6.0
11837,1998-1999,27,Fortuna Sittard,Willem II,1,2,2,0,3,3,-1,12.0,13.0
11838,1998-1999,27,MVV Maastricht,PSV,1,1,3,1,1,2,0,2.0,13.0
11839,1998-1999,27,Sparta Rotterdam,RKC Waalwijk,0,1,2,0,3,1,-1,0.0,6.0
11840,1998-1999,27,NAC Breda,Roda JC Kerkrade,0,0,3,1,1,0,0,3.0,6.0
11841,1998-1999,28,Willem II,AZ Alkmaar,2,0,1,3,0,2,2,13.0,4.0
11842,1998-1999,28,De Graafschap,Fortuna Sittard,0,0,3,1,1,0,0,7.0,10.0
11843,1998-1999,28,Vitesse,FC Twente,1,1,3,1,1,2,0,10.0,9.0
11844,1998-1999,28,sc Heerenveen,NEC Nijmegen,3,2,1,3,0,5,1,9.0,4.0
11845,1998-1999,28,SC Cambuur,AFC Ajax,4,1,1,3,0,5,3,7.0,6.0
11846,1998-1999,28,Feyenoord,FC Utrecht,4,2,1,3,0,6,2,12.0,5.0
11847,1998-1999,28,AZ Alkmaar,NAC Breda,3,0,1,3,0,3,3,4.0,2.0
11848,1998-1999,28,Vitesse,sc Heerenveen,1,2,2,0,3,3,-1,10.0,9.0
11849,1998-1999,28,AZ Alkmaar,De Graafschap,1,3,2,0,3,4,-2,3.0,10.0
11850,1998-1999,29,PSV,NEC Nijmegen,2,0,1,3,0,2,2,13.0,3.0
11851,1998-1999,29,MVV Maastricht,Sparta Rotterdam,1,1,3,1,1,2,0,3.0,1.0
11852,1998-1999,29,FC Twente,SC Cambuur,0,0,3,1,1,0,0,7.0,8.0
11853,1998-1999,29,NAC Breda,Feyenoord,0,1,2,0,3,1,-1,2.0,12.0
11854,1998-1999,29,FC Utrecht,RKC Waalwijk,1,1,3,1,1,2,0,5.0,7.0
11855,1998-1999,29,AFC Ajax,Fortuna Sittard,1,3,2,0,3,4,-2,3.0,10.0
11856,1998-1999,29,Vitesse,PSV,3,3,3,1,1,6,0,8.0,11.0
11857,1998-1999,29,AFC Ajax,NEC Nijmegen,3,0,1,3,0,3,3,3.0,3.0
11858,1998-1999,29,De Graafschap,PSV,1,0,1,3,0,1,1,13.0,8.0
11859,1998-1999,30,SC Cambuur,Sparta Rotterdam,2,4,2,0,3,6,-2,5.0,4.0
11860,1998-1999,30,sc Heerenveen,AZ Alkmaar,2,1,1,3,0,3,1,9.0,3.0
11861,1998-1999,30,RKC Waalwijk,FC Twente,2,2,3,1,1,4,0,8.0,7.0
11862,1998-1999,30,NEC Nijmegen,Vitesse,3,1,1,3,0,4,2,6.0,5.0
11863,1998-1999,30,FC Utrecht,MVV Maastricht,0,2,2,0,3,2,-2,5.0,6.0
11864,1998-1999,30,Fortuna Sittard,Roda JC Kerkrade,0,1,2,0,3,1,-1,7.0,9.0
11865,1998-1999,30,Feyenoord,NAC Breda,2,2,3,1,1,4,0,13.0,3.0
11866,1998-1999,30,Willem II,AFC Ajax,3,1,1,3,0,4,2,13.0,3.0
11867,1998-1999,30,MVV Maastricht,NAC Breda,3,3,3,1,1,6,0,7.0,3.0
11868,1998-1999,31,FC Twente,Fortuna Sittard,2,2,3,1,1,4,0,5.0,5.0
11869,1998-1999,31,PSV,RKC Waalwijk,2,2,3,1,1,4,0,6.0,6.0
11870,1998-1999,31,Roda JC Kerkrade,De Graafschap,3,1,1,3,0,4,2,9.0,10.0
11871,1998-1999,31,Vitesse,AZ Alkmaar,0,1,2,0,3,1,-1,2.0,6.0
11872,1998-1999,31,SC Cambuur,sc Heerenveen,0,0,3,1,1,0,0,6.0,10.0
11873,1998-1999,31,NEC Nijmegen,FC Utrecht,0,1,2,0,3,1,-1,3.0,5.0
11874,1998-1999,31,Sparta Rotterdam,Willem II,0,4,2,0,3,4,-4,4.0,13.0
11875,1998-1999,31,AFC Ajax,Feyenoord,6,0,1,3,0,6,6,6.0,10.0
11876,1998-1999,31,Fortuna Sittard,PSV,6,4,1,3,0,10,2,8.0,5.0
11877,1998-1999,32,Willem II,MVV Maastricht,4,1,1,3,0,5,3,15.0,6.0
11878,1998-1999,32,NAC Breda,Sparta Rotterdam,5,0,1,3,0,5,5,5.0,4.0
11879,1998-1999,32,sc Heerenveen,Roda JC Kerkrade,2,2,3,1,1,4,0,11.0,9.0
11880,1998-1999,32,AZ Alkmaar,NEC Nijmegen,1,1,3,1,1,2,0,7.0,4.0
11881,1998-1999,32,Feyenoord,FC Twente,3,1,1,3,0,4,2,10.0,4.0
11882,1998-1999,32,De Graafschap,AFC Ajax,1,3,2,0,3,4,-2,7.0,9.0
11883,1998-1999,32,FC Utrecht,Vitesse,1,2,2,0,3,3,-1,4.0,4.0
11884,1998-1999,32,RKC Waalwijk,SC Cambuur,4,1,1,3,0,5,3,9.0,5.0
11885,1998-1999,32,Roda JC Kerkrade,Feyenoord,1,0,1,3,0,1,1,11.0,7.0
11886,1998-1999,33,Vitesse,De Graafschap,2,1,1,3,0,3,1,7.0,6.0
11887,1998-1999,33,Roda JC Kerkrade,FC Utrecht,3,0,1,3,0,3,3,13.0,4.0
11888,1998-1999,33,MVV Maastricht,sc Heerenveen,1,0,1,3,0,1,1,8.0,8.0
11889,1998-1999,33,NEC Nijmegen,Feyenoord,0,3,2,0,3,3,-3,4.0,7.0
11890,1998-1999,33,Sparta Rotterdam,Fortuna Sittard,5,0,1,3,0,5,5,7.0,7.0
11891,1998-1999,33,SC Cambuur,Willem II,0,2,2,0,3,2,-2,2.0,15.0
11892,1998-1999,33,FC Twente,NAC Breda,2,2,3,1,1,4,0,4.0,6.0
11893,1998-1999,33,AFC Ajax,RKC Waalwijk,2,0,1,3,0,2,2,12.0,6.0
11894,1998-1999,33,PSV,AZ Alkmaar,7,1,1,3,0,8,6,5.0,4.0
11895,1998-1999,34,Fortuna Sittard,NEC Nijmegen,2,3,2,0,3,5,-1,4.0,7.0
11896,1998-1999,34,De Graafschap,SC Cambuur,2,2,3,1,1,4,0,4.0,2.0
11897,1998-1999,34,Willem II,FC Twente,1,2,2,0,3,3,-1,12.0,6.0
11898,1998-1999,34,NAC Breda,AFC Ajax,2,2,3,1,1,4,0,7.0,10.0
11899,1998-1999,34,FC Utrecht,PSV,2,3,2,0,3,5,-1,3.0,7.0
11900,1998-1999,34,AZ Alkmaar,MVV Maastricht,4,2,1,3,0,6,2,7.0,7.0
11901,1998-1999,34,Feyenoord,Vitesse,2,1,1,3,0,3,1,9.0,6.0
11902,1998-1999,34,RKC Waalwijk,Roda JC Kerkrade,4,1,1,3,0,5,3,8.0,10.0
11903,1998-1999,34,sc Heerenveen,Sparta Rotterdam,0,0,3,1,1,0,0,6.0,7.0
11904,1999-2000,1,Sparta Rotterdam,Willem II,0,2,2,0,3,2,-2,4.0,12.0
11905,1999-2000,1,FC Den Bosch,Feyenoord,0,4,2,0,3,4,-4,5.0,12.0
11906,1999-2000,1,SC Cambuur,Vitesse,1,1,3,1,1,2,0,3.0,7.0
11907,1999-2000,1,De Graafschap,Roda JC Kerkrade,0,0,3,1,1,0,0,2.0,8.0
11908,1999-2000,1,Fortuna Sittard,AZ Alkmaar,1,2,2,0,3,3,-1,4.0,10.0
11909,1999-2000,1,PSV,MVV Maastricht,4,1,1,3,0,5,3,10.0,4.0
11910,1999-2000,1,AFC Ajax,sc Heerenveen,3,2,1,3,0,5,1,13.0,3.0
11911,1999-2000,1,RKC Waalwijk,FC Twente,1,1,3,1,1,2,0,8.0,6.0
11912,1999-2000,1,FC Utrecht,NEC Nijmegen,1,0,1,3,0,1,1,6.0,4.0
11913,1999-2000,2,MVV Maastricht,AFC Ajax,2,6,2,0,3,8,-4,3.0,13.0
11914,1999-2000,2,FC Den Bosch,De Graafschap,1,1,3,1,1,2,0,6.0,3.0
11915,1999-2000,2,Willem II,Fortuna Sittard,2,2,3,1,1,4,0,10.0,4.0
11916,1999-2000,2,FC Twente,NEC Nijmegen,4,2,1,3,0,6,2,8.0,4.0
11917,1999-2000,2,sc Heerenveen,Sparta Rotterdam,3,1,1,3,0,4,2,5.0,4.0
11918,1999-2000,2,Roda JC Kerkrade,RKC Waalwijk,1,2,2,0,3,3,-1,7.0,10.0
11919,1999-2000,2,Vitesse,PSV,1,6,2,0,3,7,-5,7.0,12.0
11920,1999-2000,2,Feyenoord,SC Cambuur,4,0,1,3,0,4,4,12.0,2.0
11921,1999-2000,2,SC Cambuur,AFC Ajax,0,3,2,0,3,3,-3,2.0,13.0
11922,1999-2000,3,Roda JC Kerkrade,NEC Nijmegen,4,3,1,3,0,7,1,7.0,3.0
11923,1999-2000,3,PSV,Fortuna Sittard,2,1,1,3,0,3,1,15.0,1.0
11924,1999-2000,3,Vitesse,MVV Maastricht,6,2,1,3,0,8,4,7.0,3.0
11925,1999-2000,3,Willem II,FC Den Bosch,2,1,1,3,0,3,1,10.0,5.0
11926,1999-2000,3,RKC Waalwijk,AZ Alkmaar,1,2,2,0,3,3,-1,7.0,10.0
11927,1999-2000,3,FC Utrecht,FC Twente,1,0,1,3,0,1,1,6.0,8.0
11928,1999-2000,3,Feyenoord,sc Heerenveen,3,1,1,3,0,4,2,15.0,4.0
11929,1999-2000,3,AZ Alkmaar,Roda JC Kerkrade,1,2,2,0,3,3,-1,9.0,7.0
11930,1999-2000,3,AFC Ajax,Feyenoord,2,2,3,1,1,4,0,11.0,13.0
11931,1999-2000,4,FC Twente,Vitesse,0,0,3,1,1,0,0,8.0,5.0
11932,1999-2000,4,MVV Maastricht,SC Cambuur,1,1,3,1,1,2,0,1.0,3.0
11933,1999-2000,4,sc Heerenveen,Willem II,2,4,2,0,3,6,-2,4.0,10.0
11934,1999-2000,4,Fortuna Sittard,RKC Waalwijk,0,2,2,0,3,2,-2,1.0,10.0
11935,1999-2000,4,De Graafschap,PSV,1,2,2,0,3,3,-1,3.0,15.0
11936,1999-2000,4,Sparta Rotterdam,FC Utrecht,3,0,1,3,0,3,3,7.0,6.0
11937,1999-2000,4,Sparta Rotterdam,De Graafschap,2,1,1,3,0,3,1,7.0,3.0
11938,1999-2000,4,AZ Alkmaar,FC Utrecht,0,1,2,0,3,1,-1,9.0,9.0
11939,1999-2000,4,SC Cambuur,FC Twente,1,3,2,0,3,4,-2,2.0,8.0
11940,1999-2000,5,Feyenoord,Fortuna Sittard,1,0,1,3,0,1,1,13.0,1.0
11941,1999-2000,5,FC Den Bosch,MVV Maastricht,1,1,3,1,1,2,0,3.0,2.0
11942,1999-2000,5,Willem II,AZ Alkmaar,3,1,1,3,0,4,2,13.0,6.0
11943,1999-2000,5,FC Utrecht,De Graafschap,2,1,1,3,0,3,1,12.0,2.0
11944,1999-2000,5,Vitesse,Sparta Rotterdam,2,1,1,3,0,3,1,8.0,6.0
11945,1999-2000,5,RKC Waalwijk,AFC Ajax,1,1,3,1,1,2,0,8.0,11.0
11946,1999-2000,5,Roda JC Kerkrade,sc Heerenveen,0,2,2,0,3,2,-2,7.0,6.0
11947,1999-2000,5,AFC Ajax,Vitesse,3,1,1,3,0,4,2,11.0,7.0
11948,1999-2000,5,Roda JC Kerkrade,Fortuna Sittard,3,0,1,3,0,3,3,9.0,1.0
11949,1999-2000,6,PSV,Willem II,6,1,1,3,0,7,5,15.0,10.0
11950,1999-2000,6,sc Heerenveen,FC Twente,0,0,3,1,1,0,0,7.0,8.0
11951,1999-2000,6,FC Den Bosch,FC Utrecht,3,2,1,3,0,5,1,5.0,9.0
11952,1999-2000,6,Feyenoord,RKC Waalwijk,1,2,2,0,3,3,-1,10.0,10.0
11953,1999-2000,6,De Graafschap,NEC Nijmegen,2,2,3,1,1,4,0,2.0,4.0
11954,1999-2000,6,SC Cambuur,AZ Alkmaar,2,4,2,0,3,6,-2,1.0,6.0
11955,1999-2000,6,Sparta Rotterdam,MVV Maastricht,3,0,1,3,0,3,3,9.0,2.0
11956,1999-2000,6,NEC Nijmegen,FC Den Bosch,2,0,1,3,0,2,2,4.0,5.0
11957,1999-2000,6,MVV Maastricht,sc Heerenveen,1,3,2,0,3,4,-2,2.0,7.0
11958,1999-2000,7,FC Twente,FC Den Bosch,3,2,1,3,0,5,1,8.0,4.0
11959,1999-2000,7,RKC Waalwijk,De Graafschap,2,1,1,3,0,3,1,10.0,1.0
11960,1999-2000,7,PSV,Sparta Rotterdam,7,0,1,3,0,7,7,15.0,9.0
11961,1999-2000,7,Fortuna Sittard,SC Cambuur,4,1,1,3,0,5,3,3.0,1.0
11962,1999-2000,7,Willem II,AFC Ajax,3,6,2,0,3,9,-3,9.0,11.0
11963,1999-2000,7,Vitesse,NEC Nijmegen,5,1,1,3,0,6,4,10.0,4.0
11964,1999-2000,7,FC Utrecht,Roda JC Kerkrade,1,2,2,0,3,3,-1,6.0,12.0
11965,1999-2000,7,AZ Alkmaar,Feyenoord,0,0,3,1,1,0,0,4.0,8.0
11966,1999-2000,7,De Graafschap,MVV Maastricht,2,1,1,3,0,3,1,4.0,2.0
11967,1999-2000,8,Sparta Rotterdam,Roda JC Kerkrade,1,2,2,0,3,3,-1,6.0,12.0
11968,1999-2000,8,SC Cambuur,Willem II,0,1,2,0,3,1,-1,1.0,9.0
11969,1999-2000,8,Feyenoord,Vitesse,0,0,3,1,1,0,0,6.0,8.0
11970,1999-2000,8,AFC Ajax,Fortuna Sittard,4,1,1,3,0,5,3,11.0,3.0
11971,1999-2000,8,RKC Waalwijk,PSV,1,6,2,0,3,7,-5,10.0,15.0
11972,1999-2000,8,NEC Nijmegen,FC Twente,0,1,2,0,3,1,-1,4.0,11.0
11973,1999-2000,8,FC Den Bosch,AZ Alkmaar,2,3,2,0,3,5,-1,4.0,7.0
11974,1999-2000,8,sc Heerenveen,FC Utrecht,1,0,1,3,0,1,1,10.0,6.0
11975,1999-2000,8,Roda JC Kerkrade,Feyenoord,2,1,1,3,0,3,1,12.0,5.0
11976,1999-2000,9,Vitesse,SC Cambuur,1,0,1,3,0,1,1,10.0,0.0
11977,1999-2000,9,Fortuna Sittard,sc Heerenveen,0,1,2,0,3,1,-1,3.0,13.0
11978,1999-2000,9,MVV Maastricht,FC Utrecht,4,1,1,3,0,5,3,4.0,3.0
11979,1999-2000,9,Willem II,RKC Waalwijk,2,1,1,3,0,3,1,9.0,7.0
11980,1999-2000,9,Sparta Rotterdam,AZ Alkmaar,3,6,2,0,3,9,-3,3.0,10.0
11981,1999-2000,9,De Graafschap,FC Twente,0,0,3,1,1,0,0,5.0,11.0
11982,1999-2000,9,NEC Nijmegen,AFC Ajax,1,3,2,0,3,4,-2,4.0,13.0
11983,1999-2000,9,PSV,FC Den Bosch,7,0,1,3,0,7,7,15.0,3.0
11984,1999-2000,9,AZ Alkmaar,sc Heerenveen,0,1,2,0,3,1,-1,10.0,13.0
11985,1999-2000,10,SC Cambuur,De Graafschap,1,0,1,3,0,1,1,3.0,5.0
11986,1999-2000,10,Willem II,MVV Maastricht,1,0,1,3,0,1,1,9.0,3.0
11987,1999-2000,10,PSV,FC Twente,2,2,3,1,1,4,0,13.0,9.0
11988,1999-2000,10,Fortuna Sittard,Sparta Rotterdam,3,2,1,3,0,5,1,6.0,3.0
11989,1999-2000,10,AFC Ajax,FC Den Bosch,6,1,1,3,0,7,5,15.0,0.0
11990,1999-2000,10,FC Utrecht,RKC Waalwijk,4,1,1,3,0,5,3,3.0,6.0
11991,1999-2000,10,Feyenoord,NEC Nijmegen,2,1,1,3,0,3,1,5.0,3.0
11992,1999-2000,10,Roda JC Kerkrade,Vitesse,0,1,2,0,3,1,-1,12.0,10.0
11993,1999-2000,10,FC Twente,Sparta Rotterdam,3,2,1,3,0,5,1,11.0,0.0
11994,1999-2000,11,RKC Waalwijk,NEC Nijmegen,4,2,1,3,0,6,2,6.0,0.0
11995,1999-2000,11,sc Heerenveen,De Graafschap,2,0,1,3,0,2,2,15.0,4.0
11996,1999-2000,11,AFC Ajax,Roda JC Kerkrade,1,2,2,0,3,3,-1,12.0,12.0
11997,1999-2000,11,FC Den Bosch,SC Cambuur,1,1,3,1,1,2,0,1.0,4.0
11998,1999-2000,11,MVV Maastricht,Fortuna Sittard,1,0,1,3,0,1,1,6.0,6.0
11999,1999-2000,11,Vitesse,FC Utrecht,3,1,1,3,0,4,2,13.0,3.0
12000,1999-2000,11,AZ Alkmaar,PSV,0,3,2,0,3,3,-3,7.0,13.0
12001,1999-2000,11,NEC Nijmegen,sc Heerenveen,0,4,2,0,3,4,-4,0.0,15.0
12002,1999-2000,11,FC Utrecht,Fortuna Sittard,2,1,1,3,0,3,1,6.0,3.0
12003,1999-2000,12,De Graafschap,Willem II,0,2,2,0,3,2,-2,4.0,12.0
12004,1999-2000,12,MVV Maastricht,AZ Alkmaar,3,4,2,0,3,7,-1,6.0,9.0
12005,1999-2000,12,FC Twente,Feyenoord,3,3,3,1,1,6,0,9.0,6.0
12006,1999-2000,12,Sparta Rotterdam,AFC Ajax,1,2,2,0,3,3,-1,0.0,12.0
12007,1999-2000,12,Roda JC Kerkrade,FC Den Bosch,3,0,1,3,0,3,3,12.0,1.0
12008,1999-2000,12,RKC Waalwijk,SC Cambuur,3,2,1,3,0,5,1,6.0,4.0
12009,1999-2000,12,NEC Nijmegen,PSV,2,1,1,3,0,3,1,3.0,10.0
12010,1999-2000,12,MVV Maastricht,Feyenoord,3,3,3,1,1,6,0,7.0,6.0
12011,1999-2000,12,NEC Nijmegen,Sparta Rotterdam,0,1,2,0,3,1,-1,3.0,3.0
12012,1999-2000,13,AZ Alkmaar,FC Twente,2,1,1,3,0,3,1,9.0,6.0
12013,1999-2000,13,sc Heerenveen,Vitesse,1,3,2,0,3,4,-2,12.0,13.0
12014,1999-2000,13,Willem II,Roda JC Kerkrade,2,2,3,1,1,4,0,13.0,10.0
12015,1999-2000,13,Fortuna Sittard,De Graafschap,1,1,3,1,1,2,0,4.0,2.0
12016,1999-2000,13,FC Den Bosch,RKC Waalwijk,0,3,2,0,3,3,-3,1.0,9.0
12017,1999-2000,13,AFC Ajax,FC Utrecht,2,0,1,3,0,2,2,12.0,6.0
12018,1999-2000,13,SC Cambuur,PSV,0,1,2,0,3,1,-1,4.0,10.0
12019,1999-2000,13,sc Heerenveen,SC Cambuur,4,1,1,3,0,5,3,12.0,4.0
12020,1999-2000,13,Fortuna Sittard,NEC Nijmegen,2,2,3,1,1,4,0,5.0,4.0
12021,1999-2000,14,FC Twente,Willem II,4,0,1,3,0,4,4,8.0,10.0
12022,1999-2000,14,FC Utrecht,FC Den Bosch,2,1,1,3,0,3,1,9.0,1.0
12023,1999-2000,14,Feyenoord,PSV,1,0,1,3,0,1,1,8.0,7.0
12024,1999-2000,14,De Graafschap,Vitesse,2,2,3,1,1,4,0,2.0,13.0
12025,1999-2000,14,AZ Alkmaar,AFC Ajax,1,2,2,0,3,3,-1,6.0,12.0
12026,1999-2000,14,RKC Waalwijk,Sparta Rotterdam,2,1,1,3,0,3,1,12.0,3.0
12027,1999-2000,14,Roda JC Kerkrade,MVV Maastricht,3,1,1,3,0,4,2,10.0,4.0
12028,1999-2000,14,FC Den Bosch,sc Heerenveen,0,2,2,0,3,2,-2,1.0,12.0
12029,1999-2000,14,De Graafschap,AZ Alkmaar,2,5,2,0,3,7,-3,2.0,9.0
12030,1999-2000,15,Vitesse,RKC Waalwijk,2,1,1,3,0,3,1,13.0,12.0
12031,1999-2000,15,FC Twente,Fortuna Sittard,1,0,1,3,0,1,1,10.0,2.0
12032,1999-2000,15,Feyenoord,Willem II,1,0,1,3,0,1,1,11.0,7.0
12033,1999-2000,15,SC Cambuur,FC Utrecht,4,3,1,3,0,7,1,4.0,6.0
12034,1999-2000,15,MVV Maastricht,FC Twente,0,2,2,0,3,2,-2,4.0,10.0
12035,1999-2000,15,Sparta Rotterdam,Feyenoord,1,3,2,0,3,4,-2,3.0,11.0
12036,1999-2000,15,Vitesse,AZ Alkmaar,0,2,2,0,3,2,-2,10.0,12.0
12037,1999-2000,15,PSV,Roda JC Kerkrade,2,0,1,3,0,2,2,9.0,10.0
12038,1999-2000,15,Fortuna Sittard,FC Den Bosch,1,1,3,1,1,2,0,3.0,1.0
12039,1999-2000,16,NEC Nijmegen,SC Cambuur,1,0,1,3,0,1,1,7.0,3.0
12040,1999-2000,16,Willem II,FC Utrecht,4,3,1,3,0,7,1,7.0,6.0
12041,1999-2000,16,AFC Ajax,RKC Waalwijk,1,2,2,0,3,3,-1,9.0,12.0
12042,1999-2000,16,AZ Alkmaar,Fortuna Sittard,2,0,1,3,0,2,2,12.0,3.0
12043,1999-2000,16,Roda JC Kerkrade,De Graafschap,2,3,2,0,3,5,-1,7.0,5.0
12044,1999-2000,16,FC Utrecht,PSV,1,1,3,1,1,2,0,4.0,7.0
12045,1999-2000,16,RKC Waalwijk,MVV Maastricht,0,4,2,0,3,4,-4,9.0,4.0
12046,1999-2000,16,FC Den Bosch,Vitesse,2,1,1,3,0,3,1,4.0,7.0
12047,1999-2000,16,sc Heerenveen,RKC Waalwijk,4,1,1,3,0,5,3,12.0,6.0
12048,1999-2000,17,Vitesse,Willem II,3,1,1,3,0,4,2,7.0,4.0
12049,1999-2000,17,Sparta Rotterdam,FC Den Bosch,3,2,1,3,0,5,1,6.0,4.0
12050,1999-2000,17,NEC Nijmegen,MVV Maastricht,1,0,1,3,0,1,1,10.0,4.0
12051,1999-2000,17,AFC Ajax,PSV,1,3,2,0,3,4,-2,9.0,10.0
12052,1999-2000,17,Feyenoord,De Graafschap,0,0,3,1,1,0,0,11.0,6.0
12053,1999-2000,17,Willem II,Sparta Rotterdam,0,0,3,1,1,0,0,4.0,7.0
12054,1999-2000,17,Fortuna Sittard,Vitesse,3,3,3,1,1,6,0,3.0,7.0
12055,1999-2000,17,PSV,sc Heerenveen,0,1,2,0,3,1,-1,7.0,12.0
12056,1999-2000,17,AZ Alkmaar,NEC Nijmegen,1,1,3,1,1,2,0,10.0,8.0
12057,1999-2000,18,FC Twente,Roda JC Kerkrade,2,1,1,3,0,3,1,12.0,4.0
12058,1999-2000,18,De Graafschap,AFC Ajax,1,1,3,1,1,2,0,6.0,7.0
12059,1999-2000,18,FC Utrecht,Feyenoord,3,4,2,0,3,7,-1,4.0,13.0
12060,1999-2000,18,MVV Maastricht,PSV,0,2,2,0,3,2,-2,3.0,10.0
12061,1999-2000,18,Vitesse,FC Den Bosch,1,0,1,3,0,1,1,7.0,4.0
12062,1999-2000,18,De Graafschap,SC Cambuur,3,1,1,3,0,4,2,8.0,3.0
12063,1999-2000,18,Sparta Rotterdam,sc Heerenveen,2,1,1,3,0,3,1,7.0,12.0
12064,1999-2000,18,MVV Maastricht,Roda JC Kerkrade,0,0,3,1,1,0,0,4.0,4.0
12065,1999-2000,18,RKC Waalwijk,Willem II,1,0,1,3,0,1,1,6.0,4.0
12066,1999-2000,19,FC Twente,AZ Alkmaar,4,1,1,3,0,5,3,15.0,10.0
12067,1999-2000,19,Vitesse,De Graafschap,3,1,1,3,0,4,2,10.0,8.0
12068,1999-2000,19,SC Cambuur,NEC Nijmegen,0,0,3,1,1,0,0,4.0,9.0
12069,1999-2000,19,sc Heerenveen,AFC Ajax,1,1,3,1,1,2,0,10.0,5.0
12070,1999-2000,19,PSV,Feyenoord,0,1,2,0,3,1,-1,7.0,13.0
12071,1999-2000,19,FC Utrecht,MVV Maastricht,2,0,1,3,0,2,2,4.0,4.0
12072,1999-2000,19,NEC Nijmegen,De Graafschap,2,3,2,0,3,5,-1,8.0,8.0
12073,1999-2000,19,sc Heerenveen,AZ Alkmaar,3,0,1,3,0,3,3,10.0,7.0
12074,1999-2000,19,Sparta Rotterdam,Vitesse,1,1,3,1,1,2,0,8.0,11.0
12075,1999-2000,20,Willem II,FC Twente,1,1,3,1,1,2,0,5.0,13.0
12076,1999-2000,20,RKC Waalwijk,Fortuna Sittard,0,3,2,0,3,3,-3,6.0,5.0
12077,1999-2000,20,Feyenoord,Roda JC Kerkrade,2,1,1,3,0,3,1,13.0,1.0
12078,1999-2000,20,FC Den Bosch,PSV,2,6,2,0,3,8,-4,4.0,9.0
12079,1999-2000,20,AFC Ajax,SC Cambuur,3,1,1,3,0,4,2,5.0,4.0
12080,1999-2000,20,Fortuna Sittard,Feyenoord,2,3,2,0,3,5,-1,5.0,13.0
12081,1999-2000,20,AZ Alkmaar,Sparta Rotterdam,4,0,1,3,0,4,4,7.0,8.0
12082,1999-2000,20,MVV Maastricht,FC Den Bosch,2,0,1,3,0,2,2,4.0,3.0
12083,1999-2000,20,FC Twente,RKC Waalwijk,1,0,1,3,0,1,1,13.0,3.0
12084,1999-2000,21,Willem II,NEC Nijmegen,3,1,1,3,0,4,2,5.0,5.0
12085,1999-2000,21,Roda JC Kerkrade,FC Utrecht,3,2,1,3,0,5,1,4.0,4.0
12086,1999-2000,21,PSV,AFC Ajax,4,0,1,3,0,4,4,9.0,5.0
12087,1999-2000,21,SC Cambuur,Fortuna Sittard,0,0,3,1,1,0,0,2.0,5.0
12088,1999-2000,21,NEC Nijmegen,AZ Alkmaar,1,2,2,0,3,3,-1,2.0,7.0
12089,1999-2000,21,FC Den Bosch,FC Twente,0,0,3,1,1,0,0,1.0,11.0
12090,1999-2000,21,sc Heerenveen,PSV,0,3,2,0,3,3,-3,7.0,12.0
12091,1999-2000,21,Vitesse,Feyenoord,3,3,3,1,1,6,0,9.0,13.0
12092,1999-2000,21,De Graafschap,FC Utrecht,1,2,2,0,3,3,-1,7.0,7.0
12093,1999-2000,22,AFC Ajax,Willem II,3,1,1,3,0,4,2,8.0,5.0
12094,1999-2000,22,SC Cambuur,Sparta Rotterdam,0,1,2,0,3,1,-1,2.0,8.0
12095,1999-2000,22,Fortuna Sittard,FC Twente,2,2,3,1,1,4,0,6.0,9.0
12096,1999-2000,22,FC Den Bosch,Roda JC Kerkrade,2,2,3,1,1,4,0,2.0,5.0
12097,1999-2000,22,PSV,Vitesse,3,2,1,3,0,5,1,12.0,8.0
12098,1999-2000,22,MVV Maastricht,Sparta Rotterdam,2,2,3,1,1,4,0,5.0,8.0
12099,1999-2000,22,NEC Nijmegen,RKC Waalwijk,3,1,1,3,0,4,2,4.0,3.0
12100,1999-2000,22,FC Utrecht,sc Heerenveen,2,2,3,1,1,4,0,7.0,5.0
12101,1999-2000,22,AFC Ajax,De Graafschap,2,1,1,3,0,3,1,10.0,6.0
12102,1999-2000,23,Willem II,Feyenoord,2,1,1,3,0,3,1,7.0,10.0
12103,1999-2000,23,AZ Alkmaar,SC Cambuur,4,0,1,3,0,4,4,9.0,2.0
12104,1999-2000,23,Roda JC Kerkrade,PSV,1,2,2,0,3,3,-1,5.0,15.0
12105,1999-2000,23,Fortuna Sittard,Willem II,2,0,1,3,0,2,2,8.0,7.0
12106,1999-2000,23,Feyenoord,MVV Maastricht,3,0,1,3,0,3,3,10.0,5.0
12107,1999-2000,23,Sparta Rotterdam,NEC Nijmegen,1,0,1,3,0,1,1,8.0,3.0
12108,1999-2000,23,FC Twente,sc Heerenveen,2,0,1,3,0,2,2,9.0,5.0
12109,1999-2000,23,FC Utrecht,AZ Alkmaar,3,3,3,1,1,6,0,8.0,10.0
12110,1999-2000,23,RKC Waalwijk,Vitesse,1,1,3,1,1,2,0,4.0,6.0
12111,1999-2000,24,Roda JC Kerkrade,SC Cambuur,3,1,1,3,0,4,2,7.0,1.0
12112,1999-2000,24,Vitesse,Roda JC Kerkrade,2,0,1,3,0,2,2,6.0,7.0
12113,1999-2000,24,AZ Alkmaar,Willem II,2,2,3,1,1,4,0,11.0,7.0
12114,1999-2000,24,SC Cambuur,MVV Maastricht,2,2,3,1,1,4,0,2.0,5.0
12115,1999-2000,24,Sparta Rotterdam,RKC Waalwijk,3,1,1,3,0,4,2,10.0,1.0
12116,1999-2000,24,FC Twente,AFC Ajax,0,0,3,1,1,0,0,9.0,10.0
12117,1999-2000,24,sc Heerenveen,Feyenoord,3,0,1,3,0,3,3,7.0,7.0
12118,1999-2000,24,De Graafschap,FC Den Bosch,3,0,1,3,0,3,3,6.0,2.0
12119,1999-2000,24,NEC Nijmegen,FC Utrecht,0,1,2,0,3,1,-1,3.0,8.0
12120,1999-2000,25,NEC Nijmegen,Fortuna Sittard,1,2,2,0,3,3,-1,3.0,8.0
12121,1999-2000,25,AZ Alkmaar,RKC Waalwijk,4,0,1,3,0,4,4,11.0,1.0
12122,1999-2000,25,MVV Maastricht,De Graafschap,0,2,2,0,3,2,-2,5.0,9.0
12123,1999-2000,25,Willem II,sc Heerenveen,2,3,2,0,3,5,-1,4.0,7.0
12124,1999-2000,25,Feyenoord,FC Den Bosch,3,0,1,3,0,3,3,7.0,2.0
12125,1999-2000,25,FC Twente,SC Cambuur,1,0,1,3,0,1,1,9.0,1.0
12126,1999-2000,25,Roda JC Kerkrade,Sparta Rotterdam,4,1,1,3,0,5,3,7.0,10.0
12127,1999-2000,25,PSV,FC Utrecht,2,1,1,3,0,3,1,15.0,8.0
12128,1999-2000,25,Fortuna Sittard,AFC Ajax,2,0,1,3,0,2,2,11.0,7.0
12129,1999-2000,26,SC Cambuur,Feyenoord,2,3,2,0,3,5,-1,1.0,9.0
12130,1999-2000,26,NEC Nijmegen,Willem II,2,1,1,3,0,3,1,6.0,4.0
12131,1999-2000,26,PSV,De Graafschap,6,0,1,3,0,6,6,15.0,6.0
12132,1999-2000,26,sc Heerenveen,MVV Maastricht,3,1,1,3,0,4,2,10.0,2.0
12133,1999-2000,26,AFC Ajax,FC Twente,0,1,2,0,3,1,-1,7.0,11.0
12134,1999-2000,26,FC Utrecht,Vitesse,2,0,1,3,0,2,2,8.0,5.0
12135,1999-2000,26,RKC Waalwijk,Roda JC Kerkrade,2,2,3,1,1,4,0,2.0,7.0
12136,1999-2000,26,Sparta Rotterdam,Fortuna Sittard,2,3,2,0,3,5,-1,7.0,13.0
12137,1999-2000,26,AZ Alkmaar,FC Den Bosch,2,0,1,3,0,2,2,11.0,2.0
12138,1999-2000,27,Fortuna Sittard,MVV Maastricht,3,1,1,3,0,4,2,15.0,1.0
12139,1999-2000,27,Willem II,PSV,0,0,3,1,1,0,0,2.0,13.0
12140,1999-2000,27,Vitesse,sc Heerenveen,3,1,1,3,0,4,2,7.0,9.0
12141,1999-2000,27,SC Cambuur,Roda JC Kerkrade,2,2,3,1,1,4,0,2.0,8.0
12142,1999-2000,27,De Graafschap,RKC Waalwijk,2,0,1,3,0,2,2,9.0,2.0
12143,1999-2000,27,AFC Ajax,NEC Nijmegen,5,2,1,3,0,7,3,7.0,3.0
12144,1999-2000,27,FC Twente,FC Utrecht,4,2,1,3,0,6,2,13.0,7.0
12145,1999-2000,27,Feyenoord,Sparta Rotterdam,1,2,2,0,3,3,-1,9.0,9.0
12146,1999-2000,27,sc Heerenveen,NEC Nijmegen,1,0,1,3,0,1,1,12.0,3.0
12147,1999-2000,28,Roda JC Kerkrade,AFC Ajax,3,0,1,3,0,3,3,8.0,4.0
12148,1999-2000,28,FC Den Bosch,Willem II,1,1,3,1,1,2,0,2.0,3.0
12149,1999-2000,28,MVV Maastricht,Vitesse,0,2,2,0,3,2,-2,1.0,10.0
12150,1999-2000,28,PSV,AZ Alkmaar,5,1,1,3,0,6,4,13.0,8.0
12151,1999-2000,28,De Graafschap,Fortuna Sittard,1,0,1,3,0,1,1,12.0,12.0
12152,1999-2000,28,FC Utrecht,SC Cambuur,1,2,2,0,3,3,-1,6.0,5.0
12153,1999-2000,28,Sparta Rotterdam,FC Twente,1,1,3,1,1,2,0,7.0,11.0
12154,1999-2000,28,RKC Waalwijk,Feyenoord,2,2,3,1,1,4,0,2.0,7.0
12155,1999-2000,28,AZ Alkmaar,De Graafschap,2,0,1,3,0,2,2,10.0,9.0
12156,1999-2000,29,NEC Nijmegen,Roda JC Kerkrade,0,0,3,1,1,0,0,4.0,9.0
12157,1999-2000,29,Fortuna Sittard,PSV,0,4,2,0,3,4,-4,9.0,13.0
12158,1999-2000,29,FC Twente,MVV Maastricht,1,2,2,0,3,3,-1,10.0,3.0
12159,1999-2000,29,SC Cambuur,FC Den Bosch,1,2,2,0,3,3,-1,4.0,4.0
12160,1999-2000,29,Willem II,Vitesse,0,4,2,0,3,4,-4,2.0,12.0
12161,1999-2000,29,RKC Waalwijk,sc Heerenveen,0,1,2,0,3,1,-1,2.0,12.0
12162,1999-2000,29,Feyenoord,FC Utrecht,1,2,2,0,3,3,-1,7.0,6.0
12163,1999-2000,29,AFC Ajax,Sparta Rotterdam,3,2,1,3,0,5,1,6.0,4.0
12164,1999-2000,29,FC Utrecht,Sparta Rotterdam,3,1,1,3,0,4,2,9.0,4.0
12165,1999-2000,30,Vitesse,FC Twente,4,1,1,3,0,5,3,12.0,7.0
12166,1999-2000,30,Roda JC Kerkrade,Willem II,3,4,2,0,3,7,-1,6.0,5.0
12167,1999-2000,30,MVV Maastricht,RKC Waalwijk,0,1,2,0,3,1,-1,3.0,5.0
12168,1999-2000,30,sc Heerenveen,Fortuna Sittard,3,0,1,3,0,3,3,12.0,6.0
12169,1999-2000,30,De Graafschap,Feyenoord,0,1,2,0,3,1,-1,6.0,7.0
12170,1999-2000,30,FC Den Bosch,NEC Nijmegen,1,1,3,1,1,2,0,5.0,5.0
12171,1999-2000,30,AFC Ajax,AZ Alkmaar,4,1,1,3,0,5,3,9.0,9.0
12172,1999-2000,30,PSV,SC Cambuur,1,0,1,3,0,1,1,13.0,4.0
12173,1999-2000,30,FC Den Bosch,AFC Ajax,1,1,3,1,1,2,0,6.0,10.0
12174,1999-2000,31,FC Twente,PSV,1,3,2,0,3,4,-2,4.0,13.0
12175,1999-2000,31,Fortuna Sittard,FC Utrecht,3,0,1,3,0,3,3,6.0,6.0
12176,1999-2000,31,AZ Alkmaar,MVV Maastricht,2,0,1,3,0,2,2,9.0,3.0
12177,1999-2000,31,sc Heerenveen,Roda JC Kerkrade,5,1,1,3,0,6,4,12.0,5.0
12178,1999-2000,31,Willem II,De Graafschap,5,3,1,3,0,8,2,8.0,6.0
12179,1999-2000,31,Sparta Rotterdam,SC Cambuur,1,2,2,0,3,3,-1,4.0,7.0
12180,1999-2000,31,NEC Nijmegen,Vitesse,1,0,1,3,0,1,1,5.0,12.0
12181,1999-2000,31,Feyenoord,AFC Ajax,1,1,3,1,1,2,0,5.0,8.0
12182,1999-2000,31,RKC Waalwijk,FC Den Bosch,1,1,3,1,1,2,0,5.0,7.0
12183,1999-2000,32,Roda JC Kerkrade,FC Twente,3,2,1,3,0,5,1,7.0,1.0
12184,1999-2000,32,FC Den Bosch,Fortuna Sittard,0,2,2,0,3,2,-2,6.0,6.0
12185,1999-2000,32,FC Utrecht,Willem II,1,1,3,1,1,2,0,7.0,8.0
12186,1999-2000,32,MVV Maastricht,NEC Nijmegen,2,0,1,3,0,2,2,6.0,5.0
12187,1999-2000,32,Feyenoord,AZ Alkmaar,5,3,1,3,0,8,2,8.0,6.0
12188,1999-2000,32,SC Cambuur,sc Heerenveen,0,2,2,0,3,2,-2,6.0,15.0
12189,1999-2000,32,Vitesse,AFC Ajax,3,0,1,3,0,3,3,12.0,8.0
12190,1999-2000,32,PSV,RKC Waalwijk,7,1,1,3,0,8,6,15.0,5.0
12191,1999-2000,32,De Graafschap,Sparta Rotterdam,2,3,2,0,3,5,-1,3.0,4.0
12192,1999-2000,33,sc Heerenveen,FC Den Bosch,1,1,3,1,1,2,0,13.0,4.0
12193,1999-2000,33,FC Twente,De Graafschap,4,0,1,3,0,4,4,3.0,0.0
12194,1999-2000,33,Sparta Rotterdam,PSV,0,2,2,0,3,2,-2,3.0,15.0
12195,1999-2000,33,Willem II,SC Cambuur,1,4,2,0,3,5,-3,7.0,6.0
12196,1999-2000,33,Fortuna Sittard,Roda JC Kerkrade,1,2,2,0,3,3,-1,6.0,7.0
12197,1999-2000,33,AZ Alkmaar,Vitesse,0,1,2,0,3,1,-1,6.0,12.0
12198,1999-2000,33,AFC Ajax,MVV Maastricht,1,0,1,3,0,1,1,8.0,6.0
12199,1999-2000,33,RKC Waalwijk,FC Utrecht,2,0,1,3,0,2,2,7.0,7.0
12200,1999-2000,33,NEC Nijmegen,Feyenoord,0,2,2,0,3,2,-2,5.0,10.0
12201,1999-2000,34,MVV Maastricht,Willem II,1,1,3,1,1,2,0,4.0,8.0
12202,1999-2000,34,FC Utrecht,AFC Ajax,3,1,1,3,0,4,2,7.0,5.0
12203,1999-2000,34,Feyenoord,FC Twente,1,1,3,1,1,2,0,11.0,4.0
12204,1999-2000,34,PSV,NEC Nijmegen,2,0,1,3,0,2,2,15.0,4.0
12205,1999-2000,34,De Graafschap,sc Heerenveen,1,1,3,1,1,2,0,1.0,11.0
12206,1999-2000,34,SC Cambuur,RKC Waalwijk,2,1,1,3,0,3,1,9.0,7.0
12207,1999-2000,34,FC Den Bosch,Sparta Rotterdam,7,0,1,3,0,7,7,6.0,3.0
12208,1999-2000,34,Vitesse,Fortuna Sittard,2,2,3,1,1,4,0,10.0,7.0
12209,1999-2000,34,Roda JC Kerkrade,AZ Alkmaar,3,2,1,3,0,5,1,9.0,3.0
12210,2000-2001,1,Sparta Rotterdam,Roda JC Kerkrade,2,2,3,1,1,4,0,4.0,10.0
12211,2000-2001,1,Feyenoord,AZ Alkmaar,2,0,1,3,0,2,2,11.0,3.0
12212,2000-2001,1,NAC Breda,RKC Waalwijk,0,1,2,0,3,1,-1,6.0,7.0
12213,2000-2001,1,De Graafschap,PSV,2,0,1,3,0,2,2,4.0,12.0
12214,2000-2001,1,FC Groningen,Willem II,1,1,3,1,1,2,0,4.0,6.0
12215,2000-2001,1,RBC Roosendaal,NEC Nijmegen,2,3,2,0,3,5,-1,,6.0
12216,2000-2001,1,Vitesse,FC Twente,3,1,1,3,0,4,2,10.0,4.0
12217,2000-2001,1,FC Utrecht,sc Heerenveen,2,0,1,3,0,2,2,7.0,8.0
12218,2000-2001,1,AFC Ajax,Fortuna Sittard,5,0,1,3,0,5,5,7.0,7.0
12219,2000-2001,2,FC Groningen,NEC Nijmegen,4,4,3,1,1,8,0,5.0,4.0
12220,2000-2001,2,Willem II,RKC Waalwijk,2,0,1,3,0,2,2,6.0,6.0
12221,2000-2001,2,AZ Alkmaar,RBC Roosendaal,3,0,1,3,0,3,3,3.0,
12222,2000-2001,2,De Graafschap,Roda JC Kerkrade,1,3,2,0,3,4,-2,4.0,13.0
12223,2000-2001,2,NAC Breda,FC Groningen,5,1,1,3,0,6,4,8.0,5.0
12224,2000-2001,2,Fortuna Sittard,sc Heerenveen,0,2,2,0,3,2,-2,4.0,8.0
12225,2000-2001,2,NEC Nijmegen,Vitesse,4,1,1,3,0,5,3,7.0,10.0
12226,2000-2001,2,FC Utrecht,PSV,1,3,2,0,3,4,-2,7.0,12.0
12227,2000-2001,2,FC Twente,Feyenoord,1,2,2,0,3,3,-1,4.0,13.0
12228,2000-2001,3,Sparta Rotterdam,AFC Ajax,3,0,1,3,0,3,3,7.0,6.0
12229,2000-2001,3,RKC Waalwijk,RBC Roosendaal,2,1,1,3,0,3,1,9.0,
12230,2000-2001,3,PSV,Willem II,2,2,3,1,1,4,0,10.0,6.0
12231,2000-2001,3,FC Twente,sc Heerenveen,2,2,3,1,1,4,0,5.0,6.0
12232,2000-2001,3,NAC Breda,Roda JC Kerkrade,1,1,3,1,1,2,0,6.0,11.0
12233,2000-2001,3,RKC Waalwijk,AZ Alkmaar,3,0,1,3,0,3,3,9.0,3.0
12234,2000-2001,3,FC Groningen,De Graafschap,1,0,1,3,0,1,1,8.0,4.0
12235,2000-2001,3,Vitesse,Sparta Rotterdam,5,1,1,3,0,6,4,10.0,4.0
12236,2000-2001,3,RBC Roosendaal,NAC Breda,0,1,2,0,3,1,-1,,8.0
12237,2000-2001,4,AFC Ajax,NEC Nijmegen,0,0,3,1,1,0,0,7.0,8.0
12238,2000-2001,4,Fortuna Sittard,PSV,0,3,2,0,3,3,-3,1.0,10.0
12239,2000-2001,4,De Graafschap,AZ Alkmaar,4,2,1,3,0,6,2,7.0,3.0
12240,2000-2001,4,Roda JC Kerkrade,FC Twente,2,2,3,1,1,4,0,9.0,3.0
12241,2000-2001,4,Feyenoord,RKC Waalwijk,3,1,1,3,0,4,2,13.0,9.0
12242,2000-2001,4,Willem II,Vitesse,2,2,3,1,1,4,0,7.0,8.0
12243,2000-2001,4,sc Heerenveen,NAC Breda,2,1,1,3,0,3,1,8.0,7.0
12244,2000-2001,4,NEC Nijmegen,FC Utrecht,1,1,3,1,1,2,0,9.0,7.0
12245,2000-2001,4,Sparta Rotterdam,RBC Roosendaal,3,5,2,0,3,8,-2,4.0,3.0
12246,2000-2001,5,AFC Ajax,FC Groningen,3,1,1,3,0,4,2,7.0,5.0
12247,2000-2001,5,PSV,Sparta Rotterdam,2,1,1,3,0,3,1,10.0,4.0
12248,2000-2001,5,NAC Breda,De Graafschap,3,0,1,3,0,3,3,10.0,6.0
12249,2000-2001,5,FC Utrecht,FC Twente,1,2,2,0,3,3,-1,7.0,5.0
12250,2000-2001,5,Vitesse,RKC Waalwijk,1,0,1,3,0,1,1,10.0,6.0
12251,2000-2001,5,NEC Nijmegen,Fortuna Sittard,1,1,3,1,1,2,0,7.0,2.0
12252,2000-2001,5,AZ Alkmaar,AFC Ajax,3,2,1,3,0,5,1,6.0,7.0
12253,2000-2001,5,RBC Roosendaal,FC Groningen,0,2,2,0,3,2,-2,3.0,7.0
12254,2000-2001,5,AFC Ajax,RBC Roosendaal,2,0,1,3,0,2,2,7.0,3.0
12255,2000-2001,6,Fortuna Sittard,Vitesse,1,4,2,0,3,5,-3,1.0,10.0
12256,2000-2001,6,RKC Waalwijk,NEC Nijmegen,0,0,3,1,1,0,0,7.0,7.0
12257,2000-2001,6,FC Twente,De Graafschap,3,1,1,3,0,4,2,8.0,3.0
12258,2000-2001,6,NAC Breda,Willem II,2,0,1,3,0,2,2,10.0,6.0
12259,2000-2001,6,FC Groningen,FC Utrecht,1,3,2,0,3,4,-2,6.0,7.0
12260,2000-2001,6,De Graafschap,Feyenoord,2,3,2,0,3,5,-1,3.0,13.0
12261,2000-2001,6,FC Groningen,PSV,0,1,2,0,3,1,-1,6.0,13.0
12262,2000-2001,6,Sparta Rotterdam,Willem II,1,2,2,0,3,3,-1,3.0,8.0
12263,2000-2001,6,FC Twente,Fortuna Sittard,1,1,3,1,1,2,0,9.0,2.0
12264,2000-2001,7,Vitesse,FC Utrecht,2,1,1,3,0,3,1,13.0,4.0
12265,2000-2001,7,Roda JC Kerkrade,AZ Alkmaar,4,2,1,3,0,6,2,9.0,6.0
12266,2000-2001,7,sc Heerenveen,AFC Ajax,2,2,3,1,1,4,0,8.0,8.0
12267,2000-2001,7,AZ Alkmaar,NAC Breda,3,1,1,3,0,4,2,6.0,9.0
12268,2000-2001,7,Willem II,FC Utrecht,6,2,1,3,0,8,4,8.0,4.0
12269,2000-2001,7,sc Heerenveen,RKC Waalwijk,1,1,3,1,1,2,0,9.0,5.0
12270,2000-2001,7,Roda JC Kerkrade,FC Groningen,2,0,1,3,0,2,2,11.0,3.0
12271,2000-2001,7,PSV,NEC Nijmegen,0,0,3,1,1,0,0,11.0,5.0
12272,2000-2001,7,Vitesse,AFC Ajax,3,2,1,3,0,5,1,13.0,7.0
12273,2000-2001,8,RBC Roosendaal,De Graafschap,2,4,2,0,3,6,-2,3.0,6.0
12274,2000-2001,8,AFC Ajax,Roda JC Kerkrade,4,2,1,3,0,6,2,7.0,8.0
12275,2000-2001,8,FC Twente,Sparta Rotterdam,3,1,1,3,0,4,2,11.0,0.0
12276,2000-2001,8,Feyenoord,sc Heerenveen,2,0,1,3,0,2,2,15.0,6.0
12277,2000-2001,8,De Graafschap,Willem II,1,1,3,1,1,2,0,4.0,8.0
12278,2000-2001,8,FC Utrecht,RBC Roosendaal,5,3,1,3,0,8,2,6.0,3.0
12279,2000-2001,8,AZ Alkmaar,Vitesse,0,2,2,0,3,2,-2,6.0,15.0
12280,2000-2001,8,Feyenoord,Sparta Rotterdam,2,1,1,3,0,3,1,15.0,0.0
12281,2000-2001,8,RKC Waalwijk,PSV,1,1,3,1,1,2,0,3.0,11.0
12282,2000-2001,9,FC Groningen,Fortuna Sittard,4,0,1,3,0,4,4,6.0,2.0
12283,2000-2001,9,AZ Alkmaar,FC Twente,5,0,1,3,0,5,5,9.0,10.0
12284,2000-2001,9,Fortuna Sittard,NAC Breda,1,2,2,0,3,3,-1,2.0,9.0
12285,2000-2001,9,sc Heerenveen,De Graafschap,1,0,1,3,0,1,1,8.0,4.0
12286,2000-2001,9,FC Utrecht,Feyenoord,1,1,3,1,1,2,0,7.0,13.0
12287,2000-2001,9,Sparta Rotterdam,FC Groningen,2,0,1,3,0,2,2,3.0,3.0
12288,2000-2001,9,Roda JC Kerkrade,RKC Waalwijk,0,1,2,0,3,1,-1,7.0,6.0
12289,2000-2001,9,PSV,AFC Ajax,1,1,3,1,1,2,0,9.0,8.0
12290,2000-2001,9,NEC Nijmegen,Willem II,3,0,1,3,0,3,3,7.0,7.0
12291,2000-2001,10,RKC Waalwijk,FC Utrecht,4,1,1,3,0,5,3,9.0,4.0
12292,2000-2001,10,sc Heerenveen,Sparta Rotterdam,1,1,3,1,1,2,0,6.0,4.0
12293,2000-2001,10,Roda JC Kerkrade,Fortuna Sittard,1,0,1,3,0,1,1,9.0,1.0
12294,2000-2001,10,PSV,Vitesse,2,0,1,3,0,2,2,9.0,12.0
12295,2000-2001,10,NEC Nijmegen,De Graafschap,2,1,1,3,0,3,1,9.0,4.0
12296,2000-2001,10,Feyenoord,RBC Roosendaal,5,1,1,3,0,6,4,13.0,0.0
12297,2000-2001,10,FC Twente,PSV,0,2,2,0,3,2,-2,7.0,9.0
12298,2000-2001,10,NAC Breda,NEC Nijmegen,2,2,3,1,1,4,0,10.0,9.0
12299,2000-2001,10,FC Utrecht,Sparta Rotterdam,1,1,3,1,1,2,0,5.0,5.0
12300,2000-2001,11,RBC Roosendaal,Fortuna Sittard,3,1,1,3,0,4,2,3.0,1.0
12301,2000-2001,11,De Graafschap,Vitesse,1,2,2,0,3,3,-1,4.0,12.0
12302,2000-2001,11,FC Groningen,AZ Alkmaar,1,2,2,0,3,3,-1,3.0,9.0
12303,2000-2001,11,Feyenoord,Roda JC Kerkrade,4,2,1,3,0,6,2,13.0,6.0
12304,2000-2001,11,Willem II,AFC Ajax,0,1,2,0,3,1,-1,7.0,8.0
12305,2000-2001,11,RBC Roosendaal,Willem II,2,1,1,3,0,3,1,6.0,4.0
12306,2000-2001,11,Fortuna Sittard,RKC Waalwijk,0,0,3,1,1,0,0,1.0,9.0
12307,2000-2001,11,PSV,Feyenoord,1,0,1,3,0,1,1,11.0,10.0
12308,2000-2001,11,AZ Alkmaar,FC Utrecht,2,1,1,3,0,3,1,12.0,5.0
12309,2000-2001,12,FC Twente,NAC Breda,4,0,1,3,0,4,4,7.0,7.0
12310,2000-2001,12,Roda JC Kerkrade,sc Heerenveen,3,1,1,3,0,4,2,6.0,5.0
12311,2000-2001,12,Vitesse,FC Groningen,2,2,3,1,1,4,0,10.0,4.0
12312,2000-2001,12,AFC Ajax,De Graafschap,4,1,1,3,0,5,3,10.0,1.0
12313,2000-2001,12,Sparta Rotterdam,NEC Nijmegen,0,2,2,0,3,2,-2,5.0,11.0
12314,2000-2001,12,Roda JC Kerkrade,FC Utrecht,2,1,1,3,0,3,1,9.0,2.0
12315,2000-2001,12,Fortuna Sittard,AZ Alkmaar,1,1,3,1,1,2,0,2.0,10.0
12316,2000-2001,12,Vitesse,RBC Roosendaal,2,1,1,3,0,3,1,10.0,6.0
12317,2000-2001,12,sc Heerenveen,PSV,1,4,2,0,3,5,-3,4.0,13.0
12318,2000-2001,13,Willem II,FC Twente,2,2,3,1,1,4,0,2.0,7.0
12319,2000-2001,13,RKC Waalwijk,De Graafschap,1,0,1,3,0,1,1,11.0,0.0
12320,2000-2001,13,NAC Breda,AFC Ajax,0,3,2,0,3,3,-3,4.0,13.0
12321,2000-2001,13,NEC Nijmegen,Feyenoord,1,3,2,0,3,4,-2,10.0,10.0
12322,2000-2001,13,De Graafschap,Fortuna Sittard,5,1,1,3,0,6,4,3.0,2.0
12323,2000-2001,13,RBC Roosendaal,Roda JC Kerkrade,0,4,2,0,3,4,-4,6.0,12.0
12324,2000-2001,13,AZ Alkmaar,Sparta Rotterdam,1,1,3,1,1,2,0,11.0,6.0
12325,2000-2001,13,PSV,NAC Breda,2,1,1,3,0,3,1,15.0,4.0
12326,2000-2001,13,FC Twente,FC Groningen,3,0,1,3,0,3,3,7.0,4.0
12327,2000-2001,14,NAC Breda,RBC Roosendaal,2,1,1,3,0,3,1,4.0,6.0
12328,2000-2001,14,Sparta Rotterdam,Feyenoord,1,4,2,0,3,5,-3,3.0,12.0
12329,2000-2001,14,Feyenoord,Willem II,1,0,1,3,0,1,1,12.0,1.0
12330,2000-2001,14,NEC Nijmegen,sc Heerenveen,0,0,3,1,1,0,0,8.0,5.0
12331,2000-2001,14,FC Utrecht,AFC Ajax,2,1,1,3,0,3,1,4.0,10.0
12332,2000-2001,14,Roda JC Kerkrade,Vitesse,2,3,2,0,3,5,-1,9.0,10.0
12333,2000-2001,14,sc Heerenveen,AZ Alkmaar,1,1,3,1,1,2,0,3.0,9.0
12334,2000-2001,14,AFC Ajax,RKC Waalwijk,3,0,1,3,0,3,3,12.0,10.0
12335,2000-2001,14,Roda JC Kerkrade,PSV,1,2,2,0,3,3,-1,9.0,15.0
12336,2000-2001,15,RKC Waalwijk,FC Twente,1,1,3,1,1,2,0,8.0,8.0
12337,2000-2001,15,Fortuna Sittard,FC Utrecht,0,1,2,0,3,1,-1,2.0,7.0
12338,2000-2001,15,Willem II,AZ Alkmaar,1,1,3,1,1,2,0,2.0,7.0
12339,2000-2001,15,Sparta Rotterdam,De Graafschap,2,1,1,3,0,3,1,5.0,3.0
12340,2000-2001,15,AFC Ajax,sc Heerenveen,6,2,1,3,0,8,4,12.0,2.0
12341,2000-2001,15,RKC Waalwijk,FC Groningen,0,0,3,1,1,0,0,6.0,2.0
12342,2000-2001,15,NEC Nijmegen,FC Twente,1,0,1,3,0,1,1,8.0,8.0
12343,2000-2001,15,Roda JC Kerkrade,Willem II,0,1,2,0,3,1,-1,6.0,5.0
12344,2000-2001,15,Feyenoord,NAC Breda,2,0,1,3,0,2,2,12.0,3.0
12345,2000-2001,16,Fortuna Sittard,Sparta Rotterdam,2,1,1,3,0,3,1,5.0,4.0
12346,2000-2001,16,De Graafschap,FC Groningen,0,4,2,0,3,4,-4,3.0,5.0
12347,2000-2001,16,AZ Alkmaar,NEC Nijmegen,0,0,3,1,1,0,0,5.0,8.0
12348,2000-2001,16,FC Utrecht,NAC Breda,5,0,1,3,0,5,5,9.0,3.0
12349,2000-2001,16,Vitesse,sc Heerenveen,0,0,3,1,1,0,0,11.0,3.0
12350,2000-2001,16,Feyenoord,AFC Ajax,3,1,1,3,0,4,2,15.0,9.0
12351,2000-2001,16,FC Twente,Roda JC Kerkrade,0,2,2,0,3,2,-2,5.0,6.0
12352,2000-2001,16,sc Heerenveen,Willem II,0,1,2,0,3,1,-1,3.0,8.0
12353,2000-2001,16,PSV,RBC Roosendaal,6,0,1,3,0,6,6,15.0,3.0
12354,2000-2001,17,Sparta Rotterdam,NAC Breda,1,2,2,0,3,3,-1,4.0,6.0
12355,2000-2001,17,Vitesse,AZ Alkmaar,3,2,1,3,0,5,1,11.0,4.0
12356,2000-2001,17,Fortuna Sittard,Feyenoord,2,4,2,0,3,6,-2,4.0,15.0
12357,2000-2001,17,NAC Breda,Vitesse,1,1,3,1,1,2,0,7.0,11.0
12358,2000-2001,17,Willem II,Fortuna Sittard,3,1,1,3,0,4,2,10.0,3.0
12359,2000-2001,17,De Graafschap,FC Utrecht,0,3,2,0,3,3,-3,3.0,12.0
12360,2000-2001,17,FC Groningen,Feyenoord,1,0,1,3,0,1,1,8.0,12.0
12361,2000-2001,17,RBC Roosendaal,sc Heerenveen,0,3,2,0,3,3,-3,0.0,5.0
12362,2000-2001,17,RKC Waalwijk,Sparta Rotterdam,2,0,1,3,0,2,2,8.0,3.0
12363,2000-2001,18,AZ Alkmaar,PSV,0,5,2,0,3,5,-5,3.0,15.0
12364,2000-2001,18,AFC Ajax,FC Twente,5,1,1,3,0,6,4,9.0,4.0
12365,2000-2001,18,NEC Nijmegen,Roda JC Kerkrade,0,2,2,0,3,2,-2,5.0,6.0
12366,2000-2001,18,Feyenoord,Vitesse,2,0,1,3,0,2,2,12.0,8.0
12367,2000-2001,18,FC Utrecht,RKC Waalwijk,2,1,1,3,0,3,1,15.0,5.0
12368,2000-2001,18,Willem II,NEC Nijmegen,2,0,1,3,0,2,2,13.0,5.0
12369,2000-2001,18,FC Groningen,sc Heerenveen,2,1,1,3,0,3,1,10.0,4.0
12370,2000-2001,18,PSV,Fortuna Sittard,1,1,3,1,1,2,0,13.0,4.0
12371,2000-2001,18,RBC Roosendaal,FC Twente,2,2,3,1,1,4,0,1.0,2.0
12372,2000-2001,19,sc Heerenveen,Feyenoord,1,0,1,3,0,1,1,7.0,9.0
12373,2000-2001,19,Fortuna Sittard,Roda JC Kerkrade,1,0,1,3,0,1,1,7.0,6.0
12374,2000-2001,19,PSV,FC Groningen,3,0,1,3,0,3,3,13.0,10.0
12375,2000-2001,19,Vitesse,NAC Breda,2,4,2,0,3,6,-2,5.0,7.0
12376,2000-2001,19,NEC Nijmegen,RBC Roosendaal,2,3,2,0,3,5,-1,4.0,4.0
12377,2000-2001,19,Willem II,Sparta Rotterdam,4,1,1,3,0,5,3,15.0,3.0
12378,2000-2001,19,De Graafschap,AFC Ajax,1,3,2,0,3,4,-2,3.0,12.0
12379,2000-2001,19,RBC Roosendaal,RKC Waalwijk,0,3,2,0,3,3,-3,4.0,8.0
12380,2000-2001,19,Roda JC Kerkrade,NAC Breda,1,0,1,3,0,1,1,9.0,7.0
12381,2000-2001,20,Fortuna Sittard,De Graafschap,0,0,3,1,1,0,0,5.0,1.0
12382,2000-2001,20,AZ Alkmaar,Feyenoord,0,3,2,0,3,3,-3,2.0,9.0
12383,2000-2001,20,FC Twente,Willem II,3,1,1,3,0,4,2,4.0,12.0
12384,2000-2001,20,Sparta Rotterdam,PSV,0,1,2,0,3,1,-1,0.0,13.0
12385,2000-2001,20,Vitesse,NEC Nijmegen,2,2,3,1,1,4,0,5.0,2.0
12386,2000-2001,20,Roda JC Kerkrade,RBC Roosendaal,2,1,1,3,0,3,1,12.0,4.0
12387,2000-2001,20,De Graafschap,sc Heerenveen,0,1,2,0,3,1,-1,1.0,9.0
12388,2000-2001,20,FC Groningen,AFC Ajax,3,3,3,1,1,6,0,10.0,10.0
12389,2000-2001,20,sc Heerenveen,FC Utrecht,1,2,2,0,3,3,-1,9.0,15.0
12390,2000-2001,21,PSV,AZ Alkmaar,3,0,1,3,0,3,3,13.0,1.0
12391,2000-2001,21,FC Utrecht,NEC Nijmegen,1,1,3,1,1,2,0,13.0,2.0
12392,2000-2001,21,Feyenoord,FC Groningen,1,0,1,3,0,1,1,9.0,7.0
12393,2000-2001,21,AFC Ajax,Willem II,1,1,3,1,1,2,0,8.0,10.0
12394,2000-2001,21,RKC Waalwijk,Vitesse,3,0,1,3,0,3,3,10.0,2.0
12395,2000-2001,21,Fortuna Sittard,AFC Ajax,0,3,2,0,3,3,-3,5.0,11.0
12396,2000-2001,21,RBC Roosendaal,AZ Alkmaar,2,3,2,0,3,5,-1,4.0,3.0
12397,2000-2001,21,NAC Breda,PSV,1,2,2,0,3,3,-1,7.0,13.0
12398,2000-2001,21,NAC Breda,FC Twente,0,0,3,1,1,0,0,5.0,5.0
12399,2000-2001,22,FC Groningen,FC Twente,2,0,1,3,0,2,2,7.0,5.0
12400,2000-2001,22,Sparta Rotterdam,RKC Waalwijk,2,2,3,1,1,4,0,1.0,10.0
12401,2000-2001,22,FC Utrecht,De Graafschap,3,1,1,3,0,4,2,13.0,1.0
12402,2000-2001,22,NEC Nijmegen,Sparta Rotterdam,0,3,2,0,3,3,-3,2.0,4.0
12403,2000-2001,22,Willem II,sc Heerenveen,1,6,2,0,3,7,-5,7.0,9.0
12404,2000-2001,22,AZ Alkmaar,Roda JC Kerkrade,2,4,2,0,3,6,-2,3.0,12.0
12405,2000-2001,22,FC Twente,Vitesse,2,1,1,3,0,3,1,8.0,1.0
12406,2000-2001,22,RKC Waalwijk,Fortuna Sittard,1,0,1,3,0,1,1,10.0,5.0
12407,2000-2001,22,Feyenoord,PSV,1,2,2,0,3,3,-1,9.0,15.0
12408,2000-2001,23,AFC Ajax,FC Utrecht,2,0,1,3,0,2,2,11.0,10.0
12409,2000-2001,23,FC Groningen,NAC Breda,0,0,3,1,1,0,0,5.0,5.0
12410,2000-2001,23,RKC Waalwijk,NAC Breda,0,0,3,1,1,0,0,11.0,3.0
12411,2000-2001,23,sc Heerenveen,FC Groningen,0,0,3,1,1,0,0,10.0,6.0
12412,2000-2001,23,Willem II,De Graafschap,6,0,1,3,0,6,6,7.0,1.0
12413,2000-2001,23,PSV,Roda JC Kerkrade,0,0,3,1,1,0,0,13.0,10.0
12414,2000-2001,23,NEC Nijmegen,AZ Alkmaar,1,1,3,1,1,2,0,3.0,4.0
12415,2000-2001,23,Vitesse,Feyenoord,0,0,3,1,1,0,0,2.0,7.0
12416,2000-2001,23,Sparta Rotterdam,FC Twente,5,1,1,3,0,6,4,7.0,7.0
12417,2000-2001,24,De Graafschap,Sparta Rotterdam,2,1,1,3,0,3,1,4.0,7.0
12418,2000-2001,24,sc Heerenveen,Roda JC Kerkrade,0,0,3,1,1,0,0,8.0,11.0
12419,2000-2001,24,FC Utrecht,Fortuna Sittard,1,0,1,3,0,1,1,10.0,4.0
12420,2000-2001,24,RBC Roosendaal,AFC Ajax,1,3,2,0,3,4,-2,3.0,11.0
12421,2000-2001,24,Fortuna Sittard,RBC Roosendaal,2,1,1,3,0,3,1,4.0,0.0
12422,2000-2001,24,AZ Alkmaar,RKC Waalwijk,1,3,2,0,3,4,-2,4.0,11.0
12423,2000-2001,24,FC Twente,NEC Nijmegen,1,1,3,1,1,2,0,5.0,4.0
12424,2000-2001,24,Willem II,Feyenoord,3,1,1,3,0,4,2,7.0,7.0
12425,2000-2001,24,FC Utrecht,Vitesse,0,0,3,1,1,0,0,8.0,3.0
12426,2000-2001,25,RBC Roosendaal,Vitesse,0,3,2,0,3,3,-3,0.0,5.0
12427,2000-2001,25,AZ Alkmaar,Fortuna Sittard,0,2,2,0,3,2,-2,4.0,6.0
12428,2000-2001,25,NAC Breda,sc Heerenveen,2,2,3,1,1,4,0,4.0,6.0
12429,2000-2001,25,Roda JC Kerkrade,De Graafschap,3,1,1,3,0,4,2,11.0,3.0
12430,2000-2001,25,NEC Nijmegen,FC Groningen,1,0,1,3,0,1,1,6.0,5.0
12431,2000-2001,25,RKC Waalwijk,Willem II,3,2,1,3,0,5,1,11.0,7.0
12432,2000-2001,25,AFC Ajax,Sparta Rotterdam,9,0,1,3,0,9,9,13.0,7.0
12433,2000-2001,25,Feyenoord,FC Twente,5,1,1,3,0,6,4,7.0,4.0
12434,2000-2001,25,PSV,FC Utrecht,5,1,1,3,0,6,4,13.0,7.0
12435,2000-2001,26,NAC Breda,Fortuna Sittard,1,0,1,3,0,1,1,7.0,6.0
12436,2000-2001,26,PSV,FC Twente,2,1,1,3,0,3,1,13.0,4.0
12437,2000-2001,26,sc Heerenveen,RBC Roosendaal,2,0,1,3,0,2,2,9.0,0.0
12438,2000-2001,26,Willem II,Roda JC Kerkrade,1,1,3,1,1,2,0,7.0,9.0
12439,2000-2001,26,AZ Alkmaar,De Graafschap,0,1,2,0,3,1,-1,1.0,6.0
12440,2000-2001,26,NEC Nijmegen,AFC Ajax,1,0,1,3,0,1,1,8.0,12.0
12441,2000-2001,26,RKC Waalwijk,Feyenoord,2,0,1,3,0,2,2,13.0,4.0
12442,2000-2001,26,Sparta Rotterdam,FC Utrecht,0,1,2,0,3,1,-1,6.0,7.0
12443,2000-2001,26,FC Groningen,Vitesse,0,1,2,0,3,1,-1,5.0,8.0
12444,2000-2001,27,FC Utrecht,AZ Alkmaar,1,0,1,3,0,1,1,10.0,1.0
12445,2000-2001,27,sc Heerenveen,NEC Nijmegen,5,0,1,3,0,5,5,9.0,8.0
12446,2000-2001,27,Vitesse,Willem II,1,2,2,0,3,3,-1,8.0,10.0
12447,2000-2001,27,FC Twente,RKC Waalwijk,1,1,3,1,1,2,0,2.0,11.0
12448,2000-2001,27,De Graafschap,RBC Roosendaal,2,2,3,1,1,4,0,7.0,1.0
12449,2000-2001,27,FC Groningen,Roda JC Kerkrade,1,3,2,0,3,4,-2,2.0,9.0
12450,2000-2001,27,Sparta Rotterdam,Fortuna Sittard,0,2,2,0,3,2,-2,3.0,9.0
12451,2000-2001,27,NAC Breda,Feyenoord,1,0,1,3,0,1,1,9.0,4.0
12452,2000-2001,27,AFC Ajax,PSV,0,1,2,0,3,1,-1,9.0,13.0
12453,2000-2001,28,Fortuna Sittard,NEC Nijmegen,2,0,1,3,0,2,2,12.0,7.0
12454,2000-2001,28,RKC Waalwijk,sc Heerenveen,1,1,3,1,1,2,0,11.0,9.0
12455,2000-2001,28,AZ Alkmaar,FC Groningen,2,0,1,3,0,2,2,3.0,1.0
12456,2000-2001,28,RBC Roosendaal,Sparta Rotterdam,1,3,2,0,3,4,-2,1.0,3.0
12457,2000-2001,28,Feyenoord,De Graafschap,1,2,2,0,3,3,-1,3.0,10.0
12458,2000-2001,28,Vitesse,PSV,0,0,3,1,1,0,0,8.0,11.0
12459,2000-2001,28,FC Twente,FC Utrecht,0,0,3,1,1,0,0,3.0,8.0
12460,2000-2001,28,Roda JC Kerkrade,AFC Ajax,1,1,3,1,1,2,0,9.0,7.0
12461,2000-2001,28,Willem II,NAC Breda,1,3,2,0,3,4,-2,7.0,11.0
12462,2000-2001,29,FC Utrecht,Willem II,1,0,1,3,0,1,1,10.0,4.0
12463,2000-2001,29,PSV,RKC Waalwijk,3,1,1,3,0,4,2,13.0,8.0
12464,2000-2001,29,NAC Breda,AZ Alkmaar,0,0,3,1,1,0,0,11.0,4.0
12465,2000-2001,29,FC Groningen,RBC Roosendaal,2,0,1,3,0,2,2,3.0,1.0
12466,2000-2001,29,Feyenoord,NEC Nijmegen,3,0,1,3,0,3,3,6.0,6.0
12467,2000-2001,29,De Graafschap,FC Twente,4,0,1,3,0,4,4,10.0,2.0
12468,2000-2001,29,sc Heerenveen,Fortuna Sittard,6,1,1,3,0,7,5,11.0,9.0
12469,2000-2001,29,Roda JC Kerkrade,Sparta Rotterdam,1,0,1,3,0,1,1,11.0,3.0
12470,2000-2001,29,AFC Ajax,Vitesse,1,2,2,0,3,3,-1,4.0,10.0
12471,2000-2001,30,AFC Ajax,NAC Breda,1,0,1,3,0,1,1,4.0,10.0
12472,2000-2001,30,Fortuna Sittard,FC Groningen,1,1,3,1,1,2,0,7.0,4.0
12473,2000-2001,30,Sparta Rotterdam,sc Heerenveen,1,3,2,0,3,4,-2,3.0,13.0
12474,2000-2001,30,Vitesse,De Graafschap,2,1,1,3,0,3,1,10.0,10.0
12475,2000-2001,30,Willem II,PSV,1,1,3,1,1,2,0,5.0,11.0
12476,2000-2001,30,FC Twente,AZ Alkmaar,1,0,1,3,0,1,1,5.0,4.0
12477,2000-2001,30,NEC Nijmegen,RKC Waalwijk,5,1,1,3,0,6,4,6.0,5.0
12478,2000-2001,30,Roda JC Kerkrade,Feyenoord,1,0,1,3,0,1,1,11.0,3.0
12479,2000-2001,30,RBC Roosendaal,FC Utrecht,1,2,2,0,3,3,-1,1.0,13.0
12480,2000-2001,31,RKC Waalwijk,AFC Ajax,2,2,3,1,1,4,0,3.0,5.0
12481,2000-2001,31,PSV,sc Heerenveen,3,0,1,3,0,3,3,11.0,10.0
12482,2000-2001,31,Vitesse,Roda JC Kerkrade,1,1,3,1,1,2,0,8.0,11.0
12483,2000-2001,31,FC Twente,RBC Roosendaal,4,1,1,3,0,5,3,8.0,1.0
12484,2000-2001,31,AZ Alkmaar,Willem II,2,3,2,0,3,5,-1,4.0,7.0
12485,2000-2001,31,NAC Breda,FC Utrecht,0,0,3,1,1,0,0,8.0,11.0
12486,2000-2001,31,Feyenoord,Fortuna Sittard,2,3,2,0,3,5,-1,3.0,10.0
12487,2000-2001,31,De Graafschap,NEC Nijmegen,2,1,1,3,0,3,1,10.0,3.0
12488,2000-2001,31,FC Groningen,Sparta Rotterdam,1,1,3,1,1,2,0,5.0,4.0
12489,2000-2001,32,Fortuna Sittard,FC Twente,0,2,2,0,3,2,-2,7.0,10.0
12490,2000-2001,32,RBC Roosendaal,PSV,1,2,2,0,3,3,-1,0.0,11.0
12491,2000-2001,32,sc Heerenveen,Vitesse,0,0,3,1,1,0,0,8.0,9.0
12492,2000-2001,32,Willem II,FC Groningen,3,0,1,3,0,3,3,7.0,5.0
12493,2000-2001,32,De Graafschap,RKC Waalwijk,0,1,2,0,3,1,-1,9.0,5.0
12494,2000-2001,32,FC Utrecht,Roda JC Kerkrade,3,0,1,3,0,3,3,11.0,8.0
12495,2000-2001,32,NEC Nijmegen,NAC Breda,0,2,2,0,3,2,-2,3.0,8.0
12496,2000-2001,32,AFC Ajax,Feyenoord,3,4,2,0,3,7,-1,5.0,6.0
12497,2000-2001,32,Sparta Rotterdam,AZ Alkmaar,0,3,2,0,3,3,-3,4.0,7.0
12498,2000-2001,33,PSV,De Graafschap,3,2,1,3,0,5,1,13.0,6.0
12499,2000-2001,33,Willem II,RBC Roosendaal,3,0,1,3,0,3,3,10.0,0.0
12500,2000-2001,33,Roda JC Kerkrade,NEC Nijmegen,4,1,1,3,0,5,3,10.0,3.0
12501,2000-2001,33,NAC Breda,Sparta Rotterdam,2,0,1,3,0,2,2,8.0,1.0
12502,2000-2001,33,Feyenoord,FC Utrecht,2,2,3,1,1,4,0,7.0,11.0
12503,2000-2001,33,FC Twente,AFC Ajax,1,3,2,0,3,4,-2,9.0,7.0
12504,2000-2001,33,FC Groningen,RKC Waalwijk,1,2,2,0,3,3,-1,5.0,7.0
12505,2000-2001,33,AZ Alkmaar,sc Heerenveen,2,2,3,1,1,4,0,5.0,8.0
12506,2000-2001,33,Vitesse,Fortuna Sittard,3,0,1,3,0,3,3,11.0,4.0
12507,2000-2001,34,Sparta Rotterdam,Vitesse,2,2,3,1,1,4,0,2.0,9.0
12508,2000-2001,34,sc Heerenveen,FC Twente,1,1,3,1,1,2,0,6.0,10.0
12509,2000-2001,34,FC Utrecht,FC Groningen,6,0,1,3,0,6,6,11.0,2.0
12510,2000-2001,34,AFC Ajax,AZ Alkmaar,5,1,1,3,0,6,4,10.0,4.0
12511,2000-2001,34,RBC Roosendaal,Feyenoord,0,1,2,0,3,1,-1,0.0,7.0
12512,2000-2001,34,NEC Nijmegen,PSV,2,4,2,0,3,6,-2,3.0,13.0
12513,2000-2001,34,RKC Waalwijk,Roda JC Kerkrade,3,2,1,3,0,5,1,10.0,7.0
12514,2000-2001,34,Fortuna Sittard,Willem II,4,1,1,3,0,5,3,7.0,10.0
12515,2000-2001,34,De Graafschap,NAC Breda,1,1,3,1,1,2,0,4.0,8.0
12516,2001-2002,1,FC Twente,RKC Waalwijk,1,0,1,3,0,1,1,10.0,10.0
12517,2001-2002,1,FC Groningen,PSV,2,2,3,1,1,4,0,2.0,13.0
12518,2001-2002,1,NAC Breda,FC Utrecht,1,0,1,3,0,1,1,11.0,8.0
12519,2001-2002,1,FC Den Bosch,sc Heerenveen,0,0,3,1,1,0,0,6.0,4.0
12520,2001-2002,1,De Graafschap,AZ Alkmaar,3,0,1,3,0,3,3,7.0,4.0
12521,2001-2002,1,Willem II,NEC Nijmegen,3,1,1,3,0,4,2,12.0,0.0
12522,2001-2002,1,AFC Ajax,Roda JC Kerkrade,1,1,3,1,1,2,0,8.0,5.0
12523,2001-2002,1,Feyenoord,Sparta Rotterdam,5,0,1,3,0,5,5,10.0,2.0
12524,2001-2002,1,Fortuna Sittard,Vitesse,0,0,3,1,1,0,0,7.0,7.0
12525,2001-2002,2,NAC Breda,FC Twente,3,3,3,1,1,6,0,11.0,8.0
12526,2001-2002,2,Roda JC Kerkrade,Feyenoord,0,2,2,0,3,2,-2,4.0,13.0
12527,2001-2002,2,FC Groningen,Willem II,1,0,1,3,0,1,1,4.0,9.0
12528,2001-2002,2,NEC Nijmegen,RKC Waalwijk,1,0,1,3,0,1,1,3.0,9.0
12529,2001-2002,2,Sparta Rotterdam,FC Utrecht,3,1,1,3,0,4,2,4.0,7.0
12530,2001-2002,2,PSV,FC Den Bosch,3,2,1,3,0,5,1,13.0,5.0
12531,2001-2002,2,Vitesse,AZ Alkmaar,1,0,1,3,0,1,1,9.0,4.0
12532,2001-2002,2,Fortuna Sittard,De Graafschap,2,1,1,3,0,3,1,7.0,4.0
12533,2001-2002,2,sc Heerenveen,AFC Ajax,5,1,1,3,0,6,4,7.0,7.0
12534,2001-2002,3,sc Heerenveen,NAC Breda,5,0,1,3,0,5,5,9.0,8.0
12535,2001-2002,3,Willem II,PSV,3,1,1,3,0,4,2,9.0,10.0
12536,2001-2002,3,FC Twente,Roda JC Kerkrade,3,0,1,3,0,3,3,8.0,4.0
12537,2001-2002,3,De Graafschap,NEC Nijmegen,1,1,3,1,1,2,0,5.0,4.0
12538,2001-2002,3,Vitesse,FC Utrecht,1,0,1,3,0,1,1,11.0,4.0
12539,2001-2002,3,AZ Alkmaar,Sparta Rotterdam,3,0,1,3,0,3,3,4.0,4.0
12540,2001-2002,3,Feyenoord,AFC Ajax,1,2,2,0,3,3,-1,10.0,10.0
12541,2001-2002,3,RKC Waalwijk,FC Groningen,4,0,1,3,0,4,4,9.0,4.0
12542,2001-2002,3,FC Den Bosch,Fortuna Sittard,4,0,1,3,0,4,4,8.0,7.0
12543,2001-2002,4,sc Heerenveen,Vitesse,1,1,3,1,1,2,0,9.0,9.0
12544,2001-2002,4,Roda JC Kerkrade,De Graafschap,0,1,2,0,3,1,-1,1.0,8.0
12545,2001-2002,4,FC Twente,AFC Ajax,0,2,2,0,3,2,-2,8.0,10.0
12546,2001-2002,4,PSV,Fortuna Sittard,3,0,1,3,0,3,3,10.0,7.0
12547,2001-2002,4,AZ Alkmaar,NAC Breda,2,1,1,3,0,3,1,6.0,5.0
12548,2001-2002,4,NEC Nijmegen,Feyenoord,0,3,2,0,3,3,-3,4.0,12.0
12549,2001-2002,4,Sparta Rotterdam,RKC Waalwijk,0,0,3,1,1,0,0,5.0,7.0
12550,2001-2002,4,Willem II,FC Den Bosch,1,1,3,1,1,2,0,7.0,8.0
12551,2001-2002,4,FC Utrecht,FC Groningen,3,1,1,3,0,4,2,6.0,4.0
12552,2001-2002,5,Fortuna Sittard,Willem II,1,2,2,0,3,3,-1,4.0,10.0
12553,2001-2002,5,NAC Breda,PSV,2,0,1,3,0,2,2,7.0,7.0
12554,2001-2002,5,Vitesse,Sparta Rotterdam,1,1,3,1,1,2,0,9.0,5.0
12555,2001-2002,5,Feyenoord,De Graafschap,2,0,1,3,0,2,2,12.0,7.0
12556,2001-2002,5,RKC Waalwijk,sc Heerenveen,2,1,1,3,0,3,1,7.0,8.0
12557,2001-2002,5,AFC Ajax,AZ Alkmaar,1,0,1,3,0,1,1,10.0,6.0
12558,2001-2002,5,FC Den Bosch,NEC Nijmegen,2,1,1,3,0,3,1,8.0,4.0
12559,2001-2002,5,FC Groningen,FC Twente,3,0,1,3,0,3,3,7.0,7.0
12560,2001-2002,5,FC Utrecht,Roda JC Kerkrade,4,1,1,3,0,5,3,6.0,1.0
12561,2001-2002,6,Roda JC Kerkrade,FC Den Bosch,4,1,1,3,0,5,3,3.0,7.0
12562,2001-2002,6,sc Heerenveen,PSV,4,1,1,3,0,5,3,10.0,6.0
12563,2001-2002,6,RKC Waalwijk,Fortuna Sittard,1,0,1,3,0,1,1,10.0,3.0
12564,2001-2002,6,De Graafschap,Vitesse,0,2,2,0,3,2,-2,4.0,11.0
12565,2001-2002,6,AFC Ajax,Sparta Rotterdam,3,0,1,3,0,3,3,12.0,5.0
12566,2001-2002,6,AZ Alkmaar,FC Utrecht,1,0,1,3,0,1,1,9.0,6.0
12567,2001-2002,6,NEC Nijmegen,FC Groningen,1,0,1,3,0,1,1,7.0,6.0
12568,2001-2002,6,NAC Breda,Willem II,1,1,3,1,1,2,0,5.0,8.0
12569,2001-2002,6,FC Twente,Feyenoord,3,2,1,3,0,5,1,7.0,9.0
12570,2001-2002,7,De Graafschap,NAC Breda,4,2,1,3,0,6,2,7.0,4.0
12571,2001-2002,7,Willem II,AZ Alkmaar,2,2,3,1,1,4,0,9.0,10.0
12572,2001-2002,7,PSV,Vitesse,0,2,2,0,3,2,-2,3.0,11.0
12573,2001-2002,7,Fortuna Sittard,NEC Nijmegen,2,2,3,1,1,4,0,1.0,5.0
12574,2001-2002,7,FC Groningen,AFC Ajax,1,4,2,0,3,5,-3,3.0,15.0
12575,2001-2002,7,FC Den Bosch,Feyenoord,0,0,3,1,1,0,0,8.0,7.0
12576,2001-2002,7,FC Utrecht,RKC Waalwijk,2,1,1,3,0,3,1,9.0,10.0
12577,2001-2002,7,Roda JC Kerkrade,sc Heerenveen,0,2,2,0,3,2,-2,3.0,10.0
12578,2001-2002,7,Sparta Rotterdam,FC Twente,1,1,3,1,1,2,0,3.0,7.0
12579,2001-2002,8,Sparta Rotterdam,FC Den Bosch,1,1,3,1,1,2,0,4.0,6.0
12580,2001-2002,8,AZ Alkmaar,PSV,1,1,3,1,1,2,0,8.0,4.0
12581,2001-2002,8,NAC Breda,Roda JC Kerkrade,2,1,1,3,0,3,1,7.0,3.0
12582,2001-2002,8,RKC Waalwijk,De Graafschap,2,0,1,3,0,2,2,10.0,6.0
12583,2001-2002,8,FC Twente,Willem II,0,0,3,1,1,0,0,5.0,7.0
12584,2001-2002,8,sc Heerenveen,FC Utrecht,1,2,2,0,3,3,-1,7.0,12.0
12585,2001-2002,8,AFC Ajax,NEC Nijmegen,5,0,1,3,0,5,5,15.0,4.0
12586,2001-2002,8,Vitesse,FC Groningen,1,0,1,3,0,1,1,11.0,3.0
12587,2001-2002,8,Feyenoord,Fortuna Sittard,1,0,1,3,0,1,1,10.0,1.0
12588,2001-2002,9,Roda JC Kerkrade,PSV,0,1,2,0,3,1,-1,3.0,4.0
12589,2001-2002,9,Fortuna Sittard,Sparta Rotterdam,3,4,2,0,3,7,-1,1.0,6.0
12590,2001-2002,9,RKC Waalwijk,AFC Ajax,0,2,2,0,3,2,-2,9.0,15.0
12591,2001-2002,9,sc Heerenveen,AZ Alkmaar,2,1,1,3,0,3,1,9.0,5.0
12592,2001-2002,9,NEC Nijmegen,Vitesse,1,0,1,3,0,1,1,7.0,10.0
12593,2001-2002,9,NAC Breda,FC Den Bosch,0,0,3,1,1,0,0,8.0,6.0
12594,2001-2002,9,Feyenoord,FC Groningen,1,0,1,3,0,1,1,10.0,3.0
12595,2001-2002,9,FC Utrecht,Willem II,3,1,1,3,0,4,2,12.0,6.0
12596,2001-2002,9,De Graafschap,FC Twente,4,2,1,3,0,6,2,6.0,5.0
12597,2001-2002,10,PSV,De Graafschap,4,0,1,3,0,4,4,7.0,6.0
12598,2001-2002,10,Willem II,RKC Waalwijk,3,1,1,3,0,4,2,6.0,6.0
12599,2001-2002,10,Vitesse,NAC Breda,1,0,1,3,0,1,1,12.0,5.0
12600,2001-2002,10,AZ Alkmaar,Feyenoord,1,3,2,0,3,4,-2,5.0,10.0
12601,2001-2002,10,Sparta Rotterdam,Roda JC Kerkrade,0,3,2,0,3,3,-3,5.0,6.0
12602,2001-2002,10,FC Den Bosch,FC Utrecht,1,1,3,1,1,2,0,4.0,10.0
12603,2001-2002,10,FC Groningen,sc Heerenveen,1,1,3,1,1,2,0,1.0,10.0
12604,2001-2002,10,NEC Nijmegen,FC Twente,2,0,1,3,0,2,2,10.0,5.0
12605,2001-2002,10,AFC Ajax,Fortuna Sittard,4,0,1,3,0,4,4,15.0,1.0
12606,2001-2002,11,Roda JC Kerkrade,NEC Nijmegen,0,0,3,1,1,0,0,4.0,8.0
12607,2001-2002,11,sc Heerenveen,De Graafschap,1,0,1,3,0,1,1,10.0,6.0
12608,2001-2002,11,PSV,RKC Waalwijk,2,0,1,3,0,2,2,10.0,3.0
12609,2001-2002,11,FC Twente,Vitesse,0,0,3,1,1,0,0,3.0,10.0
12610,2001-2002,11,AZ Alkmaar,Fortuna Sittard,3,0,1,3,0,3,3,5.0,1.0
12611,2001-2002,11,AFC Ajax,Willem II,4,1,1,3,0,5,3,15.0,5.0
12612,2001-2002,11,Feyenoord,FC Utrecht,4,0,1,3,0,4,4,13.0,10.0
12613,2001-2002,11,FC Groningen,FC Den Bosch,2,0,1,3,0,2,2,4.0,4.0
12614,2001-2002,11,Sparta Rotterdam,NAC Breda,2,3,2,0,3,5,-1,5.0,7.0
12615,2001-2002,12,Willem II,Vitesse,1,1,3,1,1,2,0,5.0,8.0
12616,2001-2002,12,Sparta Rotterdam,PSV,2,1,1,3,0,3,1,7.0,10.0
12617,2001-2002,12,Fortuna Sittard,sc Heerenveen,1,0,1,3,0,1,1,3.0,7.0
12618,2001-2002,12,RKC Waalwijk,FC Den Bosch,3,3,3,1,1,6,0,4.0,4.0
12619,2001-2002,12,NEC Nijmegen,AZ Alkmaar,1,0,1,3,0,1,1,10.0,4.0
12620,2001-2002,12,Roda JC Kerkrade,FC Groningen,3,1,1,3,0,4,2,7.0,4.0
12621,2001-2002,12,NAC Breda,Feyenoord,2,1,1,3,0,3,1,10.0,12.0
12622,2001-2002,12,De Graafschap,AFC Ajax,1,1,3,1,1,2,0,4.0,13.0
12623,2001-2002,12,FC Utrecht,FC Twente,1,1,3,1,1,2,0,8.0,3.0
12624,2001-2002,13,sc Heerenveen,Sparta Rotterdam,3,0,1,3,0,3,3,10.0,6.0
12625,2001-2002,13,FC Den Bosch,FC Twente,1,3,2,0,3,4,-2,3.0,5.0
12626,2001-2002,13,PSV,NEC Nijmegen,3,1,1,3,0,4,2,12.0,10.0
12627,2001-2002,13,Feyenoord,Vitesse,3,2,1,3,0,5,1,12.0,5.0
12628,2001-2002,13,AZ Alkmaar,RKC Waalwijk,0,1,2,0,3,1,-1,3.0,4.0
12629,2001-2002,13,Willem II,Roda JC Kerkrade,1,1,3,1,1,2,0,5.0,8.0
12630,2001-2002,13,FC Utrecht,De Graafschap,6,0,1,3,0,6,6,8.0,4.0
12631,2001-2002,13,AFC Ajax,NAC Breda,1,3,2,0,3,4,-2,10.0,10.0
12632,2001-2002,13,FC Groningen,Fortuna Sittard,4,2,1,3,0,6,2,7.0,3.0
12633,2001-2002,14,AZ Alkmaar,FC Den Bosch,3,2,1,3,0,5,1,6.0,2.0
12634,2001-2002,14,De Graafschap,Sparta Rotterdam,3,0,1,3,0,3,3,4.0,3.0
12635,2001-2002,14,FC Twente,sc Heerenveen,0,0,3,1,1,0,0,6.0,8.0
12636,2001-2002,14,Fortuna Sittard,RKC Waalwijk,1,4,2,0,3,5,-3,3.0,7.0
12637,2001-2002,14,NAC Breda,FC Groningen,5,0,1,3,0,5,5,12.0,7.0
12638,2001-2002,14,Vitesse,Roda JC Kerkrade,2,0,1,3,0,2,2,8.0,8.0
12639,2001-2002,14,AFC Ajax,PSV,1,3,2,0,3,4,-2,7.0,12.0
12640,2001-2002,14,Feyenoord,Willem II,3,1,1,3,0,4,2,12.0,5.0
12641,2001-2002,14,NEC Nijmegen,FC Utrecht,0,3,2,0,3,3,-3,7.0,8.0
12642,2001-2002,15,FC Groningen,AZ Alkmaar,0,1,2,0,3,1,-1,6.0,9.0
12643,2001-2002,15,FC Den Bosch,De Graafschap,3,1,1,3,0,4,2,4.0,4.0
12644,2001-2002,15,FC Utrecht,PSV,3,3,3,1,1,6,0,8.0,10.0
12645,2001-2002,15,NEC Nijmegen,NAC Breda,1,3,2,0,3,4,-2,4.0,15.0
12646,2001-2002,15,RKC Waalwijk,Feyenoord,2,3,2,0,3,5,-1,7.0,12.0
12647,2001-2002,15,Roda JC Kerkrade,Fortuna Sittard,1,0,1,3,0,1,1,8.0,3.0
12648,2001-2002,15,Sparta Rotterdam,Willem II,3,2,1,3,0,5,1,6.0,2.0
12649,2001-2002,15,AFC Ajax,FC Twente,3,2,1,3,0,5,1,7.0,6.0
12650,2001-2002,16,De Graafschap,FC Groningen,1,2,2,0,3,3,-1,4.0,6.0
12651,2001-2002,16,FC Twente,Fortuna Sittard,1,1,3,1,1,2,0,6.0,4.0
12652,2001-2002,16,PSV,AZ Alkmaar,3,0,1,3,0,3,3,10.0,6.0
12653,2001-2002,16,sc Heerenveen,Feyenoord,1,0,1,3,0,1,1,10.0,9.0
12654,2001-2002,16,RKC Waalwijk,Roda JC Kerkrade,3,0,1,3,0,3,3,10.0,7.0
12655,2001-2002,16,Willem II,NAC Breda,2,2,3,1,1,4,0,3.0,13.0
12656,2001-2002,16,FC Utrecht,Vitesse,3,1,1,3,0,4,2,11.0,5.0
12657,2001-2002,16,Sparta Rotterdam,NEC Nijmegen,0,0,3,1,1,0,0,7.0,4.0
12658,2001-2002,16,FC Den Bosch,AFC Ajax,0,1,2,0,3,1,-1,4.0,7.0
12659,2001-2002,17,Fortuna Sittard,FC Den Bosch,1,3,2,0,3,4,-2,1.0,6.0
12660,2001-2002,17,Vitesse,De Graafschap,2,1,1,3,0,3,1,7.0,3.0
12661,2001-2002,17,NAC Breda,RKC Waalwijk,0,1,2,0,3,1,-1,10.0,12.0
12662,2001-2002,17,Willem II,sc Heerenveen,2,2,3,1,1,4,0,3.0,8.0
12663,2001-2002,17,AZ Alkmaar,Roda JC Kerkrade,1,2,2,0,3,3,-1,6.0,7.0
12664,2001-2002,17,Feyenoord,NEC Nijmegen,5,0,1,3,0,5,5,12.0,1.0
12665,2001-2002,17,PSV,FC Twente,1,0,1,3,0,1,1,13.0,5.0
12666,2001-2002,17,FC Groningen,Sparta Rotterdam,0,0,3,1,1,0,0,7.0,5.0
12667,2001-2002,18,Fortuna Sittard,NAC Breda,2,3,2,0,3,5,-1,1.0,10.0
12668,2001-2002,18,FC Twente,AZ Alkmaar,0,0,3,1,1,0,0,3.0,7.0
12669,2001-2002,18,De Graafschap,Willem II,1,1,3,1,1,2,0,4.0,3.0
12670,2001-2002,18,Roda JC Kerkrade,AFC Ajax,1,1,3,1,1,2,0,7.0,7.0
12671,2001-2002,18,FC Den Bosch,Vitesse,4,1,1,3,0,5,3,9.0,6.0
12672,2001-2002,18,RKC Waalwijk,Sparta Rotterdam,1,1,3,1,1,2,0,10.0,6.0
12673,2001-2002,18,Feyenoord,PSV,0,0,3,1,1,0,0,10.0,11.0
12674,2001-2002,18,NEC Nijmegen,sc Heerenveen,1,0,1,3,0,1,1,4.0,8.0
12675,2001-2002,18,FC Groningen,FC Utrecht,2,2,3,1,1,4,0,5.0,11.0
12676,2001-2002,19,sc Heerenveen,FC Den Bosch,2,0,1,3,0,2,2,8.0,9.0
12677,2001-2002,19,Fortuna Sittard,FC Utrecht,3,3,3,1,1,6,0,2.0,9.0
12678,2001-2002,19,AFC Ajax,Vitesse,5,1,1,3,0,6,4,10.0,6.0
12679,2001-2002,19,Willem II,FC Groningen,3,1,1,3,0,4,2,6.0,5.0
12680,2001-2002,19,RKC Waalwijk,PSV,2,1,1,3,0,3,1,10.0,8.0
12681,2001-2002,19,Roda JC Kerkrade,FC Utrecht,1,0,1,3,0,1,1,10.0,6.0
12682,2001-2002,20,NAC Breda,sc Heerenveen,2,1,1,3,0,3,1,10.0,7.0
12683,2001-2002,20,PSV,FC Groningen,8,0,1,3,0,8,8,10.0,5.0
12684,2001-2002,20,Willem II,FC Twente,3,3,3,1,1,6,0,7.0,3.0
12685,2001-2002,20,Vitesse,RKC Waalwijk,1,1,3,1,1,2,0,4.0,11.0
12686,2001-2002,20,FC Utrecht,AFC Ajax,3,1,1,3,0,4,2,8.0,10.0
12687,2001-2002,20,NEC Nijmegen,Roda JC Kerkrade,1,0,1,3,0,1,1,7.0,7.0
12688,2001-2002,20,Sparta Rotterdam,AZ Alkmaar,0,4,2,0,3,4,-4,6.0,7.0
12689,2001-2002,20,De Graafschap,Feyenoord,1,0,1,3,0,1,1,4.0,7.0
12690,2001-2002,21,Sparta Rotterdam,sc Heerenveen,1,4,2,0,3,5,-3,3.0,7.0
12691,2001-2002,21,Roda JC Kerkrade,FC Twente,2,1,1,3,0,3,1,10.0,3.0
12692,2001-2002,21,PSV,NAC Breda,3,1,1,3,0,4,2,10.0,7.0
12693,2001-2002,21,De Graafschap,Fortuna Sittard,5,0,1,3,0,5,5,7.0,2.0
12694,2001-2002,21,FC Utrecht,Feyenoord,2,2,3,1,1,4,0,6.0,5.0
12695,2001-2002,21,Vitesse,NEC Nijmegen,2,1,1,3,0,3,1,7.0,7.0
12696,2001-2002,21,RKC Waalwijk,Willem II,0,1,2,0,3,1,-1,8.0,9.0
12697,2001-2002,21,AZ Alkmaar,AFC Ajax,0,0,3,1,1,0,0,5.0,8.0
12698,2001-2002,21,FC Den Bosch,FC Groningen,1,4,2,0,3,5,-3,6.0,5.0
12699,2001-2002,22,NEC Nijmegen,Sparta Rotterdam,1,1,3,1,1,2,0,7.0,3.0
12700,2001-2002,22,Fortuna Sittard,PSV,0,1,2,0,3,1,-1,1.0,10.0
12701,2001-2002,22,FC Den Bosch,RKC Waalwijk,1,0,1,3,0,1,1,9.0,5.0
12702,2001-2002,22,FC Twente,De Graafschap,0,0,3,1,1,0,0,3.0,8.0
12703,2001-2002,22,AZ Alkmaar,Vitesse,0,0,3,1,1,0,0,6.0,5.0
12704,2001-2002,22,Feyenoord,Roda JC Kerkrade,5,0,1,3,0,5,5,8.0,7.0
12705,2001-2002,22,FC Groningen,NAC Breda,3,0,1,3,0,3,3,7.0,6.0
12706,2001-2002,22,FC Utrecht,sc Heerenveen,0,0,3,1,1,0,0,6.0,7.0
12707,2001-2002,22,Willem II,AFC Ajax,1,3,2,0,3,4,-2,8.0,8.0
12708,2001-2002,23,NAC Breda,Sparta Rotterdam,2,2,3,1,1,4,0,7.0,3.0
12709,2001-2002,23,FC Twente,FC Den Bosch,4,0,1,3,0,4,4,6.0,6.0
12710,2001-2002,23,Vitesse,Fortuna Sittard,1,1,3,1,1,2,0,6.0,2.0
12711,2001-2002,23,AZ Alkmaar,sc Heerenveen,0,2,2,0,3,2,-2,6.0,10.0
12712,2001-2002,23,Sparta Rotterdam,De Graafschap,1,3,2,0,3,4,-2,2.0,11.0
12713,2001-2002,23,FC Groningen,Feyenoord,0,1,2,0,3,1,-1,6.0,8.0
12714,2001-2002,23,AFC Ajax,RKC Waalwijk,3,1,1,3,0,4,2,10.0,4.0
12715,2001-2002,23,FC Utrecht,NEC Nijmegen,1,4,2,0,3,5,-3,5.0,10.0
12716,2001-2002,24,AZ Alkmaar,FC Groningen,3,2,1,3,0,5,1,8.0,6.0
12717,2001-2002,24,FC Den Bosch,Sparta Rotterdam,1,1,3,1,1,2,0,4.0,3.0
12718,2001-2002,24,NEC Nijmegen,PSV,0,4,2,0,3,4,-4,7.0,12.0
12719,2001-2002,24,sc Heerenveen,Willem II,3,0,1,3,0,3,3,10.0,7.0
12720,2001-2002,24,De Graafschap,Roda JC Kerkrade,2,1,1,3,0,3,1,13.0,6.0
12721,2001-2002,24,Vitesse,Feyenoord,2,1,1,3,0,3,1,9.0,7.0
12722,2001-2002,24,FC Twente,NAC Breda,1,2,2,0,3,3,-1,5.0,7.0
12723,2001-2002,24,Fortuna Sittard,AFC Ajax,1,1,3,1,1,2,0,3.0,8.0
12724,2001-2002,25,Roda JC Kerkrade,Willem II,2,0,1,3,0,2,2,6.0,4.0
12725,2001-2002,25,Vitesse,FC Den Bosch,1,1,3,1,1,2,0,9.0,5.0
12726,2001-2002,25,NAC Breda,AFC Ajax,0,1,2,0,3,1,-1,4.0,11.0
12727,2001-2002,25,Feyenoord,FC Twente,1,2,2,0,3,3,-1,7.0,7.0
12728,2001-2002,25,RKC Waalwijk,AZ Alkmaar,3,2,1,3,0,5,1,4.0,5.0
12729,2001-2002,25,PSV,FC Utrecht,4,0,1,3,0,4,4,15.0,5.0
12730,2001-2002,25,NEC Nijmegen,De Graafschap,3,1,1,3,0,4,2,7.0,10.0
12731,2001-2002,25,sc Heerenveen,Fortuna Sittard,3,1,1,3,0,4,2,13.0,2.0
12732,2001-2002,26,NAC Breda,AZ Alkmaar,3,1,1,3,0,4,2,7.0,4.0
12733,2001-2002,26,De Graafschap,FC Den Bosch,0,1,2,0,3,1,-1,7.0,8.0
12734,2001-2002,26,Willem II,FC Utrecht,4,2,1,3,0,6,2,6.0,2.0
12735,2001-2002,26,AFC Ajax,Feyenoord,1,1,3,1,1,2,0,11.0,7.0
12736,2001-2002,26,Sparta Rotterdam,Fortuna Sittard,0,0,3,1,1,0,0,4.0,3.0
12737,2001-2002,26,FC Twente,NEC Nijmegen,2,0,1,3,0,2,2,10.0,7.0
12738,2001-2002,26,FC Groningen,RKC Waalwijk,1,1,3,1,1,2,0,7.0,4.0
12739,2001-2002,26,Roda JC Kerkrade,Vitesse,0,2,2,0,3,2,-2,6.0,9.0
12740,2001-2002,26,PSV,sc Heerenveen,4,1,1,3,0,5,3,15.0,10.0
12741,2001-2002,27,FC Utrecht,Sparta Rotterdam,4,2,1,3,0,6,2,4.0,3.0
12742,2001-2002,27,Fortuna Sittard,FC Groningen,0,1,2,0,3,1,-1,3.0,7.0
12743,2001-2002,27,PSV,Roda JC Kerkrade,4,1,1,3,0,5,3,15.0,3.0
12744,2001-2002,27,sc Heerenveen,RKC Waalwijk,2,0,1,3,0,2,2,12.0,4.0
12745,2001-2002,27,FC Den Bosch,NAC Breda,1,2,2,0,3,3,-1,5.0,10.0
12746,2001-2002,27,Vitesse,FC Twente,2,0,1,3,0,2,2,11.0,9.0
12747,2001-2002,27,NEC Nijmegen,Willem II,3,0,1,3,0,3,3,9.0,3.0
12748,2001-2002,27,Feyenoord,AZ Alkmaar,4,1,1,3,0,5,3,7.0,3.0
12749,2001-2002,27,AFC Ajax,De Graafschap,4,0,1,3,0,4,4,11.0,6.0
12750,2001-2002,28,Roda JC Kerkrade,NAC Breda,1,1,3,1,1,2,0,4.0,10.0
12751,2001-2002,28,Willem II,Sparta Rotterdam,4,0,1,3,0,4,4,6.0,2.0
12752,2001-2002,28,AZ Alkmaar,De Graafschap,2,1,1,3,0,3,1,6.0,3.0
12753,2001-2002,28,AFC Ajax,sc Heerenveen,2,0,1,3,0,2,2,11.0,9.0
12754,2001-2002,28,Feyenoord,FC Den Bosch,3,0,1,3,0,3,3,7.0,5.0
12755,2001-2002,28,Vitesse,PSV,0,0,3,1,1,0,0,11.0,13.0
12756,2001-2002,28,FC Twente,FC Groningen,0,1,2,0,3,1,-1,6.0,7.0
12757,2001-2002,28,RKC Waalwijk,NEC Nijmegen,2,1,1,3,0,3,1,7.0,6.0
12758,2001-2002,28,FC Utrecht,Fortuna Sittard,3,0,1,3,0,3,3,6.0,2.0
12759,2001-2002,29,Fortuna Sittard,AZ Alkmaar,0,1,2,0,3,1,-1,1.0,6.0
12760,2001-2002,29,FC Den Bosch,Willem II,1,2,2,0,3,3,-1,4.0,9.0
12761,2001-2002,29,NAC Breda,Vitesse,3,3,3,1,1,6,0,8.0,9.0
12762,2001-2002,29,sc Heerenveen,NEC Nijmegen,4,0,1,3,0,4,4,9.0,6.0
12763,2001-2002,29,PSV,AFC Ajax,1,1,3,1,1,2,0,11.0,11.0
12764,2001-2002,29,Sparta Rotterdam,Feyenoord,0,5,2,0,3,5,-5,2.0,10.0
12765,2001-2002,29,De Graafschap,FC Utrecht,0,0,3,1,1,0,0,1.0,7.0
12766,2001-2002,29,RKC Waalwijk,FC Twente,3,1,1,3,0,4,2,10.0,6.0
12767,2001-2002,29,FC Groningen,Roda JC Kerkrade,0,2,2,0,3,2,-2,7.0,7.0
12768,2001-2002,30,NAC Breda,De Graafschap,1,0,1,3,0,1,1,11.0,1.0
12769,2001-2002,30,Roda JC Kerkrade,Sparta Rotterdam,3,0,1,3,0,3,3,7.0,1.0
12770,2001-2002,30,AZ Alkmaar,FC Twente,0,2,2,0,3,2,-2,6.0,6.0
12771,2001-2002,30,NEC Nijmegen,Fortuna Sittard,3,1,1,3,0,4,2,6.0,1.0
12772,2001-2002,30,Vitesse,AFC Ajax,3,1,1,3,0,4,2,11.0,8.0
12773,2001-2002,30,Feyenoord,RKC Waalwijk,1,1,3,1,1,2,0,11.0,8.0
12774,2001-2002,30,FC Utrecht,FC Den Bosch,3,1,1,3,0,4,2,10.0,3.0
12775,2001-2002,30,sc Heerenveen,FC Groningen,2,0,1,3,0,2,2,9.0,7.0
12776,2001-2002,30,PSV,Willem II,6,0,1,3,0,6,6,11.0,9.0
12777,2001-2002,31,FC Twente,Sparta Rotterdam,2,0,1,3,0,2,2,6.0,0.0
12778,2001-2002,31,Willem II,Fortuna Sittard,3,0,1,3,0,3,3,9.0,0.0
12779,2001-2002,31,Roda JC Kerkrade,AZ Alkmaar,0,0,3,1,1,0,0,8.0,7.0
12780,2001-2002,31,De Graafschap,RKC Waalwijk,3,1,1,3,0,4,2,4.0,7.0
12781,2001-2002,31,Vitesse,sc Heerenveen,0,0,3,1,1,0,0,9.0,10.0
12782,2001-2002,31,FC Den Bosch,PSV,0,1,2,0,3,1,-1,0.0,11.0
12783,2001-2002,31,FC Groningen,NEC Nijmegen,2,2,3,1,1,4,0,7.0,7.0
12784,2001-2002,31,Feyenoord,NAC Breda,0,0,3,1,1,0,0,11.0,9.0
12785,2001-2002,31,AFC Ajax,FC Utrecht,1,0,1,3,0,1,1,10.0,10.0
12786,2001-2002,32,NAC Breda,NEC Nijmegen,1,3,2,0,3,4,-2,6.0,7.0
12787,2001-2002,32,FC Den Bosch,Roda JC Kerkrade,3,1,1,3,0,4,2,3.0,8.0
12788,2001-2002,32,De Graafschap,sc Heerenveen,1,2,2,0,3,3,-1,4.0,10.0
12789,2001-2002,32,Fortuna Sittard,FC Twente,2,0,1,3,0,2,2,3.0,6.0
12790,2001-2002,32,AZ Alkmaar,Willem II,2,2,3,1,1,4,0,8.0,10.0
12791,2001-2002,32,Sparta Rotterdam,AFC Ajax,0,4,2,0,3,4,-4,0.0,10.0
12792,2001-2002,32,PSV,Feyenoord,2,0,1,3,0,2,2,11.0,8.0
12793,2001-2002,32,FC Groningen,Vitesse,0,1,2,0,3,1,-1,4.0,9.0
12794,2001-2002,32,RKC Waalwijk,FC Utrecht,1,2,2,0,3,3,-1,7.0,10.0
12795,2001-2002,33,AFC Ajax,FC Groningen,4,3,1,3,0,7,1,10.0,1.0
12796,2001-2002,33,Fortuna Sittard,Feyenoord,1,2,2,0,3,3,-1,3.0,8.0
12797,2001-2002,33,Willem II,De Graafschap,2,2,3,1,1,4,0,8.0,5.0
12798,2001-2002,33,FC Twente,PSV,1,1,3,1,1,2,0,7.0,11.0
12799,2001-2002,33,sc Heerenveen,Roda JC Kerkrade,0,0,3,1,1,0,0,11.0,8.0
12800,2001-2002,33,Sparta Rotterdam,Vitesse,0,1,2,0,3,1,-1,0.0,11.0
12801,2001-2002,33,RKC Waalwijk,NAC Breda,4,1,1,3,0,5,3,7.0,5.0
12802,2001-2002,33,NEC Nijmegen,FC Den Bosch,2,1,1,3,0,3,1,10.0,3.0
12803,2001-2002,33,FC Utrecht,AZ Alkmaar,3,2,1,3,0,5,1,10.0,5.0
12804,2001-2002,34,Vitesse,Willem II,4,2,1,3,0,6,2,13.0,5.0
12805,2001-2002,34,FC Twente,FC Utrecht,2,0,1,3,0,2,2,10.0,9.0
12806,2001-2002,34,Roda JC Kerkrade,RKC Waalwijk,1,0,1,3,0,1,1,8.0,4.0
12807,2001-2002,34,AZ Alkmaar,NEC Nijmegen,5,0,1,3,0,5,5,5.0,10.0
12808,2001-2002,34,FC Groningen,De Graafschap,2,0,1,3,0,2,2,4.0,4.0
12809,2001-2002,34,NAC Breda,Fortuna Sittard,3,1,1,3,0,4,2,7.0,3.0
12810,2001-2002,34,Feyenoord,sc Heerenveen,3,2,1,3,0,5,1,8.0,8.0
12811,2001-2002,34,AFC Ajax,FC Den Bosch,2,0,1,3,0,2,2,12.0,3.0
12812,2001-2002,34,PSV,Sparta Rotterdam,3,0,1,3,0,3,3,13.0,0.0
12813,2002-2003,1,RBC Roosendaal,FC Zwolle,1,1,3,1,1,2,0,1.0,
12814,2002-2003,1,SBV Excelsior,PSV,0,2,2,0,3,2,-2,1.0,13.0
12815,2002-2003,1,NAC Breda,Roda JC Kerkrade,2,2,3,1,1,4,0,5.0,6.0
12816,2002-2003,1,FC Twente,Willem II,0,2,2,0,3,2,-2,7.0,8.0
12817,2002-2003,1,AZ Alkmaar,sc Heerenveen,3,3,3,1,1,6,0,6.0,6.0
12818,2002-2003,1,FC Groningen,Vitesse,1,2,2,0,3,3,-1,4.0,13.0
12819,2002-2003,1,AFC Ajax,FC Utrecht,3,1,1,3,0,4,2,15.0,6.0
12820,2002-2003,1,Feyenoord,NEC Nijmegen,2,0,1,3,0,2,2,10.0,7.0
12821,2002-2003,1,RKC Waalwijk,De Graafschap,4,2,1,3,0,6,2,6.0,4.0
12822,2002-2003,2,NEC Nijmegen,AZ Alkmaar,2,0,1,3,0,2,2,9.0,5.0
12823,2002-2003,2,Roda JC Kerkrade,Feyenoord,2,2,3,1,1,4,0,6.0,10.0
12824,2002-2003,2,PSV,FC Groningen,1,0,1,3,0,1,1,13.0,3.0
12825,2002-2003,2,De Graafschap,RBC Roosendaal,2,0,1,3,0,2,2,4.0,1.0
12826,2002-2003,2,sc Heerenveen,RKC Waalwijk,1,2,2,0,3,3,-1,5.0,9.0
12827,2002-2003,2,FC Zwolle,SBV Excelsior,1,1,3,1,1,2,0,,1.0
12828,2002-2003,2,Willem II,NAC Breda,1,1,3,1,1,2,0,6.0,5.0
12829,2002-2003,2,Vitesse,AFC Ajax,1,2,2,0,3,3,-1,12.0,15.0
12830,2002-2003,2,FC Twente,FC Utrecht,1,1,3,1,1,2,0,5.0,7.0
12831,2002-2003,3,RKC Waalwijk,FC Twente,3,2,1,3,0,5,1,12.0,5.0
12832,2002-2003,3,Roda JC Kerkrade,Willem II,1,0,1,3,0,1,1,9.0,5.0
12833,2002-2003,3,NAC Breda,NEC Nijmegen,0,0,3,1,1,0,0,6.0,7.0
12834,2002-2003,3,FC Zwolle,Vitesse,1,0,1,3,0,1,1,,9.0
12835,2002-2003,3,RBC Roosendaal,sc Heerenveen,3,0,1,3,0,3,3,4.0,2.0
12836,2002-2003,3,FC Groningen,AFC Ajax,1,3,2,0,3,4,-2,3.0,15.0
12837,2002-2003,3,FC Utrecht,De Graafschap,4,0,1,3,0,4,4,7.0,4.0
12838,2002-2003,3,AZ Alkmaar,PSV,0,4,2,0,3,4,-4,4.0,13.0
12839,2002-2003,3,Feyenoord,SBV Excelsior,4,1,1,3,0,5,3,13.0,1.0
12840,2002-2003,4,Vitesse,RBC Roosendaal,3,0,1,3,0,3,3,9.0,4.0
12841,2002-2003,4,SBV Excelsior,FC Groningen,4,2,1,3,0,6,2,4.0,3.0
12842,2002-2003,4,Willem II,FC Utrecht,2,0,1,3,0,2,2,7.0,4.0
12843,2002-2003,4,sc Heerenveen,NAC Breda,0,2,2,0,3,2,-2,1.0,9.0
12844,2002-2003,4,PSV,RKC Waalwijk,4,0,1,3,0,4,4,15.0,9.0
12845,2002-2003,4,AFC Ajax,FC Zwolle,2,0,1,3,0,2,2,15.0,
12846,2002-2003,4,FC Twente,Feyenoord,1,5,2,0,3,6,-4,4.0,13.0
12847,2002-2003,4,De Graafschap,AZ Alkmaar,1,2,2,0,3,3,-1,3.0,7.0
12848,2002-2003,4,NEC Nijmegen,Roda JC Kerkrade,2,4,2,0,3,6,-2,4.0,11.0
12849,2002-2003,5,SBV Excelsior,AZ Alkmaar,1,2,2,0,3,3,-1,4.0,7.0
12850,2002-2003,5,NAC Breda,FC Twente,2,0,1,3,0,2,2,9.0,1.0
12851,2002-2003,5,RBC Roosendaal,AFC Ajax,2,3,2,0,3,5,-1,4.0,15.0
12852,2002-2003,5,FC Zwolle,PSV,1,3,2,0,3,4,-2,5.0,15.0
12853,2002-2003,5,Willem II,NEC Nijmegen,1,1,3,1,1,2,0,8.0,5.0
12854,2002-2003,5,Feyenoord,De Graafschap,2,0,1,3,0,2,2,13.0,3.0
12855,2002-2003,5,FC Groningen,FC Utrecht,0,0,3,1,1,0,0,1.0,5.0
12856,2002-2003,5,Roda JC Kerkrade,sc Heerenveen,1,0,1,3,0,1,1,11.0,1.0
12857,2002-2003,5,Vitesse,RKC Waalwijk,1,1,3,1,1,2,0,7.0,10.0
12858,2002-2003,6,AZ Alkmaar,FC Groningen,4,1,1,3,0,5,3,9.0,1.0
12859,2002-2003,6,PSV,De Graafschap,4,0,1,3,0,4,4,15.0,3.0
12860,2002-2003,6,RBC Roosendaal,Feyenoord,4,2,1,3,0,6,2,6.0,10.0
12861,2002-2003,6,Willem II,FC Zwolle,5,2,1,3,0,7,3,8.0,4.0
12862,2002-2003,6,FC Twente,Roda JC Kerkrade,3,3,3,1,1,6,0,2.0,11.0
12863,2002-2003,6,AFC Ajax,NAC Breda,2,2,3,1,1,4,0,13.0,9.0
12864,2002-2003,6,FC Utrecht,Vitesse,1,0,1,3,0,1,1,8.0,4.0
12865,2002-2003,6,NEC Nijmegen,sc Heerenveen,4,2,1,3,0,6,2,8.0,0.0
12866,2002-2003,6,RKC Waalwijk,SBV Excelsior,0,3,2,0,3,3,-3,7.0,7.0
12867,2002-2003,7,NEC Nijmegen,FC Groningen,2,0,1,3,0,2,2,8.0,1.0
12868,2002-2003,7,RKC Waalwijk,FC Zwolle,0,2,2,0,3,2,-2,4.0,6.0
12869,2002-2003,7,De Graafschap,FC Twente,0,1,2,0,3,1,-1,0.0,4.0
12870,2002-2003,7,Roda JC Kerkrade,SBV Excelsior,2,3,2,0,3,5,-1,10.0,9.0
12871,2002-2003,7,NAC Breda,PSV,2,2,3,1,1,4,0,9.0,13.0
12872,2002-2003,7,Feyenoord,AFC Ajax,1,2,2,0,3,3,-1,9.0,13.0
12873,2002-2003,7,AZ Alkmaar,Vitesse,1,3,2,0,3,4,-2,9.0,7.0
12874,2002-2003,7,FC Utrecht,RBC Roosendaal,2,2,3,1,1,4,0,8.0,7.0
12875,2002-2003,7,sc Heerenveen,Willem II,1,1,3,1,1,2,0,1.0,8.0
12876,2002-2003,8,De Graafschap,NEC Nijmegen,1,3,2,0,3,4,-2,0.0,10.0
12877,2002-2003,8,PSV,Roda JC Kerkrade,0,0,3,1,1,0,0,11.0,8.0
12878,2002-2003,8,Willem II,RBC Roosendaal,3,1,1,3,0,4,2,11.0,4.0
12879,2002-2003,8,AFC Ajax,AZ Alkmaar,6,2,1,3,0,8,4,13.0,9.0
12880,2002-2003,8,Vitesse,Feyenoord,1,1,3,1,1,2,0,8.0,7.0
12881,2002-2003,8,FC Twente,sc Heerenveen,1,1,3,1,1,2,0,5.0,2.0
12882,2002-2003,8,SBV Excelsior,FC Utrecht,1,1,3,1,1,2,0,10.0,6.0
12883,2002-2003,8,FC Groningen,RKC Waalwijk,2,3,2,0,3,5,-1,1.0,4.0
12884,2002-2003,8,FC Zwolle,NAC Breda,0,3,2,0,3,3,-3,3.0,11.0
12885,2002-2003,9,NAC Breda,Vitesse,0,0,3,1,1,0,0,9.0,6.0
12886,2002-2003,9,sc Heerenveen,SBV Excelsior,2,0,1,3,0,2,2,5.0,7.0
12887,2002-2003,9,Roda JC Kerkrade,De Graafschap,5,0,1,3,0,5,5,8.0,0.0
12888,2002-2003,9,RKC Waalwijk,AFC Ajax,1,1,3,1,1,2,0,5.0,11.0
12889,2002-2003,9,NEC Nijmegen,PSV,0,5,2,0,3,5,-5,10.0,11.0
12890,2002-2003,9,AZ Alkmaar,FC Twente,1,2,2,0,3,3,-1,6.0,8.0
12891,2002-2003,9,Feyenoord,Willem II,5,1,1,3,0,6,4,7.0,8.0
12892,2002-2003,9,RBC Roosendaal,FC Groningen,2,0,1,3,0,2,2,7.0,1.0
12893,2002-2003,9,FC Utrecht,FC Zwolle,2,0,1,3,0,2,2,9.0,3.0
12894,2002-2003,10,Vitesse,Roda JC Kerkrade,0,2,2,0,3,2,-2,5.0,8.0
12895,2002-2003,10,FC Zwolle,AZ Alkmaar,5,1,1,3,0,6,4,6.0,3.0
12896,2002-2003,10,SBV Excelsior,NEC Nijmegen,0,0,3,1,1,0,0,8.0,10.0
12897,2002-2003,10,FC Twente,PSV,0,0,3,1,1,0,0,9.0,9.0
12898,2002-2003,10,RBC Roosendaal,RKC Waalwijk,0,0,3,1,1,0,0,8.0,5.0
12899,2002-2003,10,sc Heerenveen,De Graafschap,3,1,1,3,0,4,2,8.0,0.0
12900,2002-2003,10,FC Utrecht,NAC Breda,1,0,1,3,0,1,1,11.0,6.0
12901,2002-2003,10,AFC Ajax,Willem II,3,0,1,3,0,3,3,11.0,7.0
12902,2002-2003,10,FC Groningen,Feyenoord,0,2,2,0,3,2,-2,0.0,7.0
12903,2002-2003,11,Roda JC Kerkrade,AFC Ajax,1,1,3,1,1,2,0,8.0,11.0
12904,2002-2003,11,Willem II,Vitesse,1,3,2,0,3,4,-2,4.0,8.0
12905,2002-2003,11,PSV,sc Heerenveen,3,1,1,3,0,4,2,9.0,8.0
12906,2002-2003,11,De Graafschap,SBV Excelsior,1,1,3,1,1,2,0,1.0,6.0
12907,2002-2003,11,NAC Breda,FC Groningen,0,0,3,1,1,0,0,6.0,1.0
12908,2002-2003,11,AZ Alkmaar,RBC Roosendaal,2,0,1,3,0,2,2,3.0,5.0
12909,2002-2003,11,Feyenoord,FC Zwolle,2,0,1,3,0,2,2,10.0,6.0
12910,2002-2003,11,NEC Nijmegen,FC Twente,1,2,2,0,3,3,-1,7.0,11.0
12911,2002-2003,11,RKC Waalwijk,FC Utrecht,0,1,2,0,3,1,-1,5.0,11.0
12912,2002-2003,12,Willem II,RKC Waalwijk,0,1,2,0,3,1,-1,3.0,8.0
12913,2002-2003,12,FC Groningen,De Graafschap,3,1,1,3,0,4,2,4.0,1.0
12914,2002-2003,12,PSV,Feyenoord,1,2,2,0,3,3,-1,8.0,13.0
12915,2002-2003,12,RBC Roosendaal,Roda JC Kerkrade,4,0,1,3,0,4,4,7.0,8.0
12916,2002-2003,12,Vitesse,sc Heerenveen,1,2,2,0,3,3,-1,5.0,10.0
12917,2002-2003,12,AFC Ajax,NEC Nijmegen,6,0,1,3,0,6,6,11.0,4.0
12918,2002-2003,12,FC Zwolle,FC Twente,1,1,3,1,1,2,0,4.0,9.0
12919,2002-2003,12,FC Utrecht,AZ Alkmaar,2,2,3,1,1,4,0,11.0,4.0
12920,2002-2003,12,SBV Excelsior,NAC Breda,0,3,2,0,3,3,-3,3.0,8.0
12921,2002-2003,13,SBV Excelsior,Willem II,0,3,2,0,3,3,-3,2.0,3.0
12922,2002-2003,13,sc Heerenveen,AFC Ajax,0,3,2,0,3,3,-3,9.0,11.0
12923,2002-2003,13,De Graafschap,NAC Breda,3,2,1,3,0,5,1,4.0,5.0
12924,2002-2003,13,RBC Roosendaal,PSV,0,3,2,0,3,3,-3,7.0,10.0
12925,2002-2003,13,Roda JC Kerkrade,AZ Alkmaar,1,3,2,0,3,4,-2,7.0,7.0
12926,2002-2003,13,FC Twente,Vitesse,1,0,1,3,0,1,1,11.0,4.0
12927,2002-2003,13,RKC Waalwijk,Feyenoord,1,0,1,3,0,1,1,8.0,12.0
12928,2002-2003,13,FC Zwolle,FC Groningen,0,2,2,0,3,2,-2,4.0,7.0
12929,2002-2003,13,FC Utrecht,NEC Nijmegen,3,2,1,3,0,5,1,13.0,1.0
12930,2002-2003,14,Roda JC Kerkrade,FC Zwolle,2,0,1,3,0,2,2,7.0,4.0
12931,2002-2003,14,PSV,Willem II,2,1,1,3,0,3,1,10.0,3.0
12932,2002-2003,14,NAC Breda,RBC Roosendaal,1,0,1,3,0,1,1,7.0,4.0
12933,2002-2003,14,AZ Alkmaar,RKC Waalwijk,2,0,1,3,0,2,2,10.0,7.0
12934,2002-2003,14,Vitesse,De Graafschap,1,1,3,1,1,2,0,4.0,5.0
12935,2002-2003,14,Feyenoord,FC Utrecht,2,1,1,3,0,3,1,12.0,10.0
12936,2002-2003,14,AFC Ajax,FC Twente,2,1,1,3,0,3,1,13.0,8.0
12937,2002-2003,14,FC Groningen,sc Heerenveen,1,1,3,1,1,2,0,8.0,7.0
12938,2002-2003,14,RBC Roosendaal,SBV Excelsior,1,1,3,1,1,2,0,4.0,3.0
12939,2002-2003,14,NEC Nijmegen,RBC Roosendaal,3,0,1,3,0,3,3,4.0,4.0
12940,2002-2003,15,sc Heerenveen,Feyenoord,3,1,1,3,0,4,2,7.0,9.0
12941,2002-2003,15,De Graafschap,AFC Ajax,1,1,3,1,1,2,0,6.0,11.0
12942,2002-2003,15,Willem II,AZ Alkmaar,3,1,1,3,0,4,2,6.0,10.0
12943,2002-2003,15,FC Utrecht,PSV,1,3,2,0,3,4,-2,7.0,12.0
12944,2002-2003,15,FC Twente,FC Groningen,0,0,3,1,1,0,0,8.0,9.0
12945,2002-2003,15,NEC Nijmegen,Vitesse,2,0,1,3,0,2,2,6.0,4.0
12946,2002-2003,15,RKC Waalwijk,Roda JC Kerkrade,2,1,1,3,0,3,1,9.0,4.0
12947,2002-2003,15,AZ Alkmaar,NAC Breda,3,1,1,3,0,4,2,10.0,7.0
12948,2002-2003,16,FC Groningen,Roda JC Kerkrade,3,2,1,3,0,5,1,11.0,3.0
12949,2002-2003,16,NAC Breda,RKC Waalwijk,1,0,1,3,0,1,1,9.0,9.0
12950,2002-2003,16,FC Zwolle,NEC Nijmegen,0,0,3,1,1,0,0,2.0,7.0
12951,2002-2003,16,De Graafschap,Willem II,1,1,3,1,1,2,0,6.0,7.0
12952,2002-2003,16,SBV Excelsior,FC Twente,2,2,3,1,1,4,0,3.0,6.0
12953,2002-2003,16,AFC Ajax,PSV,2,4,2,0,3,6,-2,10.0,12.0
12954,2002-2003,16,Feyenoord,AZ Alkmaar,6,1,1,3,0,7,5,9.0,9.0
12955,2002-2003,16,sc Heerenveen,FC Utrecht,2,2,3,1,1,4,0,8.0,5.0
12956,2002-2003,16,Vitesse,SBV Excelsior,1,2,2,0,3,3,-1,1.0,5.0
12957,2002-2003,17,sc Heerenveen,FC Zwolle,2,0,1,3,0,2,2,8.0,2.0
12958,2002-2003,17,FC Twente,RBC Roosendaal,3,0,1,3,0,3,3,8.0,1.0
12959,2002-2003,17,Roda JC Kerkrade,FC Utrecht,1,0,1,3,0,1,1,6.0,4.0
12960,2002-2003,17,De Graafschap,FC Zwolle,3,2,1,3,0,5,1,9.0,1.0
12961,2002-2003,17,PSV,Vitesse,1,0,1,3,0,1,1,15.0,1.0
12962,2002-2003,17,Willem II,FC Groningen,1,0,1,3,0,1,1,10.0,8.0
12963,2002-2003,17,NEC Nijmegen,RKC Waalwijk,0,0,3,1,1,0,0,8.0,7.0
12964,2002-2003,17,NAC Breda,Feyenoord,1,1,3,1,1,2,0,7.0,7.0
12965,2002-2003,17,SBV Excelsior,AFC Ajax,0,2,2,0,3,2,-2,5.0,10.0
12966,2002-2003,18,PSV,RBC Roosendaal,3,0,1,3,0,3,3,15.0,1.0
12967,2002-2003,18,NAC Breda,sc Heerenveen,1,1,3,1,1,2,0,8.0,9.0
12968,2002-2003,18,AZ Alkmaar,NEC Nijmegen,0,0,3,1,1,0,0,7.0,9.0
12969,2002-2003,18,Feyenoord,FC Twente,4,2,1,3,0,6,2,10.0,5.0
12970,2002-2003,18,RKC Waalwijk,FC Groningen,1,0,1,3,0,1,1,7.0,5.0
12971,2002-2003,18,Willem II,AFC Ajax,0,6,2,0,3,6,-6,7.0,10.0
12972,2002-2003,18,Vitesse,FC Zwolle,2,1,1,3,0,3,1,4.0,1.0
12973,2002-2003,18,SBV Excelsior,Roda JC Kerkrade,0,2,2,0,3,2,-2,5.0,9.0
12974,2002-2003,18,De Graafschap,FC Utrecht,1,0,1,3,0,1,1,9.0,1.0
12975,2002-2003,19,FC Zwolle,Willem II,0,3,2,0,3,3,-3,1.0,10.0
12976,2002-2003,19,sc Heerenveen,AZ Alkmaar,5,0,1,3,0,5,5,11.0,4.0
12977,2002-2003,19,RBC Roosendaal,De Graafschap,1,0,1,3,0,1,1,4.0,8.0
12978,2002-2003,19,RKC Waalwijk,PSV,0,1,2,0,3,1,-1,7.0,15.0
12979,2002-2003,19,Roda JC Kerkrade,Vitesse,2,0,1,3,0,2,2,9.0,3.0
12980,2002-2003,19,AFC Ajax,Feyenoord,1,1,3,1,1,2,0,8.0,8.0
12981,2002-2003,19,NEC Nijmegen,NAC Breda,2,0,1,3,0,2,2,9.0,5.0
12982,2002-2003,19,FC Utrecht,SBV Excelsior,2,2,3,1,1,4,0,2.0,5.0
12983,2002-2003,19,FC Groningen,FC Twente,0,0,3,1,1,0,0,5.0,6.0
12984,2002-2003,20,RBC Roosendaal,FC Utrecht,0,1,2,0,3,1,-1,3.0,5.0
12985,2002-2003,20,Willem II,Roda JC Kerkrade,5,0,1,3,0,5,5,10.0,9.0
12986,2002-2003,20,AFC Ajax,FC Groningen,2,1,1,3,0,3,1,10.0,4.0
12987,2002-2003,20,PSV,FC Zwolle,6,0,1,3,0,6,6,15.0,0.0
12988,2002-2003,20,NAC Breda,SBV Excelsior,2,1,1,3,0,3,1,8.0,4.0
12989,2002-2003,20,AZ Alkmaar,Feyenoord,1,4,2,0,3,5,-3,4.0,11.0
12990,2002-2003,20,RKC Waalwijk,Vitesse,1,0,1,3,0,1,1,7.0,3.0
12991,2002-2003,20,De Graafschap,sc Heerenveen,1,5,2,0,3,6,-4,7.0,11.0
12992,2002-2003,20,FC Twente,NEC Nijmegen,1,2,2,0,3,3,-1,5.0,9.0
12993,2002-2003,21,NEC Nijmegen,De Graafschap,1,0,1,3,0,1,1,11.0,6.0
12994,2002-2003,21,Roda JC Kerkrade,FC Twente,2,0,1,3,0,2,2,12.0,4.0
12995,2002-2003,21,PSV,NAC Breda,1,0,1,3,0,1,1,15.0,5.0
12996,2002-2003,21,SBV Excelsior,RBC Roosendaal,1,2,2,0,3,3,-1,1.0,6.0
12997,2002-2003,21,Vitesse,AZ Alkmaar,2,2,3,1,1,4,0,4.0,2.0
12998,2002-2003,21,FC Utrecht,AFC Ajax,1,0,1,3,0,1,1,7.0,10.0
12999,2002-2003,21,FC Zwolle,RKC Waalwijk,2,1,1,3,0,3,1,3.0,7.0
13000,2002-2003,21,Feyenoord,FC Groningen,4,1,1,3,0,5,3,11.0,1.0
13001,2002-2003,21,FC Utrecht,sc Heerenveen,2,2,3,1,1,4,0,8.0,11.0
13002,2002-2003,22,NEC Nijmegen,Willem II,1,0,1,3,0,1,1,13.0,9.0
13003,2002-2003,22,RBC Roosendaal,Willem II,1,0,1,3,0,1,1,9.0,6.0
13004,2002-2003,22,De Graafschap,Roda JC Kerkrade,1,1,3,1,1,2,0,4.0,10.0
13005,2002-2003,22,SBV Excelsior,RKC Waalwijk,1,2,2,0,3,3,-1,1.0,9.0
13006,2002-2003,22,sc Heerenveen,PSV,0,1,2,0,3,1,-1,8.0,15.0
13007,2002-2003,22,FC Twente,AZ Alkmaar,0,0,3,1,1,0,0,2.0,3.0
13008,2002-2003,22,AFC Ajax,Vitesse,2,0,1,3,0,2,2,10.0,4.0
13009,2002-2003,22,FC Groningen,FC Zwolle,4,0,1,3,0,4,4,4.0,3.0
13010,2002-2003,22,Feyenoord,NAC Breda,2,1,1,3,0,3,1,13.0,4.0
13011,2002-2003,23,AZ Alkmaar,Roda JC Kerkrade,1,0,1,3,0,1,1,5.0,7.0
13012,2002-2003,23,Willem II,FC Twente,1,2,2,0,3,3,-1,6.0,5.0
13013,2002-2003,23,SBV Excelsior,Feyenoord,2,6,2,0,3,8,-4,1.0,13.0
13014,2002-2003,23,FC Zwolle,AFC Ajax,0,5,2,0,3,5,-5,3.0,10.0
13015,2002-2003,23,PSV,NEC Nijmegen,2,1,1,3,0,3,1,15.0,12.0
13016,2002-2003,23,NAC Breda,De Graafschap,1,0,1,3,0,1,1,6.0,1.0
13017,2002-2003,23,RKC Waalwijk,sc Heerenveen,3,0,1,3,0,3,3,9.0,7.0
13018,2002-2003,23,Vitesse,FC Utrecht,1,4,2,0,3,5,-3,1.0,11.0
13019,2002-2003,23,FC Groningen,RBC Roosendaal,1,0,1,3,0,1,1,7.0,9.0
13020,2002-2003,24,FC Zwolle,RBC Roosendaal,1,1,3,1,1,2,0,4.0,7.0
13021,2002-2003,24,Roda JC Kerkrade,NAC Breda,0,0,3,1,1,0,0,5.0,7.0
13022,2002-2003,24,De Graafschap,RKC Waalwijk,2,4,2,0,3,6,-2,1.0,12.0
13023,2002-2003,24,sc Heerenveen,FC Twente,3,0,1,3,0,3,3,7.0,4.0
13024,2002-2003,24,Vitesse,PSV,0,5,2,0,3,5,-5,1.0,15.0
13025,2002-2003,24,NEC Nijmegen,Feyenoord,1,2,2,0,3,3,-1,9.0,15.0
13026,2002-2003,24,AZ Alkmaar,FC Utrecht,2,0,1,3,0,2,2,8.0,10.0
13027,2002-2003,24,FC Groningen,Willem II,1,1,3,1,1,2,0,7.0,4.0
13028,2002-2003,24,AFC Ajax,SBV Excelsior,2,1,1,3,0,3,1,12.0,0.0
13029,2002-2003,25,SBV Excelsior,FC Zwolle,0,1,2,0,3,1,-1,0.0,7.0
13030,2002-2003,25,RBC Roosendaal,Vitesse,3,1,1,3,0,4,2,10.0,1.0
13031,2002-2003,25,Roda JC Kerkrade,NEC Nijmegen,2,1,1,3,0,3,1,8.0,6.0
13032,2002-2003,25,Feyenoord,sc Heerenveen,5,0,1,3,0,5,5,15.0,4.0
13033,2002-2003,25,FC Twente,RKC Waalwijk,2,1,1,3,0,3,1,7.0,9.0
13034,2002-2003,25,AZ Alkmaar,De Graafschap,3,1,1,3,0,4,2,11.0,1.0
13035,2002-2003,25,PSV,AFC Ajax,2,0,1,3,0,2,2,15.0,9.0
13036,2002-2003,25,NAC Breda,Willem II,0,0,3,1,1,0,0,5.0,2.0
13037,2002-2003,25,FC Utrecht,FC Groningen,0,0,3,1,1,0,0,8.0,8.0
13038,2002-2003,26,AFC Ajax,RBC Roosendaal,4,1,1,3,0,5,3,12.0,7.0
13039,2002-2003,26,De Graafschap,Feyenoord,3,4,2,0,3,7,-1,1.0,15.0
13040,2002-2003,26,sc Heerenveen,Roda JC Kerkrade,3,2,1,3,0,5,1,6.0,5.0
13041,2002-2003,26,Vitesse,FC Groningen,0,0,3,1,1,0,0,1.0,9.0
13042,2002-2003,26,FC Twente,NAC Breda,0,0,3,1,1,0,0,8.0,6.0
13043,2002-2003,26,NEC Nijmegen,SBV Excelsior,1,0,1,3,0,1,1,6.0,0.0
13044,2002-2003,26,FC Zwolle,FC Utrecht,3,1,1,3,0,4,2,7.0,5.0
13045,2002-2003,26,RKC Waalwijk,AZ Alkmaar,2,0,1,3,0,2,2,12.0,10.0
13046,2002-2003,26,Willem II,PSV,1,1,3,1,1,2,0,3.0,13.0
13047,2002-2003,27,FC Utrecht,Willem II,1,1,3,1,1,2,0,5.0,4.0
13048,2002-2003,27,Roda JC Kerkrade,PSV,2,3,2,0,3,5,-1,4.0,13.0
13049,2002-2003,27,sc Heerenveen,NEC Nijmegen,2,3,2,0,3,5,-1,6.0,6.0
13050,2002-2003,27,Feyenoord,Vitesse,2,1,1,3,0,3,1,15.0,1.0
13051,2002-2003,27,FC Twente,De Graafschap,3,0,1,3,0,3,3,10.0,0.0
13052,2002-2003,27,AZ Alkmaar,FC Zwolle,1,1,3,1,1,2,0,10.0,8.0
13053,2002-2003,27,NAC Breda,AFC Ajax,0,3,2,0,3,3,-3,6.0,12.0
13054,2002-2003,27,FC Groningen,SBV Excelsior,1,0,1,3,0,1,1,9.0,0.0
13055,2002-2003,27,RKC Waalwijk,RBC Roosendaal,1,2,2,0,3,3,-1,9.0,7.0
13056,2002-2003,28,FC Utrecht,RKC Waalwijk,4,3,1,3,0,7,1,5.0,6.0
13057,2002-2003,28,SBV Excelsior,sc Heerenveen,1,0,1,3,0,1,1,3.0,6.0
13058,2002-2003,28,PSV,FC Twente,2,0,1,3,0,2,2,13.0,7.0
13059,2002-2003,28,AFC Ajax,Roda JC Kerkrade,4,2,1,3,0,6,2,12.0,4.0
13060,2002-2003,28,RBC Roosendaal,AZ Alkmaar,0,0,3,1,1,0,0,8.0,8.0
13061,2002-2003,28,Willem II,De Graafschap,3,0,1,3,0,3,3,7.0,0.0
13062,2002-2003,28,FC Zwolle,Feyenoord,1,3,2,0,3,4,-2,8.0,15.0
13063,2002-2003,28,Vitesse,NEC Nijmegen,1,1,3,1,1,2,0,2.0,7.0
13064,2002-2003,28,FC Groningen,NAC Breda,0,0,3,1,1,0,0,7.0,4.0
13065,2002-2003,29,RKC Waalwijk,Willem II,3,1,1,3,0,4,2,6.0,6.0
13066,2002-2003,29,De Graafschap,PSV,1,6,2,0,3,7,-5,0.0,13.0
13067,2002-2003,29,sc Heerenveen,Vitesse,2,2,3,1,1,4,0,4.0,3.0
13068,2002-2003,29,FC Twente,SBV Excelsior,1,0,1,3,0,1,1,10.0,3.0
13069,2002-2003,29,AZ Alkmaar,AFC Ajax,1,3,2,0,3,4,-2,5.0,12.0
13070,2002-2003,29,Feyenoord,RBC Roosendaal,1,0,1,3,0,1,1,15.0,7.0
13071,2002-2003,29,NEC Nijmegen,FC Utrecht,1,2,2,0,3,3,-1,7.0,8.0
13072,2002-2003,29,NAC Breda,FC Zwolle,2,0,1,3,0,2,2,6.0,7.0
13073,2002-2003,29,Roda JC Kerkrade,FC Groningen,5,1,1,3,0,6,4,6.0,6.0
13074,2002-2003,30,SBV Excelsior,De Graafschap,3,4,2,0,3,7,-1,3.0,3.0
13075,2002-2003,30,PSV,AZ Alkmaar,2,2,3,1,1,4,0,11.0,3.0
13076,2002-2003,30,Willem II,sc Heerenveen,1,5,2,0,3,6,-4,5.0,7.0
13077,2002-2003,30,AFC Ajax,RKC Waalwijk,6,1,1,3,0,7,5,15.0,6.0
13078,2002-2003,30,FC Zwolle,Roda JC Kerkrade,3,1,1,3,0,4,2,7.0,3.0
13079,2002-2003,30,Vitesse,NAC Breda,3,1,1,3,0,4,2,6.0,5.0
13080,2002-2003,30,FC Utrecht,Feyenoord,1,2,2,0,3,3,-1,7.0,15.0
13081,2002-2003,30,FC Groningen,NEC Nijmegen,0,0,3,1,1,0,0,6.0,8.0
13082,2002-2003,30,RBC Roosendaal,FC Twente,1,0,1,3,0,1,1,7.0,7.0
13083,2002-2003,31,Roda JC Kerkrade,RBC Roosendaal,1,0,1,3,0,1,1,6.0,7.0
13084,2002-2003,31,sc Heerenveen,FC Groningen,2,1,1,3,0,3,1,7.0,5.0
13085,2002-2003,31,PSV,SBV Excelsior,7,0,1,3,0,7,7,13.0,3.0
13086,2002-2003,31,NAC Breda,FC Utrecht,2,0,1,3,0,2,2,7.0,7.0
13087,2002-2003,31,FC Twente,FC Zwolle,0,0,3,1,1,0,0,7.0,5.0
13088,2002-2003,31,AZ Alkmaar,Willem II,3,2,1,3,0,5,1,6.0,4.0
13089,2002-2003,31,NEC Nijmegen,AFC Ajax,1,2,2,0,3,3,-1,5.0,15.0
13090,2002-2003,31,Feyenoord,RKC Waalwijk,2,1,1,3,0,3,1,15.0,3.0
13091,2002-2003,31,De Graafschap,Vitesse,0,1,2,0,3,1,-1,3.0,8.0
13092,2002-2003,32,FC Utrecht,Roda JC Kerkrade,4,4,3,1,1,8,0,7.0,7.0
13093,2002-2003,32,Willem II,SBV Excelsior,2,1,1,3,0,3,1,6.0,3.0
13094,2002-2003,32,RBC Roosendaal,NEC Nijmegen,0,2,2,0,3,2,-2,4.0,5.0
13095,2002-2003,32,FC Zwolle,sc Heerenveen,0,1,2,0,3,1,-1,4.0,10.0
13096,2002-2003,32,Vitesse,FC Twente,0,1,2,0,3,1,-1,8.0,7.0
13097,2002-2003,32,Feyenoord,PSV,3,1,1,3,0,4,2,15.0,10.0
13098,2002-2003,32,AFC Ajax,De Graafschap,7,1,1,3,0,8,6,15.0,3.0
13099,2002-2003,32,FC Groningen,AZ Alkmaar,1,0,1,3,0,1,1,5.0,5.0
13100,2002-2003,32,RKC Waalwijk,NAC Breda,2,3,2,0,3,5,-1,3.0,10.0
13101,2002-2003,33,sc Heerenveen,RBC Roosendaal,6,0,1,3,0,6,6,13.0,3.0
13102,2002-2003,33,Willem II,Feyenoord,1,1,3,1,1,2,0,4.0,13.0
13103,2002-2003,33,De Graafschap,FC Groningen,1,0,1,3,0,1,1,6.0,4.0
13104,2002-2003,33,SBV Excelsior,Vitesse,4,4,3,1,1,8,0,1.0,8.0
13105,2002-2003,33,FC Twente,AFC Ajax,1,2,2,0,3,3,-1,7.0,15.0
13106,2002-2003,33,Roda JC Kerkrade,RKC Waalwijk,1,0,1,3,0,1,1,10.0,3.0
13107,2002-2003,33,PSV,FC Utrecht,2,0,1,3,0,2,2,10.0,4.0
13108,2002-2003,33,NEC Nijmegen,FC Zwolle,0,0,3,1,1,0,0,5.0,5.0
13109,2002-2003,33,NAC Breda,AZ Alkmaar,4,0,1,3,0,4,4,12.0,4.0
13110,2002-2003,34,Feyenoord,Roda JC Kerkrade,3,1,1,3,0,4,2,13.0,7.0
13111,2002-2003,34,FC Groningen,PSV,0,0,3,1,1,0,0,5.0,8.0
13112,2002-2003,34,FC Utrecht,FC Twente,3,2,1,3,0,5,1,4.0,4.0
13113,2002-2003,34,AZ Alkmaar,SBV Excelsior,4,1,1,3,0,5,3,7.0,1.0
13114,2002-2003,34,Vitesse,Willem II,2,0,1,3,0,2,2,10.0,4.0
13115,2002-2003,34,AFC Ajax,sc Heerenveen,3,0,1,3,0,3,3,15.0,12.0
13116,2002-2003,34,RBC Roosendaal,NAC Breda,1,2,2,0,3,3,-1,3.0,12.0
13117,2002-2003,34,FC Zwolle,De Graafschap,2,1,1,3,0,3,1,8.0,6.0
13118,2002-2003,34,RKC Waalwijk,NEC Nijmegen,0,1,2,0,3,1,-1,0.0,8.0
13119,2003-2004,1,Roda JC Kerkrade,PSV,2,2,3,1,1,4,0,8.0,8.0
13120,2003-2004,1,Willem II,AZ Alkmaar,1,0,1,3,0,1,1,7.0,6.0
13121,2003-2004,1,RKC Waalwijk,ADO Den Haag,1,0,1,3,0,1,1,3.0,6.0
13122,2003-2004,1,FC Twente,RBC Roosendaal,3,1,1,3,0,4,2,7.0,0.0
13123,2003-2004,1,Feyenoord,NEC Nijmegen,2,1,1,3,0,3,1,13.0,7.0
13124,2003-2004,1,Vitesse,AFC Ajax,1,2,2,0,3,3,-1,7.0,15.0
13125,2003-2004,1,FC Groningen,NAC Breda,1,0,1,3,0,1,1,7.0,12.0
13126,2003-2004,1,FC Volendam,sc Heerenveen,0,1,2,0,3,1,-1,3.0,12.0
13127,2003-2004,1,FC Utrecht,FC Zwolle,1,0,1,3,0,1,1,7.0,5.0
13128,2003-2004,2,AZ Alkmaar,FC Twente,3,0,1,3,0,3,3,6.0,6.0
13129,2003-2004,2,ADO Den Haag,FC Utrecht,1,1,3,1,1,2,0,6.0,8.0
13130,2003-2004,2,PSV,Willem II,6,1,1,3,0,7,5,8.0,7.0
13131,2003-2004,2,NAC Breda,Vitesse,2,0,1,3,0,2,2,12.0,4.0
13132,2003-2004,2,sc Heerenveen,Feyenoord,1,0,1,3,0,1,1,12.0,10.0
13133,2003-2004,2,RBC Roosendaal,AFC Ajax,0,1,2,0,3,1,-1,0.0,15.0
13134,2003-2004,2,FC Zwolle,RKC Waalwijk,0,3,2,0,3,3,-3,4.0,6.0
13135,2003-2004,2,NEC Nijmegen,Roda JC Kerkrade,1,3,2,0,3,4,-2,7.0,8.0
13136,2003-2004,2,FC Volendam,FC Groningen,3,0,1,3,0,3,3,6.0,7.0
13137,2003-2004,3,Willem II,sc Heerenveen,2,0,1,3,0,2,2,7.0,9.0
13138,2003-2004,3,Vitesse,AZ Alkmaar,1,2,2,0,3,3,-1,4.0,9.0
13139,2003-2004,3,FC Twente,PSV,0,2,2,0,3,2,-2,3.0,11.0
13140,2003-2004,3,Roda JC Kerkrade,RBC Roosendaal,0,2,2,0,3,2,-2,7.0,3.0
13141,2003-2004,3,Feyenoord,NAC Breda,2,1,1,3,0,3,1,10.0,9.0
13142,2003-2004,3,FC Utrecht,NEC Nijmegen,0,1,2,0,3,1,-1,7.0,7.0
13143,2003-2004,3,AFC Ajax,FC Zwolle,1,0,1,3,0,1,1,15.0,4.0
13144,2003-2004,3,RKC Waalwijk,FC Volendam,3,0,1,3,0,3,3,9.0,6.0
13145,2003-2004,3,FC Groningen,ADO Den Haag,2,0,1,3,0,2,2,7.0,3.0
13146,2003-2004,4,ADO Den Haag,FC Volendam,1,1,3,1,1,2,0,3.0,4.0
13147,2003-2004,4,RBC Roosendaal,Vitesse,1,1,3,1,1,2,0,4.0,4.0
13148,2003-2004,4,FC Zwolle,Roda JC Kerkrade,0,0,3,1,1,0,0,4.0,5.0
13149,2003-2004,4,sc Heerenveen,FC Groningen,1,0,1,3,0,1,1,9.0,7.0
13150,2003-2004,4,PSV,FC Utrecht,2,1,1,3,0,3,1,11.0,7.0
13151,2003-2004,4,AFC Ajax,RKC Waalwijk,4,1,1,3,0,5,3,15.0,9.0
13152,2003-2004,4,AZ Alkmaar,Feyenoord,2,2,3,1,1,4,0,10.0,10.0
13153,2003-2004,4,NAC Breda,Willem II,1,1,3,1,1,2,0,7.0,7.0
13154,2003-2004,4,NEC Nijmegen,FC Twente,2,1,1,3,0,3,1,9.0,3.0
13155,2003-2004,5,FC Volendam,NEC Nijmegen,2,3,2,0,3,5,-1,4.0,9.0
13156,2003-2004,5,ADO Den Haag,RBC Roosendaal,1,2,2,0,3,3,-1,2.0,7.0
13157,2003-2004,5,Willem II,FC Zwolle,2,1,1,3,0,3,1,10.0,1.0
13158,2003-2004,5,AZ Alkmaar,sc Heerenveen,3,1,1,3,0,4,2,10.0,9.0
13159,2003-2004,5,Vitesse,Roda JC Kerkrade,1,1,3,1,1,2,0,2.0,6.0
13160,2003-2004,5,FC Twente,RKC Waalwijk,2,1,1,3,0,3,1,6.0,9.0
13161,2003-2004,5,Feyenoord,PSV,1,3,2,0,3,4,-2,7.0,13.0
13162,2003-2004,5,FC Groningen,FC Utrecht,1,1,3,1,1,2,0,7.0,5.0
13163,2003-2004,5,NAC Breda,AFC Ajax,4,2,1,3,0,6,2,7.0,12.0
13164,2003-2004,6,RBC Roosendaal,FC Volendam,1,1,3,1,1,2,0,8.0,5.0
13165,2003-2004,6,sc Heerenveen,FC Twente,3,0,1,3,0,3,3,9.0,3.0
13166,2003-2004,6,PSV,AZ Alkmaar,0,1,2,0,3,1,-1,12.0,13.0
13167,2003-2004,6,Roda JC Kerkrade,FC Groningen,0,0,3,1,1,0,0,6.0,5.0
13168,2003-2004,6,RKC Waalwijk,NAC Breda,2,0,1,3,0,2,2,9.0,7.0
13169,2003-2004,6,AFC Ajax,Willem II,6,0,1,3,0,6,6,12.0,7.0
13170,2003-2004,6,NEC Nijmegen,ADO Den Haag,1,2,2,0,3,3,-1,9.0,5.0
13171,2003-2004,6,FC Zwolle,Feyenoord,0,3,2,0,3,3,-3,1.0,7.0
13172,2003-2004,6,FC Utrecht,Vitesse,1,3,2,0,3,4,-2,2.0,5.0
13173,2003-2004,7,Vitesse,FC Twente,3,5,2,0,3,8,-2,5.0,6.0
13174,2003-2004,7,NAC Breda,FC Utrecht,1,2,2,0,3,3,-1,4.0,4.0
13175,2003-2004,7,ADO Den Haag,PSV,0,4,2,0,3,4,-4,4.0,12.0
13176,2003-2004,7,sc Heerenveen,RKC Waalwijk,1,0,1,3,0,1,1,9.0,6.0
13177,2003-2004,7,Willem II,Roda JC Kerkrade,0,2,2,0,3,2,-2,7.0,6.0
13178,2003-2004,7,AZ Alkmaar,NEC Nijmegen,2,0,1,3,0,2,2,13.0,9.0
13179,2003-2004,7,Feyenoord,RBC Roosendaal,2,0,1,3,0,2,2,10.0,8.0
13180,2003-2004,7,FC Groningen,AFC Ajax,1,3,2,0,3,4,-2,5.0,12.0
13181,2003-2004,7,FC Volendam,FC Zwolle,2,2,3,1,1,4,0,3.0,2.0
13182,2003-2004,8,AFC Ajax,FC Volendam,5,1,1,3,0,6,4,12.0,3.0
13183,2003-2004,8,PSV,sc Heerenveen,2,0,1,3,0,2,2,12.0,9.0
13184,2003-2004,8,RBC Roosendaal,Willem II,0,0,3,1,1,0,0,6.0,5.0
13185,2003-2004,8,RKC Waalwijk,Vitesse,2,2,3,1,1,4,0,4.0,6.0
13186,2003-2004,8,Roda JC Kerkrade,Feyenoord,1,1,3,1,1,2,0,7.0,8.0
13187,2003-2004,8,FC Zwolle,ADO Den Haag,1,2,2,0,3,3,-1,2.0,7.0
13188,2003-2004,8,FC Utrecht,AZ Alkmaar,0,3,2,0,3,3,-3,4.0,13.0
13189,2003-2004,8,NEC Nijmegen,NAC Breda,0,3,2,0,3,3,-3,6.0,7.0
13190,2003-2004,8,FC Twente,FC Groningen,5,3,1,3,0,8,2,9.0,2.0
13191,2003-2004,9,FC Volendam,Roda JC Kerkrade,2,1,1,3,0,3,1,5.0,6.0
13192,2003-2004,9,sc Heerenveen,NEC Nijmegen,1,2,2,0,3,3,-1,6.0,6.0
13193,2003-2004,9,ADO Den Haag,NAC Breda,1,1,3,1,1,2,0,7.0,7.0
13194,2003-2004,9,FC Groningen,Vitesse,2,1,1,3,0,3,1,5.0,5.0
13195,2003-2004,9,AZ Alkmaar,FC Zwolle,4,0,1,3,0,4,4,15.0,1.0
13196,2003-2004,9,RKC Waalwijk,RBC Roosendaal,1,2,2,0,3,3,-1,4.0,8.0
13197,2003-2004,9,PSV,AFC Ajax,2,2,3,1,1,4,0,10.0,10.0
13198,2003-2004,9,Feyenoord,Willem II,2,1,1,3,0,3,1,10.0,4.0
13199,2003-2004,9,FC Twente,FC Utrecht,2,2,3,1,1,4,0,10.0,5.0
13200,2003-2004,10,Roda JC Kerkrade,ADO Den Haag,5,1,1,3,0,6,4,8.0,7.0
13201,2003-2004,10,RBC Roosendaal,NEC Nijmegen,1,0,1,3,0,1,1,8.0,3.0
13202,2003-2004,10,NAC Breda,PSV,1,3,2,0,3,4,-2,4.0,10.0
13203,2003-2004,10,Vitesse,FC Volendam,2,2,3,1,1,4,0,5.0,6.0
13204,2003-2004,10,AFC Ajax,AZ Alkmaar,3,2,1,3,0,5,1,13.0,12.0
13205,2003-2004,10,FC Zwolle,FC Twente,1,0,1,3,0,1,1,4.0,7.0
13206,2003-2004,10,FC Utrecht,sc Heerenveen,2,1,1,3,0,3,1,7.0,6.0
13207,2003-2004,10,Willem II,RKC Waalwijk,4,1,1,3,0,5,3,4.0,4.0
13208,2003-2004,10,FC Groningen,Feyenoord,3,3,3,1,1,6,0,5.0,11.0
13209,2003-2004,11,Vitesse,Willem II,2,2,3,1,1,4,0,3.0,5.0
13210,2003-2004,11,NAC Breda,AZ Alkmaar,1,2,2,0,3,3,-1,4.0,12.0
13211,2003-2004,11,sc Heerenveen,FC Zwolle,1,1,3,1,1,2,0,4.0,5.0
13212,2003-2004,11,PSV,RBC Roosendaal,1,1,3,1,1,2,0,11.0,8.0
13213,2003-2004,11,Roda JC Kerkrade,FC Twente,2,1,1,3,0,3,1,10.0,7.0
13214,2003-2004,11,FC Volendam,Feyenoord,1,3,2,0,3,4,-2,5.0,11.0
13215,2003-2004,11,FC Utrecht,RKC Waalwijk,1,0,1,3,0,1,1,10.0,1.0
13216,2003-2004,11,NEC Nijmegen,FC Groningen,2,3,2,0,3,5,-1,3.0,7.0
13217,2003-2004,11,ADO Den Haag,AFC Ajax,1,4,2,0,3,5,-3,4.0,13.0
13218,2003-2004,12,RKC Waalwijk,FC Groningen,1,1,3,1,1,2,0,2.0,8.0
13219,2003-2004,12,FC Zwolle,NAC Breda,0,2,2,0,3,2,-2,4.0,7.0
13220,2003-2004,12,Willem II,FC Volendam,6,0,1,3,0,6,6,8.0,4.0
13221,2003-2004,12,NEC Nijmegen,PSV,2,3,2,0,3,5,-1,3.0,11.0
13222,2003-2004,12,AZ Alkmaar,Roda JC Kerkrade,1,5,2,0,3,6,-4,9.0,10.0
13223,2003-2004,12,Feyenoord,Vitesse,3,0,1,3,0,3,3,11.0,3.0
13224,2003-2004,12,FC Twente,ADO Den Haag,4,0,1,3,0,4,4,7.0,4.0
13225,2003-2004,12,AFC Ajax,sc Heerenveen,3,1,1,3,0,4,2,13.0,1.0
13226,2003-2004,12,RBC Roosendaal,FC Utrecht,1,1,3,1,1,2,0,9.0,8.0
13227,2003-2004,13,FC Groningen,RBC Roosendaal,2,0,1,3,0,2,2,11.0,8.0
13228,2003-2004,13,FC Zwolle,PSV,0,4,2,0,3,4,-4,4.0,11.0
13229,2003-2004,13,Willem II,NEC Nijmegen,3,0,1,3,0,3,3,10.0,3.0
13230,2003-2004,13,ADO Den Haag,Vitesse,1,1,3,1,1,2,0,2.0,3.0
13231,2003-2004,13,FC Twente,NAC Breda,2,1,1,3,0,3,1,7.0,4.0
13232,2003-2004,13,AFC Ajax,Feyenoord,2,0,1,3,0,2,2,13.0,10.0
13233,2003-2004,13,FC Utrecht,Roda JC Kerkrade,3,1,1,3,0,4,2,11.0,9.0
13234,2003-2004,13,RKC Waalwijk,AZ Alkmaar,1,1,3,1,1,2,0,2.0,7.0
13235,2003-2004,13,sc Heerenveen,ADO Den Haag,2,0,1,3,0,2,2,4.0,1.0
13236,2003-2004,14,FC Volendam,FC Twente,2,0,1,3,0,2,2,7.0,6.0
13237,2003-2004,14,Willem II,FC Utrecht,0,2,2,0,3,2,-2,10.0,13.0
13238,2003-2004,14,PSV,FC Volendam,7,0,1,3,0,7,7,13.0,4.0
13239,2003-2004,14,NEC Nijmegen,RKC Waalwijk,1,1,3,1,1,2,0,1.0,3.0
13240,2003-2004,14,Vitesse,FC Zwolle,5,2,1,3,0,7,3,6.0,4.0
13241,2003-2004,14,Feyenoord,ADO Den Haag,4,1,1,3,0,5,3,10.0,1.0
13242,2003-2004,14,RBC Roosendaal,AZ Alkmaar,1,0,1,3,0,1,1,8.0,4.0
13243,2003-2004,14,NAC Breda,sc Heerenveen,2,3,2,0,3,5,-1,3.0,7.0
13244,2003-2004,14,Roda JC Kerkrade,AFC Ajax,1,2,2,0,3,3,-1,9.0,15.0
13245,2003-2004,15,Roda JC Kerkrade,NAC Breda,2,2,3,1,1,4,0,7.0,4.0
13246,2003-2004,15,RBC Roosendaal,sc Heerenveen,1,1,3,1,1,2,0,6.0,8.0
13247,2003-2004,15,ADO Den Haag,Willem II,0,1,2,0,3,1,-1,1.0,10.0
13248,2003-2004,15,PSV,RKC Waalwijk,3,1,1,3,0,4,2,13.0,3.0
13249,2003-2004,15,FC Twente,Feyenoord,4,2,1,3,0,6,2,9.0,9.0
13250,2003-2004,15,FC Volendam,AZ Alkmaar,0,6,2,0,3,6,-6,3.0,7.0
13251,2003-2004,15,AFC Ajax,FC Utrecht,1,0,1,3,0,1,1,15.0,10.0
13252,2003-2004,15,FC Zwolle,FC Groningen,1,1,3,1,1,2,0,2.0,9.0
13253,2003-2004,15,NEC Nijmegen,Vitesse,2,0,1,3,0,2,2,4.0,5.0
13254,2003-2004,16,AZ Alkmaar,FC Groningen,2,1,1,3,0,3,1,7.0,8.0
13255,2003-2004,16,sc Heerenveen,Roda JC Kerkrade,2,1,1,3,0,3,1,10.0,4.0
13256,2003-2004,16,Vitesse,PSV,0,0,3,1,1,0,0,5.0,13.0
13257,2003-2004,16,NAC Breda,RBC Roosendaal,3,2,1,3,0,5,1,7.0,5.0
13258,2003-2004,16,NEC Nijmegen,FC Zwolle,1,0,1,3,0,1,1,7.0,1.0
13259,2003-2004,16,FC Twente,AFC Ajax,2,0,1,3,0,2,2,12.0,12.0
13260,2003-2004,16,RKC Waalwijk,Feyenoord,0,0,3,1,1,0,0,4.0,7.0
13261,2003-2004,16,FC Groningen,Willem II,1,2,2,0,3,3,-1,5.0,12.0
13262,2003-2004,16,FC Utrecht,FC Volendam,3,0,1,3,0,3,3,10.0,3.0
13263,2003-2004,17,AZ Alkmaar,ADO Den Haag,0,1,2,0,3,1,-1,7.0,4.0
13264,2003-2004,17,FC Zwolle,RBC Roosendaal,0,3,2,0,3,3,-3,1.0,7.0
13265,2003-2004,17,NAC Breda,FC Volendam,3,2,1,3,0,5,1,7.0,3.0
13266,2003-2004,17,Roda JC Kerkrade,RKC Waalwijk,2,1,1,3,0,3,1,4.0,3.0
13267,2003-2004,17,Willem II,FC Twente,2,3,2,0,3,5,-1,9.0,12.0
13268,2003-2004,17,Vitesse,sc Heerenveen,0,1,2,0,3,1,-1,5.0,13.0
13269,2003-2004,17,FC Groningen,PSV,0,2,2,0,3,2,-2,4.0,13.0
13270,2003-2004,17,Feyenoord,FC Utrecht,3,2,1,3,0,5,1,7.0,9.0
13271,2003-2004,17,AFC Ajax,NEC Nijmegen,1,0,1,3,0,1,1,12.0,7.0
13272,2003-2004,18,AZ Alkmaar,Willem II,0,0,3,1,1,0,0,7.0,7.0
13273,2003-2004,18,FC Volendam,RKC Waalwijk,0,4,2,0,3,4,-4,0.0,5.0
13274,2003-2004,18,FC Utrecht,RBC Roosendaal,0,1,2,0,3,1,-1,6.0,10.0
13275,2003-2004,18,NEC Nijmegen,Feyenoord,1,2,2,0,3,3,-1,7.0,10.0
13276,2003-2004,18,PSV,FC Zwolle,5,1,1,3,0,6,4,13.0,1.0
13277,2003-2004,18,FC Twente,Vitesse,0,0,3,1,1,0,0,10.0,5.0
13278,2003-2004,18,ADO Den Haag,Roda JC Kerkrade,1,0,1,3,0,1,1,6.0,4.0
13279,2003-2004,18,sc Heerenveen,AFC Ajax,4,1,1,3,0,5,3,13.0,9.0
13280,2003-2004,18,NAC Breda,FC Groningen,1,1,3,1,1,2,0,8.0,2.0
13281,2003-2004,19,Roda JC Kerkrade,AZ Alkmaar,3,1,1,3,0,4,2,7.0,7.0
13282,2003-2004,19,PSV,Vitesse,3,0,1,3,0,3,3,13.0,2.0
13283,2003-2004,19,RKC Waalwijk,NEC Nijmegen,1,2,2,0,3,3,-1,4.0,9.0
13284,2003-2004,19,Feyenoord,FC Twente,3,2,1,3,0,5,1,10.0,10.0
13285,2003-2004,19,AFC Ajax,ADO Den Haag,4,0,1,3,0,4,4,9.0,6.0
13286,2003-2004,19,Willem II,NAC Breda,1,1,3,1,1,2,0,8.0,9.0
13287,2003-2004,19,FC Groningen,FC Volendam,0,1,2,0,3,1,-1,1.0,3.0
13288,2003-2004,19,FC Zwolle,FC Utrecht,1,1,3,1,1,2,0,2.0,4.0
13289,2003-2004,19,ADO Den Haag,FC Groningen,3,1,1,3,0,4,2,9.0,1.0
13290,2003-2004,20,RBC Roosendaal,RKC Waalwijk,1,3,2,0,3,4,-2,7.0,7.0
13291,2003-2004,20,sc Heerenveen,NAC Breda,3,4,2,0,3,7,-1,10.0,11.0
13292,2003-2004,20,FC Twente,FC Zwolle,2,0,1,3,0,2,2,10.0,1.0
13293,2003-2004,20,AZ Alkmaar,FC Volendam,3,0,1,3,0,3,3,7.0,3.0
13294,2003-2004,20,AFC Ajax,PSV,2,1,1,3,0,3,1,9.0,10.0
13295,2003-2004,20,FC Groningen,NEC Nijmegen,2,0,1,3,0,2,2,4.0,6.0
13296,2003-2004,20,Willem II,ADO Den Haag,1,0,1,3,0,1,1,8.0,9.0
13297,2003-2004,20,Vitesse,Feyenoord,0,0,3,1,1,0,0,3.0,11.0
13298,2003-2004,20,Feyenoord,AZ Alkmaar,0,3,2,0,3,3,-3,10.0,7.0
13299,2003-2004,21,RKC Waalwijk,sc Heerenveen,0,0,3,1,1,0,0,7.0,10.0
13300,2003-2004,21,PSV,FC Twente,1,0,1,3,0,1,1,12.0,7.0
13301,2003-2004,21,NAC Breda,Roda JC Kerkrade,0,0,3,1,1,0,0,9.0,7.0
13302,2003-2004,21,sc Heerenveen,Willem II,1,1,3,1,1,2,0,8.0,6.0
13303,2003-2004,21,Vitesse,RBC Roosendaal,1,2,2,0,3,3,-1,2.0,9.0
13304,2003-2004,21,ADO Den Haag,Feyenoord,2,2,3,1,1,4,0,7.0,8.0
13305,2003-2004,21,NEC Nijmegen,FC Utrecht,4,0,1,3,0,4,4,6.0,4.0
13306,2003-2004,21,RKC Waalwijk,FC Zwolle,2,0,1,3,0,2,2,10.0,1.0
13307,2003-2004,21,FC Volendam,AFC Ajax,0,2,2,0,3,2,-2,3.0,12.0
13308,2003-2004,22,RBC Roosendaal,Roda JC Kerkrade,1,4,2,0,3,5,-3,9.0,10.0
13309,2003-2004,22,FC Utrecht,Willem II,2,2,3,1,1,4,0,2.0,7.0
13310,2003-2004,22,Roda JC Kerkrade,FC Volendam,1,0,1,3,0,1,1,10.0,3.0
13311,2003-2004,22,sc Heerenveen,PSV,3,2,1,3,0,5,1,8.0,9.0
13312,2003-2004,22,FC Zwolle,NEC Nijmegen,2,1,1,3,0,3,1,4.0,6.0
13313,2003-2004,22,AZ Alkmaar,RBC Roosendaal,2,1,1,3,0,3,1,10.0,6.0
13314,2003-2004,22,Vitesse,FC Groningen,1,2,2,0,3,3,-1,2.0,7.0
13315,2003-2004,22,FC Utrecht,NAC Breda,1,2,2,0,3,3,-1,2.0,9.0
13316,2003-2004,22,AFC Ajax,FC Twente,1,0,1,3,0,1,1,12.0,4.0
13317,2003-2004,23,FC Zwolle,Vitesse,1,1,3,1,1,2,0,5.0,2.0
13318,2003-2004,23,RBC Roosendaal,NAC Breda,1,1,3,1,1,2,0,4.0,9.0
13319,2003-2004,23,NEC Nijmegen,sc Heerenveen,1,2,2,0,3,3,-1,6.0,8.0
13320,2003-2004,23,FC Twente,AZ Alkmaar,4,1,1,3,0,5,3,6.0,9.0
13321,2003-2004,23,FC Utrecht,AFC Ajax,1,0,1,3,0,1,1,5.0,12.0
13322,2003-2004,23,PSV,Roda JC Kerkrade,1,2,2,0,3,3,-1,6.0,13.0
13323,2003-2004,23,FC Groningen,RKC Waalwijk,1,2,2,0,3,3,-1,6.0,10.0
13324,2003-2004,23,FC Volendam,ADO Den Haag,0,2,2,0,3,2,-2,3.0,7.0
13325,2003-2004,23,Willem II,Feyenoord,0,3,2,0,3,3,-3,6.0,8.0
13326,2003-2004,24,NAC Breda,FC Twente,0,1,2,0,3,1,-1,8.0,9.0
13327,2003-2004,24,Roda JC Kerkrade,FC Zwolle,1,1,3,1,1,2,0,11.0,5.0
13328,2003-2004,24,Willem II,FC Groningen,2,0,1,3,0,2,2,8.0,6.0
13329,2003-2004,24,RKC Waalwijk,AFC Ajax,0,1,2,0,3,1,-1,10.0,12.0
13330,2003-2004,24,ADO Den Haag,AZ Alkmaar,2,3,2,0,3,5,-1,7.0,12.0
13331,2003-2004,24,NEC Nijmegen,RBC Roosendaal,1,2,2,0,3,3,-1,3.0,7.0
13332,2003-2004,24,FC Utrecht,PSV,0,4,2,0,3,4,-4,4.0,6.0
13333,2003-2004,24,FC Volendam,Vitesse,0,0,3,1,1,0,0,1.0,3.0
13334,2003-2004,24,Feyenoord,sc Heerenveen,2,2,3,1,1,4,0,6.0,9.0
13335,2003-2004,25,FC Twente,NEC Nijmegen,2,5,2,0,3,7,-3,6.0,6.0
13336,2003-2004,25,NAC Breda,FC Zwolle,3,1,1,3,0,4,2,8.0,5.0
13337,2003-2004,25,sc Heerenveen,FC Volendam,2,1,1,3,0,3,1,11.0,1.0
13338,2003-2004,25,RBC Roosendaal,FC Groningen,1,0,1,3,0,1,1,7.0,6.0
13339,2003-2004,25,AZ Alkmaar,FC Utrecht,1,2,2,0,3,3,-1,9.0,7.0
13340,2003-2004,25,PSV,Feyenoord,0,1,2,0,3,1,-1,6.0,8.0
13341,2003-2004,25,RKC Waalwijk,Willem II,1,1,3,1,1,2,0,8.0,6.0
13342,2003-2004,25,AFC Ajax,Roda JC Kerkrade,4,2,1,3,0,6,2,12.0,10.0
13343,2003-2004,25,Vitesse,ADO Den Haag,1,0,1,3,0,1,1,5.0,4.0
13344,2003-2004,26,FC Groningen,sc Heerenveen,0,0,3,1,1,0,0,4.0,11.0
13345,2003-2004,26,FC Zwolle,FC Volendam,3,0,1,3,0,3,3,8.0,1.0
13346,2003-2004,26,Roda JC Kerkrade,Willem II,6,1,1,3,0,7,5,10.0,5.0
13347,2003-2004,26,PSV,NAC Breda,1,1,3,1,1,2,0,4.0,8.0
13348,2003-2004,26,NEC Nijmegen,AZ Alkmaar,0,2,2,0,3,2,-2,3.0,9.0
13349,2003-2004,26,Feyenoord,RKC Waalwijk,1,0,1,3,0,1,1,11.0,7.0
13350,2003-2004,26,AFC Ajax,Vitesse,5,0,1,3,0,5,5,12.0,5.0
13351,2003-2004,26,FC Utrecht,FC Twente,2,0,1,3,0,2,2,9.0,6.0
13352,2003-2004,26,RBC Roosendaal,ADO Den Haag,0,0,3,1,1,0,0,8.0,5.0
13353,2003-2004,27,ADO Den Haag,FC Zwolle,1,1,3,1,1,2,0,5.0,6.0
13354,2003-2004,27,NAC Breda,NEC Nijmegen,5,2,1,3,0,7,3,8.0,3.0
13355,2003-2004,27,sc Heerenveen,RBC Roosendaal,1,0,1,3,0,1,1,11.0,8.0
13356,2003-2004,27,Vitesse,RKC Waalwijk,3,3,3,1,1,6,0,6.0,5.0
13357,2003-2004,27,AZ Alkmaar,AFC Ajax,1,1,3,1,1,2,0,7.0,10.0
13358,2003-2004,27,FC Volendam,FC Utrecht,1,2,2,0,3,3,-1,1.0,12.0
13359,2003-2004,27,Willem II,PSV,3,1,1,3,0,4,2,7.0,4.0
13360,2003-2004,27,Feyenoord,Roda JC Kerkrade,3,0,1,3,0,3,3,13.0,7.0
13361,2003-2004,27,FC Groningen,FC Twente,1,0,1,3,0,1,1,4.0,6.0
13362,2003-2004,28,NEC Nijmegen,Willem II,4,0,1,3,0,4,4,6.0,7.0
13363,2003-2004,28,RKC Waalwijk,PSV,0,4,2,0,3,4,-4,2.0,7.0
13364,2003-2004,28,RBC Roosendaal,FC Zwolle,1,1,3,1,1,2,0,8.0,6.0
13365,2003-2004,28,Roda JC Kerkrade,sc Heerenveen,0,1,2,0,3,1,-1,4.0,11.0
13366,2003-2004,28,FC Twente,FC Volendam,1,2,2,0,3,3,-1,3.0,4.0
13367,2003-2004,28,AZ Alkmaar,Vitesse,2,1,1,3,0,3,1,10.0,5.0
13368,2003-2004,28,NAC Breda,Feyenoord,0,3,2,0,3,3,-3,7.0,13.0
13369,2003-2004,28,FC Utrecht,ADO Den Haag,5,3,1,3,0,8,2,12.0,2.0
13370,2003-2004,28,AFC Ajax,FC Groningen,2,1,1,3,0,3,1,13.0,4.0
13371,2003-2004,29,Roda JC Kerkrade,NEC Nijmegen,4,0,1,3,0,4,4,6.0,6.0
13372,2003-2004,29,sc Heerenveen,FC Utrecht,4,0,1,3,0,4,4,13.0,12.0
13373,2003-2004,29,ADO Den Haag,RKC Waalwijk,1,3,2,0,3,4,-2,2.0,5.0
13374,2003-2004,29,FC Zwolle,AZ Alkmaar,2,0,1,3,0,2,2,8.0,7.0
13375,2003-2004,29,FC Volendam,Willem II,0,1,2,0,3,1,-1,3.0,7.0
13376,2003-2004,29,Feyenoord,AFC Ajax,1,1,3,1,1,2,0,13.0,11.0
13377,2003-2004,29,PSV,FC Groningen,5,0,1,3,0,5,5,7.0,4.0
13378,2003-2004,29,Vitesse,NAC Breda,2,2,3,1,1,4,0,5.0,8.0
13379,2003-2004,29,RBC Roosendaal,FC Twente,1,2,2,0,3,3,-1,5.0,3.0
13380,2003-2004,30,Willem II,Vitesse,1,1,3,1,1,2,0,7.0,3.0
13381,2003-2004,30,PSV,NEC Nijmegen,3,0,1,3,0,3,3,10.0,3.0
13382,2003-2004,30,FC Zwolle,sc Heerenveen,1,0,1,3,0,1,1,11.0,10.0
13383,2003-2004,30,RKC Waalwijk,Roda JC Kerkrade,1,1,3,1,1,2,0,5.0,7.0
13384,2003-2004,30,ADO Den Haag,FC Twente,1,0,1,3,0,1,1,5.0,3.0
13385,2003-2004,30,FC Utrecht,Feyenoord,0,3,2,0,3,3,-3,9.0,13.0
13386,2003-2004,30,FC Groningen,AZ Alkmaar,1,1,3,1,1,2,0,5.0,8.0
13387,2003-2004,30,FC Volendam,NAC Breda,4,2,1,3,0,6,2,6.0,5.0
13388,2003-2004,30,AFC Ajax,RBC Roosendaal,1,1,3,1,1,2,0,9.0,3.0
13389,2003-2004,31,Roda JC Kerkrade,FC Utrecht,1,1,3,1,1,2,0,5.0,7.0
13390,2003-2004,31,sc Heerenveen,Vitesse,0,0,3,1,1,0,0,10.0,4.0
13391,2003-2004,31,RBC Roosendaal,PSV,0,3,2,0,3,3,-3,2.0,12.0
13392,2003-2004,31,AZ Alkmaar,RKC Waalwijk,7,0,1,3,0,7,7,8.0,5.0
13393,2003-2004,31,FC Twente,Willem II,2,0,1,3,0,2,2,6.0,7.0
13394,2003-2004,31,NEC Nijmegen,AFC Ajax,0,0,3,1,1,0,0,4.0,7.0
13395,2003-2004,31,NAC Breda,ADO Den Haag,1,0,1,3,0,1,1,7.0,4.0
13396,2003-2004,31,FC Groningen,FC Zwolle,2,2,3,1,1,4,0,5.0,9.0
13397,2003-2004,31,Feyenoord,FC Volendam,2,0,1,3,0,2,2,13.0,6.0
13398,2003-2004,32,Willem II,RBC Roosendaal,3,0,1,3,0,3,3,7.0,2.0
13399,2003-2004,32,ADO Den Haag,sc Heerenveen,1,0,1,3,0,1,1,6.0,7.0
13400,2003-2004,32,AZ Alkmaar,NAC Breda,2,2,3,1,1,4,0,8.0,5.0
13401,2003-2004,32,FC Twente,Roda JC Kerkrade,1,2,2,0,3,3,-1,6.0,8.0
13402,2003-2004,32,FC Zwolle,AFC Ajax,0,5,2,0,3,5,-5,8.0,9.0
13403,2003-2004,32,FC Volendam,PSV,0,5,2,0,3,5,-5,6.0,15.0
13404,2003-2004,32,RKC Waalwijk,FC Utrecht,1,0,1,3,0,1,1,7.0,4.0
13405,2003-2004,32,Feyenoord,FC Groningen,1,2,2,0,3,3,-1,10.0,5.0
13406,2003-2004,32,Vitesse,NEC Nijmegen,2,2,3,1,1,4,0,4.0,5.0
13407,2003-2004,33,RKC Waalwijk,FC Twente,3,3,3,1,1,6,0,8.0,7.0
13408,2003-2004,33,RBC Roosendaal,Feyenoord,1,4,2,0,3,5,-3,1.0,10.0
13409,2003-2004,33,FC Zwolle,Willem II,0,0,3,1,1,0,0,8.0,8.0
13410,2003-2004,33,FC Utrecht,FC Groningen,2,0,1,3,0,2,2,4.0,5.0
13411,2003-2004,33,sc Heerenveen,AZ Alkmaar,1,0,1,3,0,1,1,7.0,5.0
13412,2003-2004,33,NEC Nijmegen,FC Volendam,1,1,3,1,1,2,0,3.0,4.0
13413,2003-2004,33,PSV,ADO Den Haag,3,2,1,3,0,5,1,15.0,6.0
13414,2003-2004,33,AFC Ajax,NAC Breda,2,0,1,3,0,2,2,9.0,5.0
13415,2003-2004,33,Roda JC Kerkrade,Vitesse,2,0,1,3,0,2,2,11.0,4.0
13416,2003-2004,34,ADO Den Haag,NEC Nijmegen,4,1,1,3,0,5,3,9.0,3.0
13417,2003-2004,34,FC Groningen,Roda JC Kerkrade,2,2,3,1,1,4,0,6.0,9.0
13418,2003-2004,34,FC Volendam,RBC Roosendaal,2,1,1,3,0,3,1,7.0,1.0
13419,2003-2004,34,NAC Breda,RKC Waalwijk,5,3,1,3,0,8,2,7.0,5.0
13420,2003-2004,34,Willem II,AFC Ajax,2,5,2,0,3,7,-3,5.0,11.0
13421,2003-2004,34,AZ Alkmaar,PSV,2,4,2,0,3,6,-2,5.0,15.0
13422,2003-2004,34,Feyenoord,FC Zwolle,7,1,1,3,0,8,6,12.0,5.0
13423,2003-2004,34,Vitesse,FC Utrecht,3,0,1,3,0,3,3,6.0,4.0
13424,2003-2004,34,FC Twente,sc Heerenveen,2,0,1,3,0,2,2,7.0,4.0
13425,2004-2005,1,Roda JC Kerkrade,Vitesse,2,3,2,0,3,5,-1,8.0,8.0
13426,2004-2005,1,RBC Roosendaal,PSV,2,5,2,0,3,7,-3,0.0,15.0
13427,2004-2005,1,NAC Breda,FC Utrecht,3,2,1,3,0,5,1,10.0,4.0
13428,2004-2005,1,NEC Nijmegen,Willem II,2,0,1,3,0,2,2,6.0,4.0
13429,2004-2005,1,AZ Alkmaar,sc Heerenveen,1,1,3,1,1,2,0,5.0,5.0
13430,2004-2005,1,FC Twente,AFC Ajax,2,3,2,0,3,5,-1,7.0,13.0
13431,2004-2005,1,FC Den Bosch,ADO Den Haag,1,0,1,3,0,1,1,6.0,6.0
13432,2004-2005,1,Feyenoord,De Graafschap,6,1,1,3,0,7,5,12.0,3.0
13433,2004-2005,1,FC Groningen,RKC Waalwijk,0,0,3,1,1,0,0,6.0,5.0
13434,2004-2005,2,Vitesse,FC Groningen,1,0,1,3,0,1,1,10.0,5.0
13435,2004-2005,2,PSV,AZ Alkmaar,5,1,1,3,0,6,4,15.0,2.0
13436,2004-2005,2,sc Heerenveen,Roda JC Kerkrade,3,4,2,0,3,7,-1,4.0,10.0
13437,2004-2005,2,ADO Den Haag,NEC Nijmegen,1,2,2,0,3,3,-1,6.0,8.0
13438,2004-2005,2,RKC Waalwijk,FC Twente,1,0,1,3,0,1,1,8.0,4.0
13439,2004-2005,2,Willem II,Feyenoord,0,4,2,0,3,4,-4,4.0,12.0
13440,2004-2005,2,AFC Ajax,NAC Breda,6,2,1,3,0,8,4,15.0,7.0
13441,2004-2005,2,De Graafschap,FC Den Bosch,1,1,3,1,1,2,0,4.0,7.0
13442,2004-2005,2,FC Utrecht,RBC Roosendaal,5,1,1,3,0,6,4,6.0,0.0
13443,2004-2005,3,FC Den Bosch,Willem II,1,2,2,0,3,3,-1,4.0,4.0
13444,2004-2005,3,Roda JC Kerkrade,De Graafschap,2,1,1,3,0,3,1,10.0,4.0
13445,2004-2005,3,NAC Breda,PSV,2,2,3,1,1,4,0,7.0,13.0
13446,2004-2005,3,FC Twente,sc Heerenveen,4,1,1,3,0,5,3,7.0,4.0
13447,2004-2005,3,NEC Nijmegen,AZ Alkmaar,1,2,2,0,3,3,-1,7.0,4.0
13448,2004-2005,3,Vitesse,Feyenoord,1,1,3,1,1,2,0,10.0,13.0
13449,2004-2005,3,AFC Ajax,FC Utrecht,1,1,3,1,1,2,0,13.0,7.0
13450,2004-2005,3,RBC Roosendaal,FC Groningen,2,2,3,1,1,4,0,1.0,3.0
13451,2004-2005,3,RKC Waalwijk,ADO Den Haag,1,3,2,0,3,4,-2,5.0,6.0
13452,2004-2005,4,AZ Alkmaar,FC Den Bosch,5,0,1,3,0,5,5,7.0,4.0
13453,2004-2005,4,RBC Roosendaal,Vitesse,4,1,1,3,0,5,3,4.0,10.0
13454,2004-2005,4,sc Heerenveen,De Graafschap,2,0,1,3,0,2,2,4.0,1.0
13455,2004-2005,4,PSV,RKC Waalwijk,1,0,1,3,0,1,1,13.0,4.0
13456,2004-2005,4,Willem II,Roda JC Kerkrade,3,1,1,3,0,4,2,6.0,7.0
13457,2004-2005,4,ADO Den Haag,AFC Ajax,3,3,3,1,1,6,0,7.0,11.0
13458,2004-2005,4,FC Groningen,NAC Breda,2,3,2,0,3,5,-1,3.0,10.0
13459,2004-2005,4,Feyenoord,FC Twente,3,1,1,3,0,4,2,13.0,6.0
13460,2004-2005,4,FC Utrecht,NEC Nijmegen,1,0,1,3,0,1,1,7.0,6.0
13461,2004-2005,5,ADO Den Haag,Vitesse,0,4,2,0,3,4,-4,4.0,10.0
13462,2004-2005,5,NEC Nijmegen,PSV,0,3,2,0,3,3,-3,6.0,13.0
13463,2004-2005,5,De Graafschap,FC Groningen,2,2,3,1,1,4,0,2.0,3.0
13464,2004-2005,5,sc Heerenveen,NAC Breda,3,0,1,3,0,3,3,7.0,7.0
13465,2004-2005,5,RKC Waalwijk,RBC Roosendaal,2,0,1,3,0,2,2,7.0,4.0
13466,2004-2005,5,FC Twente,Willem II,0,0,3,1,1,0,0,4.0,7.0
13467,2004-2005,5,Feyenoord,FC Utrecht,0,3,2,0,3,3,-3,10.0,10.0
13468,2004-2005,5,Roda JC Kerkrade,AZ Alkmaar,1,1,3,1,1,2,0,7.0,8.0
13469,2004-2005,5,FC Den Bosch,AFC Ajax,0,5,2,0,3,5,-5,4.0,11.0
13470,2004-2005,6,RBC Roosendaal,Feyenoord,0,4,2,0,3,4,-4,4.0,10.0
13471,2004-2005,6,PSV,sc Heerenveen,4,0,1,3,0,4,4,13.0,6.0
13472,2004-2005,6,Vitesse,FC Den Bosch,0,0,3,1,1,0,0,8.0,2.0
13473,2004-2005,6,AZ Alkmaar,Willem II,3,1,1,3,0,4,2,10.0,7.0
13474,2004-2005,6,AFC Ajax,Roda JC Kerkrade,1,0,1,3,0,1,1,11.0,7.0
13475,2004-2005,6,FC Utrecht,ADO Den Haag,2,0,1,3,0,2,2,13.0,4.0
13476,2004-2005,6,NAC Breda,RKC Waalwijk,0,4,2,0,3,4,-4,4.0,9.0
13477,2004-2005,6,De Graafschap,FC Twente,0,0,3,1,1,0,0,3.0,5.0
13478,2004-2005,6,FC Groningen,NEC Nijmegen,0,0,3,1,1,0,0,3.0,4.0
13479,2004-2005,7,NEC Nijmegen,RBC Roosendaal,3,0,1,3,0,3,3,4.0,4.0
13480,2004-2005,7,PSV,FC Groningen,3,0,1,3,0,3,3,13.0,3.0
13481,2004-2005,7,NAC Breda,De Graafschap,3,2,1,3,0,5,1,7.0,2.0
13482,2004-2005,7,Willem II,Vitesse,3,2,1,3,0,5,1,10.0,5.0
13483,2004-2005,7,FC Twente,Roda JC Kerkrade,2,3,2,0,3,5,-1,5.0,7.0
13484,2004-2005,7,AZ Alkmaar,AFC Ajax,0,0,3,1,1,0,0,11.0,9.0
13485,2004-2005,7,sc Heerenveen,ADO Den Haag,1,0,1,3,0,1,1,9.0,4.0
13486,2004-2005,7,Feyenoord,FC Den Bosch,4,2,1,3,0,6,2,10.0,1.0
13487,2004-2005,7,FC Utrecht,RKC Waalwijk,3,2,1,3,0,5,1,13.0,6.0
13488,2004-2005,8,De Graafschap,AZ Alkmaar,1,3,2,0,3,4,-2,2.0,11.0
13489,2004-2005,8,ADO Den Haag,PSV,0,2,2,0,3,2,-2,1.0,15.0
13490,2004-2005,8,FC Den Bosch,RBC Roosendaal,2,1,1,3,0,3,1,4.0,3.0
13491,2004-2005,8,AFC Ajax,sc Heerenveen,1,3,2,0,3,4,-2,8.0,12.0
13492,2004-2005,8,Roda JC Kerkrade,Feyenoord,0,2,2,0,3,2,-2,4.0,12.0
13493,2004-2005,8,FC Groningen,FC Utrecht,3,0,1,3,0,3,3,5.0,12.0
13494,2004-2005,8,Vitesse,NAC Breda,1,2,2,0,3,3,-1,4.0,9.0
13495,2004-2005,8,RKC Waalwijk,NEC Nijmegen,2,2,3,1,1,4,0,7.0,5.0
13496,2004-2005,8,De Graafschap,Willem II,2,2,3,1,1,4,0,3.0,8.0
13497,2004-2005,9,Willem II,FC Groningen,4,2,1,3,0,6,2,8.0,5.0
13498,2004-2005,9,RBC Roosendaal,FC Twente,0,1,2,0,3,1,-1,0.0,5.0
13499,2004-2005,9,Vitesse,AZ Alkmaar,0,3,2,0,3,3,-3,4.0,11.0
13500,2004-2005,9,NEC Nijmegen,NAC Breda,3,3,3,1,1,6,0,6.0,7.0
13501,2004-2005,9,PSV,AFC Ajax,2,0,1,3,0,2,2,15.0,7.0
13502,2004-2005,9,sc Heerenveen,FC Utrecht,2,1,1,3,0,3,1,12.0,9.0
13503,2004-2005,9,Roda JC Kerkrade,FC Den Bosch,5,0,1,3,0,5,5,7.0,4.0
13504,2004-2005,9,Feyenoord,RKC Waalwijk,4,0,1,3,0,4,4,12.0,7.0
13505,2004-2005,9,De Graafschap,ADO Den Haag,1,2,2,0,3,3,-1,2.0,3.0
13506,2004-2005,10,ADO Den Haag,FC Twente,0,1,2,0,3,1,-1,3.0,8.0
13507,2004-2005,10,FC Utrecht,PSV,0,0,3,1,1,0,0,7.0,13.0
13508,2004-2005,10,Willem II,RBC Roosendaal,3,0,1,3,0,3,3,10.0,0.0
13509,2004-2005,10,Roda JC Kerkrade,RKC Waalwijk,1,1,3,1,1,2,0,7.0,5.0
13510,2004-2005,10,FC Twente,Vitesse,1,4,2,0,3,5,-3,7.0,4.0
13511,2004-2005,10,AZ Alkmaar,Feyenoord,4,1,1,3,0,5,3,13.0,12.0
13512,2004-2005,10,FC Groningen,ADO Den Haag,4,3,1,3,0,7,1,7.0,3.0
13513,2004-2005,10,FC Den Bosch,sc Heerenveen,2,4,2,0,3,6,-2,4.0,12.0
13514,2004-2005,10,AFC Ajax,NEC Nijmegen,1,0,1,3,0,1,1,7.0,6.0
13515,2004-2005,11,NAC Breda,Roda JC Kerkrade,4,0,1,3,0,4,4,10.0,7.0
13516,2004-2005,11,RBC Roosendaal,De Graafschap,3,0,1,3,0,3,3,3.0,1.0
13517,2004-2005,11,RKC Waalwijk,sc Heerenveen,0,0,3,1,1,0,0,3.0,13.0
13518,2004-2005,11,Willem II,AFC Ajax,1,3,2,0,3,4,-2,10.0,7.0
13519,2004-2005,11,AZ Alkmaar,FC Utrecht,4,0,1,3,0,4,4,13.0,4.0
13520,2004-2005,11,Vitesse,NEC Nijmegen,1,0,1,3,0,1,1,6.0,5.0
13521,2004-2005,11,FC Den Bosch,PSV,0,3,2,0,3,3,-3,3.0,13.0
13522,2004-2005,11,Feyenoord,NAC Breda,4,0,1,3,0,4,4,12.0,10.0
13523,2004-2005,11,FC Twente,FC Groningen,1,2,2,0,3,3,-1,6.0,9.0
13524,2004-2005,12,ADO Den Haag,RBC Roosendaal,5,1,1,3,0,6,4,6.0,3.0
13525,2004-2005,12,PSV,Willem II,1,0,1,3,0,1,1,13.0,7.0
13526,2004-2005,12,NAC Breda,AZ Alkmaar,0,3,2,0,3,3,-3,7.0,15.0
13527,2004-2005,12,sc Heerenveen,Vitesse,0,3,2,0,3,3,-3,10.0,9.0
13528,2004-2005,12,NEC Nijmegen,FC Twente,0,2,2,0,3,2,-2,2.0,9.0
13529,2004-2005,12,AFC Ajax,Feyenoord,1,1,3,1,1,2,0,7.0,10.0
13530,2004-2005,12,FC Utrecht,Roda JC Kerkrade,1,1,3,1,1,2,0,2.0,5.0
13531,2004-2005,12,RKC Waalwijk,De Graafschap,2,2,3,1,1,4,0,4.0,2.0
13532,2004-2005,12,FC Groningen,FC Den Bosch,3,1,1,3,0,4,2,12.0,3.0
13533,2004-2005,13,Roda JC Kerkrade,ADO Den Haag,1,1,3,1,1,2,0,6.0,7.0
13534,2004-2005,13,De Graafschap,AFC Ajax,0,5,2,0,3,5,-5,2.0,10.0
13535,2004-2005,13,RBC Roosendaal,sc Heerenveen,1,3,2,0,3,4,-2,3.0,10.0
13536,2004-2005,13,AZ Alkmaar,RKC Waalwijk,3,0,1,3,0,3,3,15.0,3.0
13537,2004-2005,13,Vitesse,PSV,0,2,2,0,3,2,-2,9.0,13.0
13538,2004-2005,13,Willem II,NAC Breda,0,1,2,0,3,1,-1,6.0,7.0
13539,2004-2005,13,FC Den Bosch,NEC Nijmegen,0,0,3,1,1,0,0,1.0,2.0
13540,2004-2005,13,FC Twente,FC Utrecht,0,1,2,0,3,1,-1,6.0,5.0
13541,2004-2005,13,Feyenoord,FC Groningen,1,2,2,0,3,3,-1,7.0,12.0
13542,2004-2005,14,RKC Waalwijk,Vitesse,2,2,3,1,1,4,0,4.0,10.0
13543,2004-2005,14,ADO Den Haag,Willem II,0,1,2,0,3,1,-1,4.0,6.0
13544,2004-2005,14,PSV,FC Twente,2,0,1,3,0,2,2,13.0,3.0
13545,2004-2005,14,NEC Nijmegen,Roda JC Kerkrade,1,1,3,1,1,2,0,2.0,4.0
13546,2004-2005,14,sc Heerenveen,Feyenoord,2,2,3,1,1,4,0,8.0,5.0
13547,2004-2005,14,AFC Ajax,RBC Roosendaal,4,1,1,3,0,5,3,13.0,3.0
13548,2004-2005,14,FC Groningen,AZ Alkmaar,1,2,2,0,3,3,-1,12.0,15.0
13549,2004-2005,14,FC Utrecht,De Graafschap,1,0,1,3,0,1,1,8.0,1.0
13550,2004-2005,14,NAC Breda,FC Den Bosch,3,0,1,3,0,3,3,9.0,1.0
13551,2004-2005,15,RKC Waalwijk,AFC Ajax,1,2,2,0,3,3,-1,3.0,13.0
13552,2004-2005,15,Roda JC Kerkrade,FC Groningen,5,1,1,3,0,6,4,6.0,9.0
13553,2004-2005,15,De Graafschap,PSV,0,4,2,0,3,4,-4,1.0,15.0
13554,2004-2005,15,RBC Roosendaal,NAC Breda,0,0,3,1,1,0,0,4.0,7.0
13555,2004-2005,15,FC Twente,FC Den Bosch,4,0,1,3,0,4,4,6.0,1.0
13556,2004-2005,15,AZ Alkmaar,ADO Den Haag,2,0,1,3,0,2,2,15.0,4.0
13557,2004-2005,15,Willem II,sc Heerenveen,2,2,3,1,1,4,0,4.0,6.0
13558,2004-2005,15,Vitesse,FC Utrecht,2,1,1,3,0,3,1,10.0,7.0
13559,2004-2005,15,Feyenoord,NEC Nijmegen,2,1,1,3,0,3,1,8.0,2.0
13560,2004-2005,16,sc Heerenveen,FC Groningen,1,0,1,3,0,1,1,8.0,6.0
13561,2004-2005,16,FC Den Bosch,RKC Waalwijk,0,2,2,0,3,2,-2,1.0,5.0
13562,2004-2005,16,Roda JC Kerkrade,RBC Roosendaal,3,1,1,3,0,4,2,9.0,1.0
13563,2004-2005,16,Willem II,FC Utrecht,0,0,3,1,1,0,0,5.0,8.0
13564,2004-2005,16,AZ Alkmaar,FC Twente,5,0,1,3,0,5,5,15.0,6.0
13565,2004-2005,16,Feyenoord,PSV,3,3,3,1,1,6,0,6.0,13.0
13566,2004-2005,16,NAC Breda,ADO Den Haag,1,1,3,1,1,2,0,8.0,5.0
13567,2004-2005,16,AFC Ajax,Vitesse,1,0,1,3,0,1,1,13.0,7.0
13568,2004-2005,16,De Graafschap,NEC Nijmegen,3,2,1,3,0,5,1,4.0,2.0
13569,2004-2005,17,Vitesse,De Graafschap,3,1,1,3,0,4,2,7.0,3.0
13570,2004-2005,17,FC Twente,NAC Breda,0,0,3,1,1,0,0,4.0,9.0
13571,2004-2005,17,PSV,Roda JC Kerkrade,0,2,2,0,3,2,-2,10.0,11.0
13572,2004-2005,17,RBC Roosendaal,AZ Alkmaar,0,2,2,0,3,2,-2,1.0,15.0
13573,2004-2005,17,RKC Waalwijk,Willem II,1,0,1,3,0,1,1,7.0,5.0
13574,2004-2005,17,ADO Den Haag,Feyenoord,2,0,1,3,0,2,2,5.0,5.0
13575,2004-2005,17,NEC Nijmegen,sc Heerenveen,3,2,1,3,0,5,1,5.0,8.0
13576,2004-2005,17,FC Utrecht,FC Den Bosch,1,0,1,3,0,1,1,10.0,1.0
13577,2004-2005,17,FC Groningen,AFC Ajax,0,4,2,0,3,4,-4,3.0,15.0
13578,2004-2005,18,AZ Alkmaar,NEC Nijmegen,1,1,3,1,1,2,0,13.0,5.0
13579,2004-2005,18,PSV,NAC Breda,4,0,1,3,0,4,4,10.0,6.0
13580,2004-2005,18,sc Heerenveen,FC Den Bosch,2,1,1,3,0,3,1,8.0,0.0
13581,2004-2005,18,Willem II,FC Twente,0,3,2,0,3,3,-3,5.0,7.0
13582,2004-2005,18,De Graafschap,Roda JC Kerkrade,2,0,1,3,0,2,2,6.0,10.0
13583,2004-2005,18,FC Utrecht,AFC Ajax,0,2,2,0,3,2,-2,7.0,15.0
13584,2004-2005,18,ADO Den Haag,FC Groningen,0,3,2,0,3,3,-3,4.0,3.0
13585,2004-2005,18,RBC Roosendaal,RKC Waalwijk,0,1,2,0,3,1,-1,1.0,10.0
13586,2004-2005,18,Feyenoord,Vitesse,1,2,2,0,3,3,-1,5.0,10.0
13587,2004-2005,19,Roda JC Kerkrade,Willem II,4,0,1,3,0,4,4,12.0,2.0
13588,2004-2005,19,FC Den Bosch,AZ Alkmaar,0,1,2,0,3,1,-1,0.0,13.0
13589,2004-2005,19,FC Twente,Feyenoord,0,0,3,1,1,0,0,8.0,5.0
13590,2004-2005,19,Vitesse,RBC Roosendaal,1,3,2,0,3,4,-2,9.0,4.0
13591,2004-2005,19,RKC Waalwijk,PSV,1,4,2,0,3,5,-3,9.0,10.0
13592,2004-2005,19,NAC Breda,sc Heerenveen,1,1,3,1,1,2,0,4.0,8.0
13593,2004-2005,19,AFC Ajax,ADO Den Haag,0,0,3,1,1,0,0,13.0,5.0
13594,2004-2005,19,FC Groningen,De Graafschap,1,0,1,3,0,1,1,6.0,6.0
13595,2004-2005,19,NEC Nijmegen,FC Utrecht,0,0,3,1,1,0,0,5.0,5.0
13596,2004-2005,20,PSV,RBC Roosendaal,4,1,1,3,0,5,3,10.0,3.0
13597,2004-2005,20,Willem II,NEC Nijmegen,3,1,1,3,0,4,2,4.0,5.0
13598,2004-2005,20,De Graafschap,Feyenoord,2,7,2,0,3,9,-5,6.0,5.0
13599,2004-2005,20,ADO Den Haag,FC Den Bosch,2,0,1,3,0,2,2,8.0,0.0
13600,2004-2005,20,sc Heerenveen,AZ Alkmaar,1,3,2,0,3,4,-2,7.0,13.0
13601,2004-2005,20,Vitesse,Roda JC Kerkrade,3,0,1,3,0,3,3,9.0,9.0
13602,2004-2005,20,AFC Ajax,FC Twente,1,2,2,0,3,3,-1,10.0,8.0
13603,2004-2005,20,FC Utrecht,NAC Breda,2,0,1,3,0,2,2,8.0,3.0
13604,2004-2005,20,RKC Waalwijk,FC Groningen,3,0,1,3,0,3,3,12.0,6.0
13605,2004-2005,21,FC Groningen,Vitesse,0,0,3,1,1,0,0,7.0,10.0
13606,2004-2005,21,Roda JC Kerkrade,sc Heerenveen,2,3,2,0,3,5,-1,6.0,7.0
13607,2004-2005,21,AZ Alkmaar,PSV,0,0,3,1,1,0,0,11.0,10.0
13608,2004-2005,21,RBC Roosendaal,FC Utrecht,0,1,2,0,3,1,-1,3.0,10.0
13609,2004-2005,21,FC Twente,RKC Waalwijk,3,1,1,3,0,4,2,11.0,9.0
13610,2004-2005,21,NAC Breda,AFC Ajax,1,2,2,0,3,3,-1,2.0,10.0
13611,2004-2005,21,NEC Nijmegen,ADO Den Haag,1,1,3,1,1,2,0,6.0,8.0
13612,2004-2005,21,FC Den Bosch,De Graafschap,0,2,2,0,3,2,-2,0.0,6.0
13613,2004-2005,21,Feyenoord,Willem II,7,0,1,3,0,7,7,7.0,3.0
13614,2004-2005,22,RBC Roosendaal,Willem II,2,0,1,3,0,2,2,6.0,3.0
13615,2004-2005,22,PSV,NEC Nijmegen,4,1,1,3,0,5,3,13.0,3.0
13616,2004-2005,22,FC Utrecht,Feyenoord,0,2,2,0,3,2,-2,7.0,10.0
13617,2004-2005,22,AZ Alkmaar,Roda JC Kerkrade,1,1,3,1,1,2,0,9.0,4.0
13618,2004-2005,22,De Graafschap,sc Heerenveen,2,1,1,3,0,3,1,9.0,7.0
13619,2004-2005,22,AFC Ajax,FC Den Bosch,2,0,1,3,0,2,2,10.0,0.0
13620,2004-2005,22,FC Groningen,FC Twente,0,1,2,0,3,1,-1,7.0,13.0
13621,2004-2005,22,RKC Waalwijk,NAC Breda,1,0,1,3,0,1,1,9.0,1.0
13622,2004-2005,22,Vitesse,ADO Den Haag,3,4,2,0,3,7,-1,7.0,8.0
13623,2004-2005,23,NEC Nijmegen,RKC Waalwijk,1,0,1,3,0,1,1,5.0,6.0
13624,2004-2005,23,NAC Breda,FC Groningen,1,4,2,0,3,5,-3,1.0,7.0
13625,2004-2005,23,FC Twente,De Graafschap,0,0,3,1,1,0,0,11.0,7.0
13626,2004-2005,23,ADO Den Haag,FC Utrecht,1,0,1,3,0,1,1,11.0,7.0
13627,2004-2005,23,Roda JC Kerkrade,AFC Ajax,1,2,2,0,3,3,-1,4.0,10.0
13628,2004-2005,23,Willem II,AZ Alkmaar,1,3,2,0,3,4,-2,3.0,11.0
13629,2004-2005,23,FC Den Bosch,Vitesse,1,2,2,0,3,3,-1,0.0,7.0
13630,2004-2005,23,Feyenoord,RBC Roosendaal,3,0,1,3,0,3,3,13.0,6.0
13631,2004-2005,23,sc Heerenveen,PSV,0,3,2,0,3,3,-3,4.0,13.0
13632,2004-2005,24,RBC Roosendaal,NEC Nijmegen,1,0,1,3,0,1,1,6.0,4.0
13633,2004-2005,24,RKC Waalwijk,FC Utrecht,2,2,3,1,1,4,0,7.0,7.0
13634,2004-2005,24,Vitesse,Willem II,2,0,1,3,0,2,2,10.0,3.0
13635,2004-2005,24,De Graafschap,NAC Breda,0,2,2,0,3,2,-2,7.0,3.0
13636,2004-2005,24,Roda JC Kerkrade,FC Twente,1,2,2,0,3,3,-1,1.0,13.0
13637,2004-2005,24,ADO Den Haag,sc Heerenveen,0,2,2,0,3,2,-2,10.0,6.0
13638,2004-2005,24,FC Groningen,PSV,0,1,2,0,3,1,-1,4.0,13.0
13639,2004-2005,24,AFC Ajax,AZ Alkmaar,4,2,1,3,0,6,2,12.0,8.0
13640,2004-2005,24,FC Den Bosch,Feyenoord,4,1,1,3,0,5,3,3.0,12.0
13641,2004-2005,25,FC Twente,RBC Roosendaal,3,0,1,3,0,3,3,13.0,6.0
13642,2004-2005,25,NAC Breda,Vitesse,1,2,2,0,3,3,-1,3.0,10.0
13643,2004-2005,25,sc Heerenveen,RKC Waalwijk,1,2,2,0,3,3,-1,6.0,7.0
13644,2004-2005,25,Willem II,FC Den Bosch,2,1,1,3,0,3,1,3.0,3.0
13645,2004-2005,25,NEC Nijmegen,AFC Ajax,0,1,2,0,3,1,-1,4.0,15.0
13646,2004-2005,25,PSV,ADO Den Haag,4,0,1,3,0,4,4,13.0,7.0
13647,2004-2005,25,AZ Alkmaar,De Graafschap,3,2,1,3,0,5,1,8.0,7.0
13648,2004-2005,25,FC Utrecht,FC Groningen,1,2,2,0,3,3,-1,4.0,7.0
13649,2004-2005,25,Feyenoord,Roda JC Kerkrade,4,1,1,3,0,5,3,12.0,1.0
13650,2004-2005,26,FC Den Bosch,Roda JC Kerkrade,0,3,2,0,3,3,-3,3.0,4.0
13651,2004-2005,26,De Graafschap,RBC Roosendaal,0,1,2,0,3,1,-1,4.0,9.0
13652,2004-2005,26,NAC Breda,NEC Nijmegen,1,2,2,0,3,3,-1,3.0,6.0
13653,2004-2005,26,RKC Waalwijk,Feyenoord,2,4,2,0,3,6,-2,7.0,12.0
13654,2004-2005,26,AZ Alkmaar,Vitesse,3,0,1,3,0,3,3,10.0,9.0
13655,2004-2005,26,AFC Ajax,PSV,0,4,2,0,3,4,-4,12.0,15.0
13656,2004-2005,26,FC Utrecht,sc Heerenveen,0,1,2,0,3,1,-1,1.0,6.0
13657,2004-2005,26,FC Groningen,Willem II,1,1,3,1,1,2,0,7.0,4.0
13658,2004-2005,26,FC Twente,ADO Den Haag,2,1,1,3,0,3,1,13.0,6.0
13659,2004-2005,27,Vitesse,FC Twente,1,1,3,1,1,2,0,10.0,11.0
13660,2004-2005,27,PSV,FC Utrecht,2,0,1,3,0,2,2,15.0,1.0
13661,2004-2005,27,sc Heerenveen,AFC Ajax,2,1,1,3,0,3,1,9.0,9.0
13662,2004-2005,27,Willem II,De Graafschap,4,1,1,3,0,5,3,7.0,1.0
13663,2004-2005,27,ADO Den Haag,RKC Waalwijk,0,0,3,1,1,0,0,4.0,5.0
13664,2004-2005,27,Feyenoord,AZ Alkmaar,4,2,1,3,0,6,2,12.0,9.0
13665,2004-2005,27,NEC Nijmegen,FC Groningen,4,3,1,3,0,7,1,9.0,7.0
13666,2004-2005,27,RBC Roosendaal,FC Den Bosch,1,2,2,0,3,3,-1,6.0,6.0
13667,2004-2005,27,Roda JC Kerkrade,NAC Breda,2,1,1,3,0,3,1,6.0,3.0
13668,2004-2005,28,AFC Ajax,Willem II,2,0,1,3,0,2,2,9.0,7.0
13669,2004-2005,28,ADO Den Haag,De Graafschap,2,0,1,3,0,2,2,4.0,0.0
13670,2004-2005,28,sc Heerenveen,FC Twente,1,2,2,0,3,3,-1,9.0,13.0
13671,2004-2005,28,PSV,FC Den Bosch,3,0,1,3,0,3,3,15.0,6.0
13672,2004-2005,28,FC Groningen,RBC Roosendaal,3,0,1,3,0,3,3,7.0,6.0
13673,2004-2005,28,NAC Breda,Feyenoord,0,2,2,0,3,2,-2,3.0,12.0
13674,2004-2005,28,NEC Nijmegen,Vitesse,1,1,3,1,1,2,0,7.0,8.0
13675,2004-2005,28,RKC Waalwijk,Roda JC Kerkrade,1,0,1,3,0,1,1,8.0,6.0
13676,2004-2005,28,FC Utrecht,AZ Alkmaar,3,2,1,3,0,5,1,4.0,6.0
13677,2004-2005,29,Roda JC Kerkrade,FC Utrecht,3,2,1,3,0,5,1,9.0,3.0
13678,2004-2005,29,RBC Roosendaal,ADO Den Haag,2,0,1,3,0,2,2,6.0,4.0
13679,2004-2005,29,De Graafschap,RKC Waalwijk,2,4,2,0,3,6,-2,0.0,10.0
13680,2004-2005,29,Vitesse,sc Heerenveen,1,3,2,0,3,4,-2,5.0,9.0
13681,2004-2005,29,Feyenoord,AFC Ajax,2,3,2,0,3,5,-1,12.0,9.0
13682,2004-2005,29,AZ Alkmaar,NAC Breda,1,1,3,1,1,2,0,7.0,1.0
13683,2004-2005,29,FC Twente,NEC Nijmegen,2,1,1,3,0,3,1,13.0,7.0
13684,2004-2005,29,Willem II,PSV,0,1,2,0,3,1,-1,7.0,15.0
13685,2004-2005,29,FC Den Bosch,FC Groningen,1,2,2,0,3,3,-1,3.0,10.0
13686,2004-2005,30,sc Heerenveen,RBC Roosendaal,7,1,1,3,0,8,6,12.0,6.0
13687,2004-2005,30,ADO Den Haag,Roda JC Kerkrade,1,4,2,0,3,5,-3,4.0,12.0
13688,2004-2005,30,RKC Waalwijk,AZ Alkmaar,2,1,1,3,0,3,1,10.0,4.0
13689,2004-2005,30,PSV,Vitesse,3,0,1,3,0,3,3,15.0,2.0
13690,2004-2005,30,FC Groningen,Feyenoord,0,2,2,0,3,2,-2,7.0,12.0
13691,2004-2005,30,AFC Ajax,De Graafschap,1,0,1,3,0,1,1,9.0,0.0
13692,2004-2005,30,NAC Breda,Willem II,1,2,2,0,3,3,-1,1.0,7.0
13693,2004-2005,30,FC Utrecht,FC Twente,2,2,3,1,1,4,0,4.0,11.0
13694,2004-2005,30,NEC Nijmegen,FC Den Bosch,2,2,3,1,1,4,0,8.0,4.0
13695,2004-2005,31,FC Twente,PSV,2,2,3,1,1,4,0,9.0,13.0
13696,2004-2005,31,Roda JC Kerkrade,NEC Nijmegen,1,0,1,3,0,1,1,12.0,5.0
13697,2004-2005,31,RBC Roosendaal,AFC Ajax,1,4,2,0,3,5,-3,3.0,12.0
13698,2004-2005,31,Vitesse,RKC Waalwijk,3,1,1,3,0,4,2,5.0,10.0
13699,2004-2005,31,AZ Alkmaar,FC Groningen,2,1,1,3,0,3,1,4.0,6.0
13700,2004-2005,31,Willem II,ADO Den Haag,1,0,1,3,0,1,1,9.0,4.0
13701,2004-2005,31,Feyenoord,sc Heerenveen,1,3,2,0,3,4,-2,9.0,12.0
13702,2004-2005,31,FC Den Bosch,NAC Breda,0,2,2,0,3,2,-2,4.0,4.0
13703,2004-2005,31,De Graafschap,FC Utrecht,0,0,3,1,1,0,0,1.0,5.0
13704,2004-2005,32,NAC Breda,RBC Roosendaal,1,2,2,0,3,3,-1,4.0,6.0
13705,2004-2005,32,FC Den Bosch,FC Twente,1,0,1,3,0,1,1,4.0,8.0
13706,2004-2005,32,sc Heerenveen,Willem II,2,2,3,1,1,4,0,10.0,7.0
13707,2004-2005,32,AFC Ajax,RKC Waalwijk,4,0,1,3,0,4,4,15.0,9.0
13708,2004-2005,32,NEC Nijmegen,Feyenoord,2,0,1,3,0,2,2,5.0,6.0
13709,2004-2005,32,ADO Den Haag,AZ Alkmaar,2,1,1,3,0,3,1,6.0,4.0
13710,2004-2005,32,PSV,De Graafschap,4,1,1,3,0,5,3,13.0,1.0
13711,2004-2005,32,FC Groningen,Roda JC Kerkrade,4,4,3,1,1,8,0,7.0,10.0
13712,2004-2005,32,FC Utrecht,Vitesse,1,2,2,0,3,3,-1,5.0,7.0
13713,2004-2005,33,NEC Nijmegen,De Graafschap,3,0,1,3,0,3,3,7.0,1.0
13714,2004-2005,33,RBC Roosendaal,Roda JC Kerkrade,3,1,1,3,0,4,2,9.0,10.0
13715,2004-2005,33,RKC Waalwijk,FC Den Bosch,2,0,1,3,0,2,2,9.0,4.0
13716,2004-2005,33,Vitesse,AFC Ajax,0,2,2,0,3,2,-2,6.0,15.0
13717,2004-2005,33,ADO Den Haag,NAC Breda,6,2,1,3,0,8,4,6.0,4.0
13718,2004-2005,33,FC Groningen,sc Heerenveen,1,2,2,0,3,3,-1,4.0,13.0
13719,2004-2005,33,FC Twente,AZ Alkmaar,3,0,1,3,0,3,3,8.0,4.0
13720,2004-2005,33,PSV,Feyenoord,4,2,1,3,0,6,2,13.0,3.0
13721,2004-2005,33,FC Utrecht,Willem II,0,3,2,0,3,3,-3,2.0,10.0
13722,2004-2005,34,AFC Ajax,FC Groningen,2,1,1,3,0,3,1,15.0,1.0
13723,2004-2005,34,Willem II,RKC Waalwijk,3,0,1,3,0,3,3,13.0,6.0
13724,2004-2005,34,AZ Alkmaar,RBC Roosendaal,1,3,2,0,3,4,-2,3.0,9.0
13725,2004-2005,34,De Graafschap,Vitesse,1,2,2,0,3,3,-1,1.0,9.0
13726,2004-2005,34,FC Den Bosch,FC Utrecht,0,3,2,0,3,3,-3,4.0,5.0
13727,2004-2005,34,Feyenoord,ADO Den Haag,6,3,1,3,0,9,3,6.0,6.0
13728,2004-2005,34,NAC Breda,FC Twente,1,1,3,1,1,2,0,4.0,6.0
13729,2004-2005,34,Roda JC Kerkrade,PSV,0,0,3,1,1,0,0,8.0,11.0
13730,2004-2005,34,sc Heerenveen,NEC Nijmegen,2,1,1,3,0,3,1,13.0,7.0
13731,2005-2006,1,AZ Alkmaar,Sparta Rotterdam,3,0,1,3,0,3,3,6.0,0.0
13732,2005-2006,1,Willem II,RKC Waalwijk,1,2,2,0,3,3,-1,10.0,6.0
13733,2005-2006,1,Roda JC Kerkrade,FC Twente,2,0,1,3,0,2,2,8.0,5.0
13734,2005-2006,1,Heracles Almelo,PSV,1,1,3,1,1,2,0,1.0,9.0
13735,2005-2006,1,Vitesse,sc Heerenveen,2,2,3,1,1,4,0,10.0,11.0
13736,2005-2006,1,FC Groningen,RBC Roosendaal,1,0,1,3,0,1,1,4.0,9.0
13737,2005-2006,1,Feyenoord,NAC Breda,2,0,1,3,0,2,2,6.0,4.0
13738,2005-2006,1,NEC Nijmegen,FC Utrecht,0,0,3,1,1,0,0,7.0,5.0
13739,2005-2006,1,AFC Ajax,ADO Den Haag,2,2,3,1,1,4,0,13.0,7.0
13740,2005-2006,2,NAC Breda,Willem II,1,0,1,3,0,1,1,4.0,7.0
13741,2005-2006,2,ADO Den Haag,Heracles Almelo,1,2,2,0,3,3,-1,7.0,4.0
13742,2005-2006,2,RBC Roosendaal,AFC Ajax,0,2,2,0,3,2,-2,9.0,13.0
13743,2005-2006,2,sc Heerenveen,Roda JC Kerkrade,5,4,1,3,0,9,1,11.0,5.0
13744,2005-2006,2,FC Twente,NEC Nijmegen,0,1,2,0,3,1,-1,4.0,10.0
13745,2005-2006,2,Sparta Rotterdam,Feyenoord,1,3,2,0,3,4,-2,0.0,9.0
13746,2005-2006,2,FC Utrecht,AZ Alkmaar,1,2,2,0,3,3,-1,4.0,6.0
13747,2005-2006,2,RKC Waalwijk,FC Groningen,2,1,1,3,0,3,1,9.0,4.0
13748,2005-2006,2,PSV,Vitesse,2,1,1,3,0,3,1,11.0,7.0
13749,2005-2006,3,ADO Den Haag,sc Heerenveen,1,0,1,3,0,1,1,7.0,10.0
13750,2005-2006,3,Sparta Rotterdam,NAC Breda,1,0,1,3,0,1,1,3.0,4.0
13751,2005-2006,3,Vitesse,AZ Alkmaar,0,5,2,0,3,5,-5,4.0,9.0
13752,2005-2006,3,NEC Nijmegen,RKC Waalwijk,1,3,2,0,3,4,-2,7.0,12.0
13753,2005-2006,3,AFC Ajax,Feyenoord,1,2,2,0,3,3,-1,10.0,12.0
13754,2005-2006,3,FC Utrecht,FC Twente,1,3,2,0,3,4,-2,4.0,7.0
13755,2005-2006,3,RBC Roosendaal,Willem II,1,1,3,1,1,2,0,7.0,7.0
13756,2005-2006,3,Heracles Almelo,FC Groningen,2,1,1,3,0,3,1,7.0,3.0
13757,2005-2006,3,Roda JC Kerkrade,PSV,0,3,2,0,3,3,-3,4.0,11.0
13758,2005-2006,4,RKC Waalwijk,Roda JC Kerkrade,2,0,1,3,0,2,2,12.0,4.0
13759,2005-2006,4,PSV,FC Utrecht,1,0,1,3,0,1,1,11.0,4.0
13760,2005-2006,4,sc Heerenveen,Heracles Almelo,1,2,2,0,3,3,-1,7.0,10.0
13761,2005-2006,4,Willem II,AFC Ajax,0,2,2,0,3,2,-2,4.0,10.0
13762,2005-2006,4,AZ Alkmaar,RBC Roosendaal,7,0,1,3,0,7,7,12.0,4.0
13763,2005-2006,4,NAC Breda,ADO Den Haag,4,1,1,3,0,5,3,7.0,4.0
13764,2005-2006,4,Feyenoord,NEC Nijmegen,3,0,1,3,0,3,3,15.0,4.0
13765,2005-2006,4,FC Twente,Vitesse,0,1,2,0,3,1,-1,4.0,7.0
13766,2005-2006,4,FC Groningen,Sparta Rotterdam,0,1,2,0,3,1,-1,3.0,6.0
13767,2005-2006,5,ADO Den Haag,FC Twente,0,0,3,1,1,0,0,5.0,4.0
13768,2005-2006,5,Heracles Almelo,RKC Waalwijk,0,2,2,0,3,2,-2,10.0,15.0
13769,2005-2006,5,RBC Roosendaal,Sparta Rotterdam,1,1,3,1,1,2,0,2.0,7.0
13770,2005-2006,5,NEC Nijmegen,NAC Breda,1,1,3,1,1,2,0,5.0,7.0
13771,2005-2006,5,AZ Alkmaar,AFC Ajax,4,2,1,3,0,6,2,15.0,7.0
13772,2005-2006,5,FC Utrecht,Vitesse,1,0,1,3,0,1,1,4.0,4.0
13773,2005-2006,5,Feyenoord,sc Heerenveen,5,1,1,3,0,6,4,15.0,4.0
13774,2005-2006,5,FC Groningen,PSV,1,0,1,3,0,1,1,6.0,10.0
13775,2005-2006,5,Roda JC Kerkrade,Willem II,0,2,2,0,3,2,-2,3.0,4.0
13776,2005-2006,6,sc Heerenveen,NEC Nijmegen,2,1,1,3,0,3,1,6.0,4.0
13777,2005-2006,6,PSV,RBC Roosendaal,2,0,1,3,0,2,2,12.0,2.0
13778,2005-2006,6,Willem II,ADO Den Haag,1,0,1,3,0,1,1,7.0,4.0
13779,2005-2006,6,RKC Waalwijk,FC Utrecht,2,3,2,0,3,5,-1,12.0,6.0
13780,2005-2006,6,Vitesse,FC Groningen,2,0,1,3,0,2,2,6.0,3.0
13781,2005-2006,6,AFC Ajax,Roda JC Kerkrade,4,1,1,3,0,5,3,9.0,0.0
13782,2005-2006,6,FC Twente,Feyenoord,1,3,2,0,3,4,-2,4.0,15.0
13783,2005-2006,6,Sparta Rotterdam,Heracles Almelo,2,0,1,3,0,2,2,10.0,9.0
13784,2005-2006,6,NAC Breda,AZ Alkmaar,2,1,1,3,0,3,1,10.0,12.0
13785,2005-2006,7,RBC Roosendaal,NAC Breda,1,2,2,0,3,3,-1,2.0,10.0
13786,2005-2006,7,Roda JC Kerkrade,Vitesse,3,2,1,3,0,5,1,3.0,6.0
13787,2005-2006,7,ADO Den Haag,RKC Waalwijk,2,1,1,3,0,3,1,7.0,9.0
13788,2005-2006,7,Sparta Rotterdam,AFC Ajax,1,2,2,0,3,3,-1,10.0,9.0
13789,2005-2006,7,FC Utrecht,Feyenoord,3,1,1,3,0,4,2,9.0,12.0
13790,2005-2006,7,AZ Alkmaar,NEC Nijmegen,3,2,1,3,0,5,1,12.0,1.0
13791,2005-2006,7,Heracles Almelo,FC Twente,0,4,2,0,3,4,-4,6.0,7.0
13792,2005-2006,7,FC Groningen,Willem II,2,0,1,3,0,2,2,6.0,7.0
13793,2005-2006,7,sc Heerenveen,PSV,2,3,2,0,3,5,-1,3.0,12.0
13794,2005-2006,8,Willem II,Sparta Rotterdam,0,0,3,1,1,0,0,7.0,8.0
13795,2005-2006,8,NAC Breda,sc Heerenveen,0,3,2,0,3,3,-3,10.0,6.0
13796,2005-2006,8,PSV,AZ Alkmaar,3,0,1,3,0,3,3,12.0,9.0
13797,2005-2006,8,FC Twente,RKC Waalwijk,2,0,1,3,0,2,2,7.0,6.0
13798,2005-2006,8,AFC Ajax,Heracles Almelo,0,0,3,1,1,0,0,10.0,4.0
13799,2005-2006,8,NEC Nijmegen,RBC Roosendaal,3,1,1,3,0,4,2,4.0,1.0
13800,2005-2006,8,Vitesse,ADO Den Haag,3,1,1,3,0,4,2,9.0,4.0
13801,2005-2006,8,Feyenoord,FC Groningen,4,1,1,3,0,5,3,12.0,6.0
13802,2005-2006,8,Roda JC Kerkrade,FC Utrecht,2,1,1,3,0,3,1,6.0,9.0
13803,2005-2006,9,Heracles Almelo,NEC Nijmegen,0,2,2,0,3,2,-2,1.0,7.0
13804,2005-2006,9,RBC Roosendaal,Vitesse,0,3,2,0,3,3,-3,1.0,9.0
13805,2005-2006,9,NAC Breda,FC Twente,1,1,3,1,1,2,0,8.0,8.0
13806,2005-2006,9,Sparta Rotterdam,Roda JC Kerkrade,2,3,2,0,3,5,-1,5.0,9.0
13807,2005-2006,9,PSV,AFC Ajax,1,0,1,3,0,1,1,12.0,7.0
13808,2005-2006,9,AZ Alkmaar,Willem II,5,1,1,3,0,6,4,9.0,7.0
13809,2005-2006,9,FC Groningen,ADO Den Haag,3,1,1,3,0,4,2,9.0,4.0
13810,2005-2006,9,RKC Waalwijk,Feyenoord,2,1,1,3,0,3,1,6.0,9.0
13811,2005-2006,9,sc Heerenveen,FC Utrecht,1,1,3,1,1,2,0,7.0,10.0
13812,2005-2006,10,AFC Ajax,sc Heerenveen,0,0,3,1,1,0,0,8.0,8.0
13813,2005-2006,10,ADO Den Haag,AZ Alkmaar,0,2,2,0,3,2,-2,3.0,9.0
13814,2005-2006,10,Vitesse,Heracles Almelo,5,1,1,3,0,6,4,12.0,1.0
13815,2005-2006,10,FC Twente,PSV,0,1,2,0,3,1,-1,7.0,15.0
13816,2005-2006,10,RKC Waalwijk,NAC Breda,4,1,1,3,0,5,3,6.0,7.0
13817,2005-2006,10,FC Groningen,Roda JC Kerkrade,1,0,1,3,0,1,1,9.0,9.0
13818,2005-2006,10,FC Utrecht,RBC Roosendaal,4,1,1,3,0,5,3,10.0,0.0
13819,2005-2006,10,Willem II,Feyenoord,1,3,2,0,3,4,-2,4.0,9.0
13820,2005-2006,10,NEC Nijmegen,Sparta Rotterdam,0,0,3,1,1,0,0,7.0,5.0
13821,2005-2006,11,RBC Roosendaal,RKC Waalwijk,1,1,3,1,1,2,0,1.0,7.0
13822,2005-2006,11,Roda JC Kerkrade,NAC Breda,3,3,3,1,1,6,0,10.0,5.0
13823,2005-2006,11,PSV,Sparta Rotterdam,3,0,1,3,0,3,3,15.0,2.0
13824,2005-2006,11,FC Twente,Willem II,3,1,1,3,0,4,2,10.0,1.0
13825,2005-2006,11,AZ Alkmaar,Heracles Almelo,2,2,3,1,1,4,0,10.0,2.0
13826,2005-2006,11,FC Utrecht,ADO Den Haag,1,1,3,1,1,2,0,8.0,4.0
13827,2005-2006,11,NEC Nijmegen,AFC Ajax,1,0,1,3,0,1,1,10.0,5.0
13828,2005-2006,11,sc Heerenveen,FC Groningen,4,0,1,3,0,4,4,8.0,9.0
13829,2005-2006,11,Feyenoord,Vitesse,0,0,3,1,1,0,0,7.0,10.0
13830,2005-2006,12,Willem II,Vitesse,3,4,2,0,3,7,-1,1.0,13.0
13831,2005-2006,12,ADO Den Haag,NEC Nijmegen,0,1,2,0,3,1,-1,1.0,13.0
13832,2005-2006,12,NAC Breda,FC Utrecht,0,1,2,0,3,1,-1,2.0,8.0
13833,2005-2006,12,RKC Waalwijk,PSV,4,4,3,1,1,8,0,8.0,13.0
13834,2005-2006,12,AFC Ajax,FC Twente,2,0,1,3,0,2,2,5.0,7.0
13835,2005-2006,12,Roda JC Kerkrade,Feyenoord,2,3,2,0,3,5,-1,7.0,10.0
13836,2005-2006,12,Heracles Almelo,RBC Roosendaal,3,0,1,3,0,3,3,5.0,1.0
13837,2005-2006,12,FC Groningen,AZ Alkmaar,0,0,3,1,1,0,0,7.0,8.0
13838,2005-2006,12,Sparta Rotterdam,sc Heerenveen,1,2,2,0,3,3,-1,2.0,11.0
13839,2005-2006,13,FC Utrecht,AFC Ajax,1,0,1,3,0,1,1,11.0,4.0
13840,2005-2006,13,sc Heerenveen,RBC Roosendaal,2,0,1,3,0,2,2,11.0,1.0
13841,2005-2006,13,PSV,ADO Den Haag,3,0,1,3,0,3,3,13.0,1.0
13842,2005-2006,13,AZ Alkmaar,Roda JC Kerkrade,2,0,1,3,0,2,2,11.0,4.0
13843,2005-2006,13,Feyenoord,Heracles Almelo,7,1,1,3,0,8,6,10.0,4.0
13844,2005-2006,13,Vitesse,RKC Waalwijk,4,2,1,3,0,6,2,13.0,8.0
13845,2005-2006,13,NAC Breda,FC Groningen,2,2,3,1,1,4,0,3.0,8.0
13846,2005-2006,13,FC Twente,Sparta Rotterdam,1,0,1,3,0,1,1,7.0,1.0
13847,2005-2006,13,NEC Nijmegen,Willem II,2,0,1,3,0,2,2,13.0,0.0
13848,2005-2006,14,Heracles Almelo,Roda JC Kerkrade,0,1,2,0,3,1,-1,4.0,4.0
13849,2005-2006,14,RBC Roosendaal,Feyenoord,2,2,3,1,1,4,0,2.0,11.0
13850,2005-2006,14,PSV,NAC Breda,3,0,1,3,0,3,3,13.0,2.0
13851,2005-2006,14,AZ Alkmaar,sc Heerenveen,2,1,1,3,0,3,1,11.0,10.0
13852,2005-2006,14,NEC Nijmegen,Vitesse,1,0,1,3,0,1,1,13.0,10.0
13853,2005-2006,14,Sparta Rotterdam,ADO Den Haag,2,3,2,0,3,5,-1,1.0,4.0
13854,2005-2006,14,AFC Ajax,RKC Waalwijk,4,1,1,3,0,5,3,7.0,5.0
13855,2005-2006,14,FC Groningen,FC Twente,1,0,1,3,0,1,1,8.0,6.0
13856,2005-2006,14,Willem II,FC Utrecht,0,1,2,0,3,1,-1,0.0,13.0
13857,2005-2006,15,Roda JC Kerkrade,NEC Nijmegen,0,1,2,0,3,1,-1,4.0,15.0
13858,2005-2006,15,sc Heerenveen,Willem II,3,3,3,1,1,6,0,10.0,1.0
13859,2005-2006,15,NAC Breda,Heracles Almelo,2,1,1,3,0,3,1,5.0,4.0
13860,2005-2006,15,ADO Den Haag,RBC Roosendaal,3,0,1,3,0,3,3,7.0,2.0
13861,2005-2006,15,FC Twente,AZ Alkmaar,1,3,2,0,3,4,-2,6.0,11.0
13862,2005-2006,15,Feyenoord,PSV,1,0,1,3,0,1,1,11.0,10.0
13863,2005-2006,15,Vitesse,AFC Ajax,0,2,2,0,3,2,-2,7.0,9.0
13864,2005-2006,15,FC Utrecht,FC Groningen,0,2,2,0,3,2,-2,10.0,8.0
13865,2005-2006,15,RKC Waalwijk,Sparta Rotterdam,3,2,1,3,0,5,1,5.0,0.0
13866,2005-2006,16,Sparta Rotterdam,Vitesse,1,0,1,3,0,1,1,3.0,6.0
13867,2005-2006,16,RBC Roosendaal,Roda JC Kerkrade,0,2,2,0,3,2,-2,1.0,6.0
13868,2005-2006,16,PSV,Willem II,4,1,1,3,0,5,3,10.0,1.0
13869,2005-2006,16,sc Heerenveen,FC Twente,3,1,1,3,0,4,2,10.0,3.0
13870,2005-2006,16,ADO Den Haag,Feyenoord,2,1,1,3,0,3,1,9.0,10.0
13871,2005-2006,16,AZ Alkmaar,RKC Waalwijk,3,0,1,3,0,3,3,13.0,4.0
13872,2005-2006,16,FC Groningen,NEC Nijmegen,3,0,1,3,0,3,3,11.0,12.0
13873,2005-2006,16,Heracles Almelo,FC Utrecht,1,1,3,1,1,2,0,4.0,10.0
13874,2005-2006,16,NAC Breda,AFC Ajax,0,2,2,0,3,2,-2,4.0,12.0
13875,2005-2006,17,Feyenoord,AZ Alkmaar,2,0,1,3,0,2,2,10.0,12.0
13876,2005-2006,17,FC Utrecht,Sparta Rotterdam,1,1,3,1,1,2,0,8.0,4.0
13877,2005-2006,17,NEC Nijmegen,PSV,0,2,2,0,3,2,-2,9.0,12.0
13878,2005-2006,17,FC Twente,RBC Roosendaal,4,1,1,3,0,5,3,6.0,1.0
13879,2005-2006,17,Roda JC Kerkrade,ADO Den Haag,3,1,1,3,0,4,2,9.0,9.0
13880,2005-2006,17,RKC Waalwijk,sc Heerenveen,2,2,3,1,1,4,0,4.0,8.0
13881,2005-2006,17,Vitesse,NAC Breda,2,1,1,3,0,3,1,6.0,4.0
13882,2005-2006,17,AFC Ajax,FC Groningen,3,2,1,3,0,5,1,12.0,10.0
13883,2005-2006,17,Willem II,Heracles Almelo,1,2,2,0,3,3,-1,1.0,4.0
13884,2005-2006,18,RBC Roosendaal,FC Utrecht,1,2,2,0,3,3,-1,1.0,8.0
13885,2005-2006,18,PSV,FC Twente,1,1,3,1,1,2,0,10.0,4.0
13886,2005-2006,18,Feyenoord,Willem II,6,1,1,3,0,7,5,10.0,1.0
13887,2005-2006,18,Roda JC Kerkrade,FC Groningen,1,3,2,0,3,4,-2,9.0,12.0
13888,2005-2006,18,Heracles Almelo,Vitesse,3,1,1,3,0,4,2,7.0,3.0
13889,2005-2006,18,sc Heerenveen,AFC Ajax,4,2,1,3,0,6,2,8.0,12.0
13890,2005-2006,18,NAC Breda,RKC Waalwijk,1,2,2,0,3,3,-1,3.0,7.0
13891,2005-2006,18,AZ Alkmaar,ADO Den Haag,3,1,1,3,0,4,2,12.0,9.0
13892,2005-2006,18,Sparta Rotterdam,NEC Nijmegen,1,3,2,0,3,4,-2,4.0,9.0
13893,2005-2006,19,FC Groningen,sc Heerenveen,2,0,1,3,0,2,2,12.0,8.0
13894,2005-2006,19,Heracles Almelo,AZ Alkmaar,0,2,2,0,3,2,-2,7.0,12.0
13895,2005-2006,19,NAC Breda,Roda JC Kerkrade,0,4,2,0,3,4,-4,3.0,9.0
13896,2005-2006,19,RKC Waalwijk,RBC Roosendaal,1,1,3,1,1,2,0,8.0,1.0
13897,2005-2006,19,ADO Den Haag,FC Utrecht,2,3,2,0,3,5,-1,6.0,8.0
13898,2005-2006,19,Vitesse,Feyenoord,0,1,2,0,3,1,-1,3.0,12.0
13899,2005-2006,19,Willem II,FC Twente,1,1,3,1,1,2,0,2.0,5.0
13900,2005-2006,19,AFC Ajax,NEC Nijmegen,1,1,3,1,1,2,0,10.0,7.0
13901,2005-2006,19,Sparta Rotterdam,PSV,0,1,2,0,3,1,-1,4.0,10.0
13902,2005-2006,20,PSV,RKC Waalwijk,2,0,1,3,0,2,2,13.0,5.0
13903,2005-2006,20,sc Heerenveen,Sparta Rotterdam,0,0,3,1,1,0,0,8.0,5.0
13904,2005-2006,20,RBC Roosendaal,Heracles Almelo,1,2,2,0,3,3,-1,1.0,10.0
13905,2005-2006,20,Vitesse,Willem II,2,1,1,3,0,3,1,6.0,1.0
13906,2005-2006,20,AZ Alkmaar,FC Groningen,1,1,3,1,1,2,0,10.0,10.0
13907,2005-2006,20,FC Twente,AFC Ajax,2,3,2,0,3,5,-1,5.0,10.0
13908,2005-2006,20,Feyenoord,Roda JC Kerkrade,0,0,3,1,1,0,0,10.0,10.0
13909,2005-2006,20,FC Utrecht,NAC Breda,2,2,3,1,1,4,0,9.0,1.0
13910,2005-2006,20,NEC Nijmegen,ADO Den Haag,5,0,1,3,0,5,5,7.0,3.0
13911,2005-2006,21,Roda JC Kerkrade,AZ Alkmaar,1,4,2,0,3,5,-3,7.0,10.0
13912,2005-2006,21,RBC Roosendaal,sc Heerenveen,0,2,2,0,3,2,-2,1.0,8.0
13913,2005-2006,21,Willem II,NEC Nijmegen,2,2,3,1,1,4,0,2.0,8.0
13914,2005-2006,21,Sparta Rotterdam,FC Twente,1,0,1,3,0,1,1,5.0,5.0
13915,2005-2006,21,ADO Den Haag,PSV,0,2,2,0,3,2,-2,0.0,13.0
13916,2005-2006,21,AFC Ajax,FC Utrecht,1,4,2,0,3,5,-3,7.0,11.0
13917,2005-2006,21,RKC Waalwijk,Vitesse,0,1,2,0,3,1,-1,5.0,9.0
13918,2005-2006,21,FC Groningen,NAC Breda,3,2,1,3,0,5,1,10.0,1.0
13919,2005-2006,21,Heracles Almelo,Feyenoord,0,4,2,0,3,4,-4,9.0,13.0
13920,2005-2006,22,Willem II,RBC Roosendaal,3,1,1,3,0,4,2,5.0,1.0
13921,2005-2006,22,PSV,Roda JC Kerkrade,3,2,1,3,0,5,1,13.0,4.0
13922,2005-2006,22,NAC Breda,Sparta Rotterdam,0,0,3,1,1,0,0,2.0,5.0
13923,2005-2006,22,FC Groningen,Heracles Almelo,0,0,3,1,1,0,0,11.0,7.0
13924,2005-2006,22,AZ Alkmaar,Vitesse,1,1,3,1,1,2,0,11.0,7.0
13925,2005-2006,22,Feyenoord,AFC Ajax,3,2,1,3,0,5,1,13.0,4.0
13926,2005-2006,22,RKC Waalwijk,NEC Nijmegen,1,3,2,0,3,4,-2,4.0,11.0
13927,2005-2006,22,FC Twente,FC Utrecht,3,0,1,3,0,3,3,5.0,10.0
13928,2005-2006,22,sc Heerenveen,ADO Den Haag,3,0,1,3,0,3,3,10.0,0.0
13929,2005-2006,23,RBC Roosendaal,AZ Alkmaar,0,5,2,0,3,5,-5,1.0,11.0
13930,2005-2006,23,Sparta Rotterdam,FC Groningen,1,0,1,3,0,1,1,8.0,8.0
13931,2005-2006,23,ADO Den Haag,NAC Breda,0,3,2,0,3,3,-3,0.0,5.0
13932,2005-2006,23,Heracles Almelo,sc Heerenveen,1,1,3,1,1,2,0,5.0,8.0
13933,2005-2006,23,NEC Nijmegen,Feyenoord,1,2,2,0,3,3,-1,8.0,13.0
13934,2005-2006,23,Vitesse,FC Twente,1,2,2,0,3,3,-1,7.0,7.0
13935,2005-2006,23,FC Utrecht,PSV,1,2,2,0,3,3,-1,7.0,15.0
13936,2005-2006,23,Roda JC Kerkrade,RKC Waalwijk,1,0,1,3,0,1,1,7.0,1.0
13937,2005-2006,23,AFC Ajax,Willem II,1,0,1,3,0,1,1,7.0,5.0
13938,2005-2006,24,Sparta Rotterdam,AZ Alkmaar,0,1,2,0,3,1,-1,8.0,11.0
13939,2005-2006,24,sc Heerenveen,Vitesse,4,1,1,3,0,5,3,11.0,7.0
13940,2005-2006,24,PSV,Heracles Almelo,1,0,1,3,0,1,1,15.0,5.0
13941,2005-2006,24,FC Twente,Roda JC Kerkrade,1,0,1,3,0,1,1,9.0,4.0
13942,2005-2006,24,RKC Waalwijk,Willem II,1,0,1,3,0,1,1,3.0,4.0
13943,2005-2006,24,ADO Den Haag,AFC Ajax,1,2,2,0,3,3,-1,0.0,9.0
13944,2005-2006,24,FC Utrecht,NEC Nijmegen,1,1,3,1,1,2,0,5.0,8.0
13945,2005-2006,24,NAC Breda,Feyenoord,3,3,3,1,1,6,0,6.0,11.0
13946,2005-2006,24,RBC Roosendaal,FC Groningen,1,2,2,0,3,3,-1,0.0,8.0
13947,2005-2006,25,NEC Nijmegen,FC Twente,0,3,2,0,3,3,-3,5.0,12.0
13948,2005-2006,25,Vitesse,PSV,1,3,2,0,3,4,-2,4.0,15.0
13949,2005-2006,25,Roda JC Kerkrade,sc Heerenveen,2,1,1,3,0,3,1,6.0,10.0
13950,2005-2006,25,FC Groningen,RKC Waalwijk,1,0,1,3,0,1,1,10.0,3.0
13951,2005-2006,25,Feyenoord,Sparta Rotterdam,4,0,1,3,0,4,4,13.0,7.0
13952,2005-2006,25,AZ Alkmaar,FC Utrecht,2,3,2,0,3,5,-1,10.0,7.0
13953,2005-2006,25,Heracles Almelo,ADO Den Haag,1,3,2,0,3,4,-2,2.0,3.0
13954,2005-2006,25,AFC Ajax,RBC Roosendaal,6,0,1,3,0,6,6,9.0,0.0
13955,2005-2006,25,Willem II,NAC Breda,2,0,1,3,0,2,2,7.0,5.0
13956,2005-2006,26,RBC Roosendaal,NEC Nijmegen,2,0,1,3,0,2,2,3.0,4.0
13957,2005-2006,26,RKC Waalwijk,FC Twente,0,0,3,1,1,0,0,4.0,13.0
13958,2005-2006,26,ADO Den Haag,Vitesse,2,0,1,3,0,2,2,6.0,1.0
13959,2005-2006,26,Sparta Rotterdam,Willem II,3,2,1,3,0,5,1,7.0,6.0
13960,2005-2006,26,AZ Alkmaar,PSV,1,2,2,0,3,3,-1,7.0,15.0
13961,2005-2006,26,sc Heerenveen,NAC Breda,2,1,1,3,0,3,1,10.0,5.0
13962,2005-2006,26,FC Utrecht,Roda JC Kerkrade,2,1,1,3,0,3,1,7.0,6.0
13963,2005-2006,26,Heracles Almelo,AFC Ajax,1,3,2,0,3,4,-2,2.0,12.0
13964,2005-2006,26,FC Groningen,Feyenoord,1,1,3,1,1,2,0,8.0,11.0
13965,2005-2006,27,NEC Nijmegen,AZ Alkmaar,0,2,2,0,3,2,-2,1.0,9.0
13966,2005-2006,27,NAC Breda,RBC Roosendaal,2,1,1,3,0,3,1,7.0,3.0
13967,2005-2006,27,Willem II,FC Groningen,5,0,1,3,0,5,5,6.0,7.0
13968,2005-2006,27,PSV,sc Heerenveen,4,1,1,3,0,5,3,15.0,7.0
13969,2005-2006,27,Vitesse,Roda JC Kerkrade,1,3,2,0,3,4,-2,0.0,9.0
13970,2005-2006,27,Feyenoord,FC Utrecht,3,0,1,3,0,3,3,11.0,7.0
13971,2005-2006,27,RKC Waalwijk,ADO Den Haag,3,0,1,3,0,3,3,7.0,6.0
13972,2005-2006,27,FC Twente,Heracles Almelo,2,0,1,3,0,2,2,13.0,1.0
13973,2005-2006,27,AFC Ajax,Sparta Rotterdam,6,0,1,3,0,6,6,15.0,6.0
13974,2005-2006,28,FC Twente,NAC Breda,1,0,1,3,0,1,1,13.0,4.0
13975,2005-2006,28,Roda JC Kerkrade,Sparta Rotterdam,1,1,3,1,1,2,0,7.0,4.0
13976,2005-2006,28,ADO Den Haag,FC Groningen,2,1,1,3,0,3,1,9.0,7.0
13977,2005-2006,28,AFC Ajax,PSV,0,0,3,1,1,0,0,13.0,13.0
13978,2005-2006,28,NEC Nijmegen,Heracles Almelo,2,0,1,3,0,2,2,4.0,0.0
13979,2005-2006,28,FC Utrecht,sc Heerenveen,2,0,1,3,0,2,2,10.0,6.0
13980,2005-2006,28,Vitesse,RBC Roosendaal,5,1,1,3,0,6,4,3.0,3.0
13981,2005-2006,28,Willem II,AZ Alkmaar,1,3,2,0,3,4,-2,6.0,9.0
13982,2005-2006,28,Feyenoord,RKC Waalwijk,1,1,3,1,1,2,0,9.0,8.0
13983,2005-2006,29,NAC Breda,Vitesse,2,2,3,1,1,4,0,4.0,4.0
13984,2005-2006,29,ADO Den Haag,Roda JC Kerkrade,1,1,3,1,1,2,0,10.0,8.0
13985,2005-2006,29,sc Heerenveen,RKC Waalwijk,2,1,1,3,0,3,1,6.0,5.0
13986,2005-2006,29,PSV,NEC Nijmegen,1,0,1,3,0,1,1,13.0,3.0
13987,2005-2006,29,Heracles Almelo,Willem II,1,0,1,3,0,1,1,3.0,6.0
13988,2005-2006,29,AZ Alkmaar,Feyenoord,1,0,1,3,0,1,1,9.0,8.0
13989,2005-2006,29,RBC Roosendaal,FC Twente,1,1,3,1,1,2,0,4.0,11.0
13990,2005-2006,29,FC Groningen,AFC Ajax,3,2,1,3,0,5,1,7.0,10.0
13991,2005-2006,29,Sparta Rotterdam,FC Utrecht,0,1,2,0,3,1,-1,4.0,12.0
13992,2005-2006,30,Vitesse,Sparta Rotterdam,3,1,1,3,0,4,2,7.0,4.0
13993,2005-2006,30,Willem II,PSV,0,3,2,0,3,3,-3,3.0,13.0
13994,2005-2006,30,Roda JC Kerkrade,RBC Roosendaal,5,1,1,3,0,6,4,8.0,4.0
13995,2005-2006,30,FC Twente,sc Heerenveen,1,2,2,0,3,3,-1,8.0,9.0
13996,2005-2006,30,NEC Nijmegen,FC Groningen,2,2,3,1,1,4,0,4.0,5.0
13997,2005-2006,30,Feyenoord,ADO Den Haag,0,2,2,0,3,2,-2,5.0,10.0
13998,2005-2006,30,FC Utrecht,Heracles Almelo,1,0,1,3,0,1,1,12.0,3.0
13999,2005-2006,30,RKC Waalwijk,AZ Alkmaar,0,1,2,0,3,1,-1,5.0,12.0
14000,2005-2006,30,AFC Ajax,NAC Breda,1,1,3,1,1,2,0,8.0,5.0
14001,2005-2006,31,FC Utrecht,RKC Waalwijk,3,1,1,3,0,4,2,12.0,4.0
14002,2005-2006,31,RBC Roosendaal,PSV,1,2,2,0,3,3,-1,1.0,13.0
14003,2005-2006,31,ADO Den Haag,Willem II,1,1,3,1,1,2,0,8.0,4.0
14004,2005-2006,31,Heracles Almelo,Sparta Rotterdam,1,0,1,3,0,1,1,6.0,1.0
14005,2005-2006,31,NEC Nijmegen,sc Heerenveen,4,1,1,3,0,5,3,7.0,6.0
14006,2005-2006,31,Roda JC Kerkrade,AFC Ajax,2,1,1,3,0,3,1,11.0,5.0
14007,2005-2006,31,FC Groningen,Vitesse,2,1,1,3,0,3,1,7.0,7.0
14008,2005-2006,31,Feyenoord,FC Twente,4,2,1,3,0,6,2,7.0,7.0
14009,2005-2006,31,AZ Alkmaar,NAC Breda,3,2,1,3,0,5,1,15.0,5.0
14010,2005-2006,32,sc Heerenveen,Feyenoord,1,1,3,1,1,2,0,7.0,5.0
14011,2005-2006,32,NAC Breda,NEC Nijmegen,2,1,1,3,0,3,1,5.0,7.0
14012,2005-2006,32,RKC Waalwijk,Heracles Almelo,0,2,2,0,3,2,-2,1.0,9.0
14013,2005-2006,32,Sparta Rotterdam,RBC Roosendaal,5,0,1,3,0,5,5,4.0,1.0
14014,2005-2006,32,PSV,FC Groningen,1,1,3,1,1,2,0,11.0,8.0
14015,2005-2006,32,Willem II,Roda JC Kerkrade,2,2,3,1,1,4,0,2.0,9.0
14016,2005-2006,32,Vitesse,FC Utrecht,1,0,1,3,0,1,1,10.0,12.0
14017,2005-2006,32,FC Twente,ADO Den Haag,2,0,1,3,0,2,2,7.0,8.0
14018,2005-2006,32,AFC Ajax,AZ Alkmaar,1,0,1,3,0,1,1,5.0,12.0
14019,2005-2006,33,Heracles Almelo,NAC Breda,4,2,1,3,0,6,2,12.0,5.0
14020,2005-2006,33,RBC Roosendaal,ADO Den Haag,1,2,2,0,3,3,-1,1.0,8.0
14021,2005-2006,33,FC Groningen,FC Utrecht,2,1,1,3,0,3,1,11.0,9.0
14022,2005-2006,33,PSV,Feyenoord,1,1,3,1,1,2,0,11.0,5.0
14023,2005-2006,33,AFC Ajax,Vitesse,2,1,1,3,0,3,1,7.0,7.0
14024,2005-2006,33,AZ Alkmaar,FC Twente,0,0,3,1,1,0,0,10.0,5.0
14025,2005-2006,33,Willem II,sc Heerenveen,4,3,1,3,0,7,1,5.0,7.0
14026,2005-2006,33,Sparta Rotterdam,RKC Waalwijk,3,2,1,3,0,5,1,6.0,0.0
14027,2005-2006,33,NEC Nijmegen,Roda JC Kerkrade,0,3,2,0,3,3,-3,4.0,11.0
14028,2005-2006,34,NAC Breda,PSV,2,6,2,0,3,8,-4,4.0,11.0
14029,2005-2006,34,ADO Den Haag,Sparta Rotterdam,0,2,2,0,3,2,-2,7.0,9.0
14030,2005-2006,34,Vitesse,NEC Nijmegen,1,1,3,1,1,2,0,7.0,5.0
14031,2005-2006,34,Feyenoord,RBC Roosendaal,2,0,1,3,0,2,2,8.0,0.0
14032,2005-2006,34,RKC Waalwijk,AFC Ajax,2,4,2,0,3,6,-2,0.0,10.0
14033,2005-2006,34,FC Twente,FC Groningen,1,1,3,1,1,2,0,5.0,9.0
14034,2005-2006,34,sc Heerenveen,AZ Alkmaar,2,4,2,0,3,6,-2,4.0,10.0
14035,2005-2006,34,Roda JC Kerkrade,Heracles Almelo,2,1,1,3,0,3,1,13.0,9.0
14036,2005-2006,34,FC Utrecht,Willem II,1,4,2,0,3,5,-3,6.0,8.0
14037,2006-2007,1,Sparta Rotterdam,Vitesse,1,2,2,0,3,3,-1,9.0,7.0
14038,2006-2007,1,ADO Den Haag,sc Heerenveen,2,3,2,0,3,5,-1,4.0,4.0
14039,2006-2007,1,Willem II,FC Utrecht,2,1,1,3,0,3,1,11.0,3.0
14040,2006-2007,1,SBV Excelsior,Roda JC Kerkrade,0,1,2,0,3,1,-1,1.0,13.0
14041,2006-2007,1,AZ Alkmaar,NAC Breda,8,1,1,3,0,9,7,10.0,3.0
14042,2006-2007,1,AFC Ajax,RKC Waalwijk,5,0,1,3,0,5,5,12.0,0.0
14043,2006-2007,1,FC Groningen,Feyenoord,3,0,1,3,0,3,3,11.0,8.0
14044,2006-2007,1,Heracles Almelo,FC Twente,3,0,1,3,0,3,3,12.0,5.0
14045,2006-2007,1,PSV,NEC Nijmegen,3,1,1,3,0,4,2,11.0,4.0
14046,2006-2007,2,Roda JC Kerkrade,ADO Den Haag,1,0,1,3,0,1,1,13.0,3.0
14047,2006-2007,2,sc Heerenveen,Willem II,5,0,1,3,0,5,5,7.0,10.0
14048,2006-2007,2,FC Utrecht,Sparta Rotterdam,2,2,3,1,1,4,0,1.0,10.0
14049,2006-2007,2,RKC Waalwijk,SBV Excelsior,1,1,3,1,1,2,0,1.0,2.0
14050,2006-2007,2,Vitesse,AZ Alkmaar,1,3,2,0,3,4,-2,7.0,10.0
14051,2006-2007,2,FC Twente,PSV,1,0,1,3,0,1,1,8.0,8.0
14052,2006-2007,2,Feyenoord,Heracles Almelo,0,0,3,1,1,0,0,6.0,10.0
14053,2006-2007,2,NEC Nijmegen,FC Groningen,1,1,3,1,1,2,0,2.0,9.0
14054,2006-2007,2,NAC Breda,AFC Ajax,1,2,2,0,3,3,-1,3.0,15.0
14055,2006-2007,3,ADO Den Haag,NAC Breda,0,2,2,0,3,2,-2,3.0,3.0
14056,2006-2007,3,FC Twente,Roda JC Kerkrade,2,2,3,1,1,4,0,6.0,13.0
14057,2006-2007,3,Willem II,PSV,1,3,2,0,3,4,-2,9.0,10.0
14058,2006-2007,3,SBV Excelsior,sc Heerenveen,3,1,1,3,0,4,2,5.0,6.0
14059,2006-2007,3,AFC Ajax,Vitesse,3,0,1,3,0,3,3,15.0,4.0
14060,2006-2007,3,FC Groningen,Heracles Almelo,2,1,1,3,0,3,1,11.0,7.0
14061,2006-2007,3,FC Utrecht,RKC Waalwijk,5,0,1,3,0,5,5,4.0,1.0
14062,2006-2007,3,NEC Nijmegen,AZ Alkmaar,0,2,2,0,3,2,-2,2.0,13.0
14063,2006-2007,3,Sparta Rotterdam,Feyenoord,1,4,2,0,3,5,-3,7.0,8.0
14064,2006-2007,4,RKC Waalwijk,ADO Den Haag,1,0,1,3,0,1,1,4.0,0.0
14065,2006-2007,4,SBV Excelsior,Willem II,3,2,1,3,0,5,1,7.0,6.0
14066,2006-2007,4,Heracles Almelo,FC Utrecht,3,0,1,3,0,3,3,7.0,4.0
14067,2006-2007,4,Vitesse,NAC Breda,0,1,2,0,3,1,-1,4.0,6.0
14068,2006-2007,4,PSV,Feyenoord,2,1,1,3,0,3,1,12.0,7.0
14069,2006-2007,4,Roda JC Kerkrade,AFC Ajax,2,0,1,3,0,2,2,13.0,12.0
14070,2006-2007,4,AZ Alkmaar,FC Twente,2,2,3,1,1,4,0,13.0,6.0
14071,2006-2007,4,sc Heerenveen,NEC Nijmegen,3,0,1,3,0,3,3,9.0,2.0
14072,2006-2007,4,Sparta Rotterdam,FC Groningen,0,1,2,0,3,1,-1,4.0,11.0
14073,2006-2007,5,NAC Breda,Willem II,0,0,3,1,1,0,0,7.0,4.0
14074,2006-2007,5,ADO Den Haag,PSV,0,2,2,0,3,2,-2,0.0,12.0
14075,2006-2007,5,FC Twente,Sparta Rotterdam,2,0,1,3,0,2,2,8.0,1.0
14076,2006-2007,5,Vitesse,Heracles Almelo,4,0,1,3,0,4,4,6.0,7.0
14077,2006-2007,5,AFC Ajax,NEC Nijmegen,2,0,1,3,0,2,2,12.0,1.0
14078,2006-2007,5,FC Groningen,RKC Waalwijk,1,1,3,1,1,2,0,11.0,5.0
14079,2006-2007,5,FC Utrecht,sc Heerenveen,1,0,1,3,0,1,1,7.0,9.0
14080,2006-2007,5,Feyenoord,SBV Excelsior,1,0,1,3,0,1,1,7.0,7.0
14081,2006-2007,5,Roda JC Kerkrade,AZ Alkmaar,0,2,2,0,3,2,-2,10.0,13.0
14082,2006-2007,6,NEC Nijmegen,Heracles Almelo,2,0,1,3,0,2,2,4.0,4.0
14083,2006-2007,6,Willem II,Roda JC Kerkrade,0,1,2,0,3,1,-1,1.0,10.0
14084,2006-2007,6,SBV Excelsior,Sparta Rotterdam,3,1,1,3,0,4,2,10.0,1.0
14085,2006-2007,6,FC Twente,RKC Waalwijk,4,3,1,3,0,7,1,11.0,5.0
14086,2006-2007,6,FC Utrecht,AFC Ajax,2,3,2,0,3,5,-1,7.0,12.0
14087,2006-2007,6,AZ Alkmaar,ADO Den Haag,2,2,3,1,1,4,0,11.0,1.0
14088,2006-2007,6,FC Groningen,Vitesse,4,3,1,3,0,7,1,11.0,3.0
14089,2006-2007,6,Feyenoord,NAC Breda,3,2,1,3,0,5,1,10.0,7.0
14090,2006-2007,6,sc Heerenveen,PSV,0,0,3,1,1,0,0,7.0,10.0
14091,2006-2007,7,ADO Den Haag,FC Twente,1,2,2,0,3,3,-1,1.0,11.0
14092,2006-2007,7,AFC Ajax,FC Groningen,3,2,1,3,0,5,1,12.0,10.0
14093,2006-2007,7,NAC Breda,NEC Nijmegen,0,2,2,0,3,2,-2,7.0,6.0
14094,2006-2007,7,Sparta Rotterdam,AZ Alkmaar,0,2,2,0,3,2,-2,0.0,11.0
14095,2006-2007,7,Vitesse,Willem II,1,0,1,3,0,1,1,6.0,1.0
14096,2006-2007,7,SBV Excelsior,FC Utrecht,0,1,2,0,3,1,-1,9.0,9.0
14097,2006-2007,7,Heracles Almelo,sc Heerenveen,1,0,1,3,0,1,1,6.0,4.0
14098,2006-2007,7,PSV,Roda JC Kerkrade,4,1,1,3,0,5,3,13.0,7.0
14099,2006-2007,7,RKC Waalwijk,Feyenoord,2,2,3,1,1,4,0,5.0,10.0
14100,2006-2007,8,Willem II,Heracles Almelo,2,0,1,3,0,2,2,4.0,6.0
14101,2006-2007,8,Roda JC Kerkrade,Sparta Rotterdam,2,1,1,3,0,3,1,9.0,0.0
14102,2006-2007,8,FC Twente,SBV Excelsior,4,1,1,3,0,5,3,13.0,6.0
14103,2006-2007,8,RKC Waalwijk,NAC Breda,0,1,2,0,3,1,-1,5.0,7.0
14104,2006-2007,8,AZ Alkmaar,PSV,1,3,2,0,3,4,-2,8.0,13.0
14105,2006-2007,8,FC Utrecht,ADO Den Haag,2,0,1,3,0,2,2,9.0,1.0
14106,2006-2007,8,Feyenoord,AFC Ajax,0,4,2,0,3,4,-4,7.0,12.0
14107,2006-2007,8,NEC Nijmegen,Vitesse,1,0,1,3,0,1,1,9.0,6.0
14108,2006-2007,8,sc Heerenveen,FC Groningen,4,2,1,3,0,6,2,7.0,7.0
14109,2006-2007,9,FC Groningen,SBV Excelsior,2,1,1,3,0,3,1,7.0,3.0
14110,2006-2007,9,Heracles Almelo,RKC Waalwijk,1,1,3,1,1,2,0,4.0,3.0
14111,2006-2007,9,NEC Nijmegen,Roda JC Kerkrade,0,0,3,1,1,0,0,10.0,7.0
14112,2006-2007,9,PSV,Sparta Rotterdam,7,0,1,3,0,7,7,13.0,0.0
14113,2006-2007,9,AFC Ajax,ADO Den Haag,2,0,1,3,0,2,2,15.0,1.0
14114,2006-2007,9,Feyenoord,FC Twente,2,1,1,3,0,3,1,10.0,12.0
14115,2006-2007,9,NAC Breda,FC Utrecht,2,1,1,3,0,3,1,7.0,9.0
14116,2006-2007,9,Willem II,AZ Alkmaar,0,4,2,0,3,4,-4,4.0,10.0
14117,2006-2007,9,Vitesse,sc Heerenveen,1,3,2,0,3,4,-2,6.0,7.0
14118,2006-2007,10,ADO Den Haag,Heracles Almelo,2,0,1,3,0,2,2,4.0,4.0
14119,2006-2007,10,sc Heerenveen,AFC Ajax,0,2,2,0,3,2,-2,7.0,15.0
14120,2006-2007,10,SBV Excelsior,Vitesse,2,2,3,1,1,4,0,4.0,4.0
14121,2006-2007,10,RKC Waalwijk,PSV,0,3,2,0,3,3,-3,2.0,13.0
14122,2006-2007,10,AZ Alkmaar,FC Utrecht,5,1,1,3,0,6,4,10.0,6.0
14123,2006-2007,10,Roda JC Kerkrade,Feyenoord,1,2,2,0,3,3,-1,7.0,10.0
14124,2006-2007,10,FC Twente,NEC Nijmegen,4,0,1,3,0,4,4,12.0,10.0
14125,2006-2007,10,NAC Breda,FC Groningen,0,0,3,1,1,0,0,7.0,7.0
14126,2006-2007,10,Sparta Rotterdam,Willem II,1,0,1,3,0,1,1,3.0,3.0
14127,2006-2007,11,NEC Nijmegen,Willem II,1,2,2,0,3,3,-1,7.0,6.0
14128,2006-2007,11,ADO Den Haag,SBV Excelsior,2,2,3,1,1,4,0,4.0,2.0
14129,2006-2007,11,PSV,NAC Breda,3,0,1,3,0,3,3,15.0,7.0
14130,2006-2007,11,FC Groningen,Roda JC Kerkrade,2,1,1,3,0,3,1,7.0,4.0
14131,2006-2007,11,sc Heerenveen,Sparta Rotterdam,2,0,1,3,0,2,2,9.0,3.0
14132,2006-2007,11,FC Utrecht,FC Twente,0,0,3,1,1,0,0,7.0,10.0
14133,2006-2007,11,Feyenoord,Vitesse,2,1,1,3,0,3,1,10.0,4.0
14134,2006-2007,11,Heracles Almelo,AFC Ajax,0,3,2,0,3,3,-3,4.0,15.0
14135,2006-2007,11,RKC Waalwijk,AZ Alkmaar,0,2,2,0,3,2,-2,2.0,12.0
14136,2006-2007,12,NAC Breda,sc Heerenveen,1,1,3,1,1,2,0,8.0,10.0
14137,2006-2007,12,Roda JC Kerkrade,RKC Waalwijk,1,1,3,1,1,2,0,5.0,2.0
14138,2006-2007,12,SBV Excelsior,NEC Nijmegen,1,1,3,1,1,2,0,3.0,5.0
14139,2006-2007,12,AZ Alkmaar,Heracles Almelo,5,0,1,3,0,5,5,12.0,1.0
14140,2006-2007,12,AFC Ajax,PSV,0,1,2,0,3,1,-1,12.0,15.0
14141,2006-2007,12,Sparta Rotterdam,ADO Den Haag,2,1,1,3,0,3,1,6.0,4.0
14142,2006-2007,12,Willem II,Feyenoord,3,5,2,0,3,8,-2,6.0,12.0
14143,2006-2007,12,FC Twente,FC Groningen,7,1,1,3,0,8,6,10.0,7.0
14144,2006-2007,12,Vitesse,FC Utrecht,4,2,1,3,0,6,2,4.0,4.0
14145,2006-2007,13,Heracles Almelo,NAC Breda,2,0,1,3,0,2,2,4.0,5.0
14146,2006-2007,13,PSV,SBV Excelsior,4,0,1,3,0,4,4,15.0,3.0
14147,2006-2007,13,Feyenoord,AZ Alkmaar,3,2,1,3,0,5,1,15.0,12.0
14148,2006-2007,13,RKC Waalwijk,sc Heerenveen,0,2,2,0,3,2,-2,2.0,10.0
14149,2006-2007,13,NEC Nijmegen,Sparta Rotterdam,1,2,2,0,3,3,-1,2.0,9.0
14150,2006-2007,13,ADO Den Haag,Vitesse,0,3,2,0,3,3,-3,4.0,7.0
14151,2006-2007,13,AFC Ajax,FC Twente,1,1,3,1,1,2,0,10.0,8.0
14152,2006-2007,13,FC Groningen,Willem II,4,1,1,3,0,5,3,10.0,3.0
14153,2006-2007,13,FC Utrecht,Roda JC Kerkrade,2,0,1,3,0,2,2,4.0,2.0
14154,2006-2007,14,FC Twente,Vitesse,2,0,1,3,0,2,2,11.0,7.0
14155,2006-2007,14,PSV,FC Utrecht,5,0,1,3,0,5,5,15.0,4.0
14156,2006-2007,14,Willem II,RKC Waalwijk,3,1,1,3,0,4,2,6.0,1.0
14157,2006-2007,14,SBV Excelsior,Heracles Almelo,6,1,1,3,0,7,5,6.0,3.0
14158,2006-2007,14,NEC Nijmegen,Feyenoord,4,1,1,3,0,5,3,4.0,12.0
14159,2006-2007,14,Sparta Rotterdam,AFC Ajax,3,0,1,3,0,3,3,12.0,7.0
14160,2006-2007,14,sc Heerenveen,AZ Alkmaar,1,3,2,0,3,4,-2,7.0,12.0
14161,2006-2007,14,FC Groningen,ADO Den Haag,2,5,2,0,3,7,-3,7.0,7.0
14162,2006-2007,14,Roda JC Kerkrade,NAC Breda,3,2,1,3,0,5,1,4.0,2.0
14163,2006-2007,15,RKC Waalwijk,Sparta Rotterdam,2,1,1,3,0,3,1,4.0,9.0
14164,2006-2007,15,ADO Den Haag,NEC Nijmegen,0,2,2,0,3,2,-2,4.0,7.0
14165,2006-2007,15,NAC Breda,FC Twente,0,0,3,1,1,0,0,2.0,9.0
14166,2006-2007,15,Heracles Almelo,Roda JC Kerkrade,1,1,3,1,1,2,0,4.0,5.0
14167,2006-2007,15,Vitesse,PSV,0,1,2,0,3,1,-1,6.0,15.0
14168,2006-2007,15,AFC Ajax,Willem II,6,0,1,3,0,6,6,7.0,6.0
14169,2006-2007,15,AZ Alkmaar,SBV Excelsior,5,0,1,3,0,5,5,12.0,5.0
14170,2006-2007,15,FC Utrecht,FC Groningen,3,0,1,3,0,3,3,7.0,6.0
14171,2006-2007,15,Feyenoord,sc Heerenveen,4,3,1,3,0,7,1,12.0,7.0
14172,2006-2007,16,sc Heerenveen,Roda JC Kerkrade,1,0,1,3,0,1,1,7.0,5.0
14173,2006-2007,16,NAC Breda,SBV Excelsior,2,1,1,3,0,3,1,5.0,4.0
14174,2006-2007,16,FC Groningen,PSV,0,2,2,0,3,2,-2,3.0,15.0
14175,2006-2007,16,Heracles Almelo,Sparta Rotterdam,2,3,2,0,3,5,-1,4.0,12.0
14176,2006-2007,16,NEC Nijmegen,FC Utrecht,2,0,1,3,0,2,2,10.0,6.0
14177,2006-2007,16,AFC Ajax,AZ Alkmaar,2,2,3,1,1,4,0,5.0,10.0
14178,2006-2007,16,Feyenoord,ADO Den Haag,3,1,1,3,0,4,2,12.0,3.0
14179,2006-2007,16,Vitesse,RKC Waalwijk,3,1,1,3,0,4,2,9.0,4.0
14180,2006-2007,16,Willem II,FC Twente,1,3,2,0,3,4,-2,3.0,11.0
14181,2006-2007,17,PSV,Heracles Almelo,3,0,1,3,0,3,3,15.0,4.0
14182,2006-2007,17,ADO Den Haag,Willem II,2,1,1,3,0,3,1,6.0,3.0
14183,2006-2007,17,Roda JC Kerkrade,Vitesse,2,4,2,0,3,6,-2,4.0,9.0
14184,2006-2007,17,Sparta Rotterdam,NAC Breda,0,3,2,0,3,3,-3,9.0,7.0
14185,2006-2007,17,SBV Excelsior,AFC Ajax,1,3,2,0,3,4,-2,3.0,8.0
14186,2006-2007,17,FC Utrecht,Feyenoord,2,1,1,3,0,3,1,9.0,9.0
14187,2006-2007,17,RKC Waalwijk,NEC Nijmegen,0,1,2,0,3,1,-1,3.0,12.0
14188,2006-2007,17,AZ Alkmaar,FC Groningen,2,0,1,3,0,2,2,10.0,3.0
14189,2006-2007,17,FC Twente,sc Heerenveen,5,1,1,3,0,6,4,11.0,6.0
14190,2006-2007,18,Heracles Almelo,FC Groningen,0,1,2,0,3,1,-1,1.0,3.0
14191,2006-2007,18,sc Heerenveen,SBV Excelsior,2,0,1,3,0,2,2,6.0,3.0
14192,2006-2007,18,NAC Breda,ADO Den Haag,2,2,3,1,1,4,0,8.0,7.0
14193,2006-2007,18,PSV,Willem II,4,0,1,3,0,4,4,15.0,3.0
14194,2006-2007,18,Feyenoord,Sparta Rotterdam,3,2,1,3,0,5,1,9.0,6.0
14195,2006-2007,18,Roda JC Kerkrade,FC Twente,2,0,1,3,0,2,2,7.0,10.0
14196,2006-2007,18,Vitesse,AFC Ajax,4,2,1,3,0,6,2,9.0,7.0
14197,2006-2007,18,AZ Alkmaar,NEC Nijmegen,0,0,3,1,1,0,0,11.0,13.0
14198,2006-2007,18,RKC Waalwijk,FC Utrecht,1,1,3,1,1,2,0,4.0,7.0
14199,2006-2007,19,Feyenoord,PSV,1,1,3,1,1,2,0,10.0,13.0
14200,2006-2007,19,Willem II,SBV Excelsior,2,1,1,3,0,3,1,3.0,0.0
14201,2006-2007,19,FC Groningen,Sparta Rotterdam,0,1,2,0,3,1,-1,3.0,6.0
14202,2006-2007,19,ADO Den Haag,RKC Waalwijk,1,1,3,1,1,2,0,5.0,5.0
14203,2006-2007,19,FC Twente,AZ Alkmaar,3,0,1,3,0,3,3,10.0,8.0
14204,2006-2007,19,FC Utrecht,Heracles Almelo,0,0,3,1,1,0,0,8.0,2.0
14205,2006-2007,19,NEC Nijmegen,sc Heerenveen,0,2,2,0,3,2,-2,10.0,9.0
14206,2006-2007,19,NAC Breda,Vitesse,2,1,1,3,0,3,1,11.0,9.0
14207,2006-2007,19,AFC Ajax,Roda JC Kerkrade,2,0,1,3,0,2,2,10.0,4.0
14208,2006-2007,20,SBV Excelsior,Feyenoord,1,3,2,0,3,4,-2,0.0,10.0
14209,2006-2007,20,NEC Nijmegen,AFC Ajax,2,2,3,1,1,4,0,8.0,8.0
14210,2006-2007,20,sc Heerenveen,FC Utrecht,0,0,3,1,1,0,0,10.0,6.0
14211,2006-2007,20,PSV,ADO Den Haag,2,1,1,3,0,3,1,13.0,5.0
14212,2006-2007,20,RKC Waalwijk,FC Groningen,0,2,2,0,3,2,-2,2.0,6.0
14213,2006-2007,20,Sparta Rotterdam,FC Twente,3,0,1,3,0,3,3,9.0,9.0
14214,2006-2007,20,AZ Alkmaar,Roda JC Kerkrade,2,2,3,1,1,4,0,6.0,4.0
14215,2006-2007,20,Heracles Almelo,Vitesse,2,2,3,1,1,4,0,2.0,10.0
14216,2006-2007,20,Willem II,NAC Breda,0,2,2,0,3,2,-2,3.0,13.0
14217,2006-2007,21,ADO Den Haag,AZ Alkmaar,1,3,2,0,3,4,-2,5.0,8.0
14218,2006-2007,21,PSV,sc Heerenveen,3,1,1,3,0,4,2,13.0,7.0
14219,2006-2007,21,Roda JC Kerkrade,Willem II,2,1,1,3,0,3,1,7.0,3.0
14220,2006-2007,21,Heracles Almelo,NEC Nijmegen,0,0,3,1,1,0,0,3.0,6.0
14221,2006-2007,21,RKC Waalwijk,FC Twente,1,2,2,0,3,3,-1,2.0,9.0
14222,2006-2007,21,AFC Ajax,FC Utrecht,2,0,1,3,0,2,2,10.0,6.0
14223,2006-2007,21,NAC Breda,Feyenoord,4,1,1,3,0,5,3,13.0,7.0
14224,2006-2007,21,Sparta Rotterdam,SBV Excelsior,2,1,1,3,0,3,1,9.0,0.0
14225,2006-2007,21,Vitesse,FC Groningen,3,2,1,3,0,5,1,10.0,6.0
14226,2006-2007,22,sc Heerenveen,Heracles Almelo,5,1,1,3,0,6,4,10.0,3.0
14227,2006-2007,22,Willem II,Vitesse,0,0,3,1,1,0,0,4.0,8.0
14228,2006-2007,22,AZ Alkmaar,Sparta Rotterdam,3,0,1,3,0,3,3,8.0,9.0
14229,2006-2007,22,FC Utrecht,SBV Excelsior,1,0,1,3,0,1,1,6.0,0.0
14230,2006-2007,22,NEC Nijmegen,NAC Breda,2,1,1,3,0,3,1,6.0,10.0
14231,2006-2007,22,FC Groningen,AFC Ajax,2,3,2,0,3,5,-1,6.0,10.0
14232,2006-2007,22,FC Twente,ADO Den Haag,3,1,1,3,0,4,2,9.0,2.0
14233,2006-2007,22,Feyenoord,RKC Waalwijk,3,1,1,3,0,4,2,10.0,2.0
14234,2006-2007,22,Roda JC Kerkrade,PSV,2,0,1,3,0,2,2,10.0,10.0
14235,2006-2007,23,FC Groningen,sc Heerenveen,1,1,3,1,1,2,0,4.0,8.0
14236,2006-2007,23,NAC Breda,RKC Waalwijk,2,1,1,3,0,3,1,12.0,1.0
14237,2006-2007,23,PSV,AZ Alkmaar,2,3,2,0,3,5,-1,7.0,10.0
14238,2006-2007,23,SBV Excelsior,FC Twente,1,2,2,0,3,3,-1,0.0,12.0
14239,2006-2007,23,Heracles Almelo,Willem II,2,2,3,1,1,4,0,4.0,5.0
14240,2006-2007,23,ADO Den Haag,FC Utrecht,1,1,3,1,1,2,0,2.0,6.0
14241,2006-2007,23,AFC Ajax,Feyenoord,4,1,1,3,0,5,3,13.0,7.0
14242,2006-2007,23,Vitesse,NEC Nijmegen,1,1,3,1,1,2,0,6.0,6.0
14243,2006-2007,23,Sparta Rotterdam,Roda JC Kerkrade,2,2,3,1,1,4,0,10.0,8.0
14244,2006-2007,24,SBV Excelsior,FC Groningen,0,2,2,0,3,2,-2,0.0,7.0
14245,2006-2007,24,sc Heerenveen,Vitesse,0,0,3,1,1,0,0,6.0,7.0
14246,2006-2007,24,Roda JC Kerkrade,NEC Nijmegen,1,0,1,3,0,1,1,11.0,6.0
14247,2006-2007,24,AZ Alkmaar,Willem II,2,0,1,3,0,2,2,13.0,2.0
14248,2006-2007,24,RKC Waalwijk,Heracles Almelo,2,0,1,3,0,2,2,3.0,3.0
14249,2006-2007,24,ADO Den Haag,AFC Ajax,1,2,2,0,3,3,-1,1.0,13.0
14250,2006-2007,24,FC Twente,Feyenoord,3,0,1,3,0,3,3,12.0,6.0
14251,2006-2007,24,FC Utrecht,NAC Breda,1,0,1,3,0,1,1,8.0,9.0
14252,2006-2007,24,Sparta Rotterdam,PSV,1,1,3,1,1,2,0,8.0,7.0
14253,2006-2007,25,Willem II,ADO Den Haag,2,1,1,3,0,3,1,5.0,1.0
14254,2006-2007,25,NAC Breda,Sparta Rotterdam,3,1,1,3,0,4,2,9.0,5.0
14255,2006-2007,25,Heracles Almelo,PSV,0,2,2,0,3,2,-2,2.0,7.0
14256,2006-2007,25,NEC Nijmegen,RKC Waalwijk,1,0,1,3,0,1,1,8.0,3.0
14257,2006-2007,25,Vitesse,Roda JC Kerkrade,0,0,3,1,1,0,0,7.0,11.0
14258,2006-2007,25,AFC Ajax,SBV Excelsior,2,2,3,1,1,4,0,13.0,1.0
14259,2006-2007,25,FC Groningen,AZ Alkmaar,1,1,3,1,1,2,0,5.0,13.0
14260,2006-2007,25,Feyenoord,FC Utrecht,2,0,1,3,0,2,2,6.0,7.0
14261,2006-2007,25,sc Heerenveen,FC Twente,1,2,2,0,3,3,-1,5.0,15.0
14262,2006-2007,26,FC Utrecht,NEC Nijmegen,3,0,1,3,0,3,3,10.0,7.0
14263,2006-2007,26,PSV,FC Groningen,1,0,1,3,0,1,1,7.0,5.0
14264,2006-2007,26,FC Twente,Willem II,0,0,3,1,1,0,0,13.0,6.0
14265,2006-2007,26,Sparta Rotterdam,Heracles Almelo,0,0,3,1,1,0,0,3.0,2.0
14266,2006-2007,26,Roda JC Kerkrade,sc Heerenveen,1,0,1,3,0,1,1,11.0,5.0
14267,2006-2007,26,ADO Den Haag,Feyenoord,3,3,3,1,1,6,0,2.0,7.0
14268,2006-2007,26,AZ Alkmaar,AFC Ajax,1,1,3,1,1,2,0,11.0,11.0
14269,2006-2007,26,SBV Excelsior,NAC Breda,0,2,2,0,3,2,-2,1.0,9.0
14270,2006-2007,26,RKC Waalwijk,Vitesse,3,1,1,3,0,4,2,6.0,4.0
14271,2006-2007,27,NEC Nijmegen,FC Twente,0,3,2,0,3,3,-3,4.0,13.0
14272,2006-2007,27,PSV,RKC Waalwijk,2,0,1,3,0,2,2,10.0,6.0
14273,2006-2007,27,Willem II,Sparta Rotterdam,0,0,3,1,1,0,0,6.0,4.0
14274,2006-2007,27,FC Groningen,NAC Breda,3,1,1,3,0,4,2,8.0,9.0
14275,2006-2007,27,Vitesse,SBV Excelsior,2,3,2,0,3,5,-1,3.0,4.0
14276,2006-2007,27,AFC Ajax,sc Heerenveen,0,1,2,0,3,1,-1,8.0,5.0
14277,2006-2007,27,FC Utrecht,AZ Alkmaar,0,4,2,0,3,4,-4,7.0,11.0
14278,2006-2007,27,Feyenoord,Roda JC Kerkrade,1,1,3,1,1,2,0,5.0,9.0
14279,2006-2007,27,Heracles Almelo,ADO Den Haag,3,1,1,3,0,4,2,5.0,2.0
14280,2006-2007,28,Roda JC Kerkrade,FC Utrecht,0,0,3,1,1,0,0,9.0,7.0
14281,2006-2007,28,sc Heerenveen,RKC Waalwijk,1,0,1,3,0,1,1,7.0,6.0
14282,2006-2007,28,NAC Breda,Heracles Almelo,1,1,3,1,1,2,0,7.0,5.0
14283,2006-2007,28,Willem II,FC Groningen,3,0,1,3,0,3,3,8.0,7.0
14284,2006-2007,28,Sparta Rotterdam,NEC Nijmegen,0,4,2,0,3,4,-4,3.0,6.0
14285,2006-2007,28,AZ Alkmaar,Feyenoord,0,0,3,1,1,0,0,9.0,6.0
14286,2006-2007,28,SBV Excelsior,PSV,0,0,3,1,1,0,0,5.0,11.0
14287,2006-2007,28,FC Twente,AFC Ajax,1,4,2,0,3,5,-3,10.0,8.0
14288,2006-2007,28,Vitesse,ADO Den Haag,2,2,3,1,1,4,0,3.0,2.0
14289,2006-2007,29,RKC Waalwijk,Roda JC Kerkrade,3,2,1,3,0,5,1,6.0,6.0
14290,2006-2007,29,ADO Den Haag,Sparta Rotterdam,2,4,2,0,3,6,-2,2.0,5.0
14291,2006-2007,29,sc Heerenveen,NAC Breda,4,2,1,3,0,6,2,9.0,7.0
14292,2006-2007,29,NEC Nijmegen,SBV Excelsior,0,1,2,0,3,1,-1,6.0,8.0
14293,2006-2007,29,Heracles Almelo,AZ Alkmaar,0,0,3,1,1,0,0,6.0,7.0
14294,2006-2007,29,FC Groningen,FC Twente,1,1,3,1,1,2,0,5.0,8.0
14295,2006-2007,29,FC Utrecht,Vitesse,2,0,1,3,0,2,2,7.0,2.0
14296,2006-2007,29,Feyenoord,Willem II,0,0,3,1,1,0,0,7.0,9.0
14297,2006-2007,29,PSV,AFC Ajax,1,5,2,0,3,6,-4,10.0,8.0
14298,2006-2007,30,Roda JC Kerkrade,FC Groningen,0,1,2,0,3,1,-1,5.0,7.0
14299,2006-2007,30,Willem II,NEC Nijmegen,1,0,1,3,0,1,1,9.0,3.0
14300,2006-2007,30,NAC Breda,PSV,1,1,3,1,1,2,0,5.0,8.0
14301,2006-2007,30,AZ Alkmaar,RKC Waalwijk,2,0,1,3,0,2,2,9.0,6.0
14302,2006-2007,30,Vitesse,Feyenoord,0,1,2,0,3,1,-1,1.0,7.0
14303,2006-2007,30,AFC Ajax,Heracles Almelo,3,0,1,3,0,3,3,10.0,6.0
14304,2006-2007,30,SBV Excelsior,ADO Den Haag,3,1,1,3,0,4,2,10.0,2.0
14305,2006-2007,30,FC Twente,FC Utrecht,3,0,1,3,0,3,3,8.0,7.0
14306,2006-2007,30,Sparta Rotterdam,sc Heerenveen,2,2,3,1,1,4,0,6.0,10.0
14307,2006-2007,31,Vitesse,Sparta Rotterdam,3,0,1,3,0,3,3,4.0,5.0
14308,2006-2007,31,sc Heerenveen,ADO Den Haag,1,1,3,1,1,2,0,11.0,2.0
14309,2006-2007,31,Roda JC Kerkrade,SBV Excelsior,2,0,1,3,0,2,2,5.0,10.0
14310,2006-2007,31,NEC Nijmegen,PSV,2,1,1,3,0,3,1,6.0,5.0
14311,2006-2007,31,RKC Waalwijk,AFC Ajax,2,2,3,1,1,4,0,4.0,10.0
14312,2006-2007,31,FC Twente,Heracles Almelo,1,1,3,1,1,2,0,8.0,6.0
14313,2006-2007,31,FC Utrecht,Willem II,3,0,1,3,0,3,3,7.0,8.0
14314,2006-2007,31,Feyenoord,FC Groningen,0,4,2,0,3,4,-4,6.0,10.0
14315,2006-2007,31,NAC Breda,AZ Alkmaar,1,4,2,0,3,5,-3,2.0,11.0
14316,2006-2007,32,Sparta Rotterdam,FC Utrecht,1,1,3,1,1,2,0,5.0,8.0
14317,2006-2007,32,AFC Ajax,NAC Breda,2,0,1,3,0,2,2,13.0,2.0
14318,2006-2007,32,ADO Den Haag,Roda JC Kerkrade,0,2,2,0,3,2,-2,2.0,7.0
14319,2006-2007,32,PSV,FC Twente,2,0,1,3,0,2,2,5.0,5.0
14320,2006-2007,32,SBV Excelsior,RKC Waalwijk,0,3,2,0,3,3,-3,7.0,7.0
14321,2006-2007,32,AZ Alkmaar,Vitesse,1,0,1,3,0,1,1,11.0,4.0
14322,2006-2007,32,FC Groningen,NEC Nijmegen,4,1,1,3,0,5,3,10.0,6.0
14323,2006-2007,32,Heracles Almelo,Feyenoord,4,1,1,3,0,5,3,6.0,5.0
14324,2006-2007,32,Willem II,sc Heerenveen,1,3,2,0,3,4,-2,7.0,11.0
14325,2006-2007,33,AFC Ajax,Sparta Rotterdam,5,2,1,3,0,7,3,13.0,5.0
14326,2006-2007,33,AZ Alkmaar,sc Heerenveen,3,1,1,3,0,4,2,13.0,8.0
14327,2006-2007,33,FC Utrecht,PSV,1,1,3,1,1,2,0,8.0,5.0
14328,2006-2007,33,Feyenoord,NEC Nijmegen,1,1,3,1,1,2,0,5.0,4.0
14329,2006-2007,33,Heracles Almelo,SBV Excelsior,3,2,1,3,0,5,1,8.0,6.0
14330,2006-2007,33,NAC Breda,Roda JC Kerkrade,0,2,2,0,3,2,-2,1.0,9.0
14331,2006-2007,33,RKC Waalwijk,Willem II,1,1,3,1,1,2,0,8.0,5.0
14332,2006-2007,33,Vitesse,FC Twente,1,1,3,1,1,2,0,4.0,6.0
14333,2006-2007,33,ADO Den Haag,FC Groningen,1,3,2,0,3,4,-2,1.0,13.0
14334,2006-2007,34,SBV Excelsior,AZ Alkmaar,3,2,1,3,0,5,1,6.0,12.0
14335,2006-2007,34,FC Groningen,FC Utrecht,0,2,2,0,3,2,-2,12.0,8.0
14336,2006-2007,34,FC Twente,NAC Breda,2,1,1,3,0,3,1,8.0,1.0
14337,2006-2007,34,sc Heerenveen,Feyenoord,5,1,1,3,0,6,4,8.0,4.0
14338,2006-2007,34,NEC Nijmegen,ADO Den Haag,3,2,1,3,0,5,1,7.0,1.0
14339,2006-2007,34,PSV,Vitesse,5,1,1,3,0,6,4,8.0,4.0
14340,2006-2007,34,Roda JC Kerkrade,Heracles Almelo,7,0,1,3,0,7,7,12.0,7.0
14341,2006-2007,34,Sparta Rotterdam,RKC Waalwijk,1,0,1,3,0,1,1,5.0,5.0
14342,2006-2007,34,Willem II,AFC Ajax,0,2,2,0,3,2,-2,4.0,13.0
14343,2007-2008,1,sc Heerenveen,Willem II,0,0,3,1,1,0,0,8.0,2.0
14344,2007-2008,1,NAC Breda,FC Groningen,0,3,2,0,3,3,-3,0.0,12.0
14345,2007-2008,1,AZ Alkmaar,VVV-Venlo,4,0,1,3,0,4,4,12.0,4.0
14346,2007-2008,1,SBV Excelsior,FC Twente,0,2,2,0,3,2,-2,3.0,8.0
14347,2007-2008,1,NEC Nijmegen,Roda JC Kerkrade,1,1,3,1,1,2,0,8.0,13.0
14348,2007-2008,1,De Graafschap,AFC Ajax,1,8,2,0,3,9,-7,1.0,13.0
14349,2007-2008,1,FC Utrecht,Feyenoord,0,3,2,0,3,3,-3,8.0,4.0
14350,2007-2008,1,Sparta Rotterdam,Vitesse,1,2,2,0,3,3,-1,4.0,7.0
14351,2007-2008,1,Heracles Almelo,PSV,0,2,2,0,3,2,-2,7.0,10.0
14352,2007-2008,2,Roda JC Kerkrade,Heracles Almelo,2,1,1,3,0,3,1,13.0,6.0
14353,2007-2008,2,Willem II,Sparta Rotterdam,2,2,3,1,1,4,0,3.0,5.0
14354,2007-2008,2,PSV,NEC Nijmegen,5,0,1,3,0,5,5,13.0,5.0
14355,2007-2008,2,VVV-Venlo,SBV Excelsior,3,1,1,3,0,4,2,4.0,3.0
14356,2007-2008,2,Vitesse,AZ Alkmaar,1,0,1,3,0,1,1,7.0,9.0
14357,2007-2008,2,Feyenoord,NAC Breda,5,0,1,3,0,5,5,7.0,0.0
14358,2007-2008,2,FC Twente,FC Utrecht,2,2,3,1,1,4,0,8.0,6.0
14359,2007-2008,2,AFC Ajax,sc Heerenveen,4,1,1,3,0,5,3,15.0,7.0
14360,2007-2008,2,FC Groningen,De Graafschap,0,2,2,0,3,2,-2,9.0,3.0
14361,2007-2008,3,AZ Alkmaar,SBV Excelsior,3,0,1,3,0,3,3,9.0,3.0
14362,2007-2008,3,sc Heerenveen,Sparta Rotterdam,3,3,3,1,1,6,0,5.0,5.0
14363,2007-2008,3,NAC Breda,Heracles Almelo,4,1,1,3,0,5,3,3.0,3.0
14364,2007-2008,3,Feyenoord,Willem II,2,0,1,3,0,2,2,10.0,3.0
14365,2007-2008,3,FC Twente,PSV,0,0,3,1,1,0,0,9.0,11.0
14366,2007-2008,3,Vitesse,NEC Nijmegen,1,0,1,3,0,1,1,10.0,5.0
14367,2007-2008,3,VVV-Venlo,Roda JC Kerkrade,3,5,2,0,3,8,-2,3.0,13.0
14368,2007-2008,3,FC Utrecht,De Graafschap,2,2,3,1,1,4,0,6.0,4.0
14369,2007-2008,3,AFC Ajax,FC Groningen,2,2,3,1,1,4,0,13.0,7.0
14370,2007-2008,4,FC Groningen,FC Utrecht,0,2,2,0,3,2,-2,4.0,8.0
14371,2007-2008,4,PSV,Vitesse,1,0,1,3,0,1,1,13.0,9.0
14372,2007-2008,4,SBV Excelsior,sc Heerenveen,2,5,2,0,3,7,-3,3.0,8.0
14373,2007-2008,4,Heracles Almelo,AFC Ajax,0,1,2,0,3,1,-1,0.0,13.0
14374,2007-2008,4,De Graafschap,VVV-Venlo,3,2,1,3,0,5,1,7.0,3.0
14375,2007-2008,4,Roda JC Kerkrade,Feyenoord,1,3,2,0,3,4,-2,10.0,12.0
14376,2007-2008,4,Sparta Rotterdam,AZ Alkmaar,2,2,3,1,1,4,0,6.0,7.0
14377,2007-2008,4,Willem II,FC Twente,1,3,2,0,3,4,-2,2.0,11.0
14378,2007-2008,4,NEC Nijmegen,NAC Breda,0,1,2,0,3,1,-1,4.0,6.0
14379,2007-2008,5,VVV-Venlo,NAC Breda,1,3,2,0,3,4,-2,3.0,9.0
14380,2007-2008,5,Willem II,Roda JC Kerkrade,1,0,1,3,0,1,1,5.0,7.0
14381,2007-2008,5,Sparta Rotterdam,Heracles Almelo,1,1,3,1,1,2,0,4.0,1.0
14382,2007-2008,5,Vitesse,De Graafschap,0,2,2,0,3,2,-2,9.0,10.0
14383,2007-2008,5,AZ Alkmaar,AFC Ajax,2,3,2,0,3,5,-1,7.0,13.0
14384,2007-2008,5,sc Heerenveen,FC Utrecht,2,3,2,0,3,5,-1,5.0,8.0
14385,2007-2008,5,FC Twente,NEC Nijmegen,3,0,1,3,0,3,3,11.0,1.0
14386,2007-2008,5,PSV,Feyenoord,4,0,1,3,0,4,4,13.0,12.0
14387,2007-2008,5,SBV Excelsior,FC Groningen,1,3,2,0,3,4,-2,0.0,7.0
14388,2007-2008,6,NAC Breda,PSV,1,1,3,1,1,2,0,10.0,11.0
14389,2007-2008,6,Roda JC Kerkrade,SBV Excelsior,3,3,3,1,1,6,0,7.0,1.0
14390,2007-2008,6,FC Groningen,Sparta Rotterdam,1,0,1,3,0,1,1,7.0,4.0
14391,2007-2008,6,Feyenoord,sc Heerenveen,2,0,1,3,0,2,2,12.0,4.0
14392,2007-2008,6,NEC Nijmegen,Willem II,1,0,1,3,0,1,1,3.0,4.0
14393,2007-2008,6,FC Utrecht,Vitesse,2,4,2,0,3,6,-2,8.0,9.0
14394,2007-2008,6,AFC Ajax,VVV-Venlo,6,1,1,3,0,7,5,13.0,3.0
14395,2007-2008,6,Heracles Almelo,AZ Alkmaar,2,1,1,3,0,3,1,4.0,4.0
14396,2007-2008,6,De Graafschap,FC Twente,0,0,3,1,1,0,0,11.0,9.0
14397,2007-2008,7,VVV-Venlo,FC Utrecht,1,2,2,0,3,3,-1,0.0,10.0
14398,2007-2008,7,NAC Breda,De Graafschap,1,0,1,3,0,1,1,13.0,8.0
14399,2007-2008,7,PSV,Willem II,3,0,1,3,0,3,3,11.0,3.0
14400,2007-2008,7,SBV Excelsior,NEC Nijmegen,2,0,1,3,0,2,2,4.0,3.0
14401,2007-2008,7,Sparta Rotterdam,AFC Ajax,2,2,3,1,1,4,0,4.0,11.0
14402,2007-2008,7,FC Twente,Roda JC Kerkrade,0,1,2,0,3,1,-1,8.0,7.0
14403,2007-2008,7,Vitesse,Feyenoord,0,1,2,0,3,1,-1,6.0,12.0
14404,2007-2008,7,sc Heerenveen,Heracles Almelo,9,0,1,3,0,9,9,7.0,4.0
14405,2007-2008,7,AZ Alkmaar,FC Groningen,2,2,3,1,1,4,0,5.0,8.0
14406,2007-2008,8,De Graafschap,Sparta Rotterdam,4,0,1,3,0,4,4,10.0,3.0
14407,2007-2008,8,AFC Ajax,NEC Nijmegen,0,0,3,1,1,0,0,11.0,4.0
14408,2007-2008,8,PSV,VVV-Venlo,3,1,1,3,0,4,2,13.0,0.0
14409,2007-2008,8,Feyenoord,SBV Excelsior,1,0,1,3,0,1,1,12.0,4.0
14410,2007-2008,8,Heracles Almelo,Vitesse,2,2,3,1,1,4,0,5.0,4.0
14411,2007-2008,8,AZ Alkmaar,sc Heerenveen,0,1,2,0,3,1,-1,2.0,9.0
14412,2007-2008,8,Willem II,NAC Breda,0,0,3,1,1,0,0,4.0,11.0
14413,2007-2008,8,Roda JC Kerkrade,FC Utrecht,1,1,3,1,1,2,0,5.0,10.0
14414,2007-2008,8,FC Groningen,FC Twente,1,0,1,3,0,1,1,10.0,7.0
14415,2007-2008,9,Vitesse,Willem II,1,0,1,3,0,1,1,7.0,4.0
14416,2007-2008,9,Roda JC Kerkrade,De Graafschap,1,0,1,3,0,1,1,8.0,7.0
14417,2007-2008,9,VVV-Venlo,sc Heerenveen,0,4,2,0,3,4,-4,0.0,9.0
14418,2007-2008,9,FC Twente,Feyenoord,2,0,1,3,0,2,2,7.0,9.0
14419,2007-2008,9,SBV Excelsior,Heracles Almelo,1,1,3,1,1,2,0,5.0,6.0
14420,2007-2008,9,FC Utrecht,AFC Ajax,0,1,2,0,3,1,-1,7.0,11.0
14421,2007-2008,9,Sparta Rotterdam,PSV,1,4,2,0,3,5,-3,2.0,13.0
14422,2007-2008,9,NAC Breda,AZ Alkmaar,2,3,2,0,3,5,-1,8.0,4.0
14423,2007-2008,9,NEC Nijmegen,FC Groningen,5,1,1,3,0,6,4,7.0,10.0
14424,2007-2008,10,Willem II,VVV-Venlo,1,2,2,0,3,3,-1,1.0,3.0
14425,2007-2008,10,sc Heerenveen,PSV,2,1,1,3,0,3,1,12.0,10.0
14426,2007-2008,10,AZ Alkmaar,NEC Nijmegen,4,0,1,3,0,4,4,7.0,7.0
14427,2007-2008,10,SBV Excelsior,Sparta Rotterdam,4,3,1,3,0,7,1,8.0,1.0
14428,2007-2008,10,FC Utrecht,NAC Breda,0,1,2,0,3,1,-1,4.0,8.0
14429,2007-2008,10,Feyenoord,De Graafschap,2,0,1,3,0,2,2,12.0,4.0
14430,2007-2008,10,AFC Ajax,Roda JC Kerkrade,4,2,1,3,0,6,2,11.0,8.0
14431,2007-2008,10,Heracles Almelo,FC Twente,0,3,2,0,3,3,-3,5.0,7.0
14432,2007-2008,10,FC Groningen,Vitesse,0,0,3,1,1,0,0,8.0,8.0
14433,2007-2008,11,NEC Nijmegen,Heracles Almelo,3,0,1,3,0,3,3,7.0,2.0
14434,2007-2008,11,Willem II,FC Utrecht,1,4,2,0,3,5,-3,1.0,7.0
14435,2007-2008,11,VVV-Venlo,Sparta Rotterdam,2,0,1,3,0,2,2,6.0,1.0
14436,2007-2008,11,FC Twente,NAC Breda,1,1,3,1,1,2,0,7.0,8.0
14437,2007-2008,11,De Graafschap,SBV Excelsior,1,1,3,1,1,2,0,4.0,8.0
14438,2007-2008,11,Feyenoord,AFC Ajax,2,2,3,1,1,4,0,10.0,9.0
14439,2007-2008,11,PSV,AZ Alkmaar,1,1,3,1,1,2,0,10.0,8.0
14440,2007-2008,11,Vitesse,sc Heerenveen,0,1,2,0,3,1,-1,5.0,15.0
14441,2007-2008,11,Roda JC Kerkrade,FC Groningen,5,1,1,3,0,6,4,10.0,5.0
14442,2007-2008,12,NAC Breda,Roda JC Kerkrade,0,0,3,1,1,0,0,6.0,8.0
14443,2007-2008,12,sc Heerenveen,De Graafschap,2,3,2,0,3,5,-1,12.0,7.0
14444,2007-2008,12,AZ Alkmaar,Willem II,2,0,1,3,0,2,2,10.0,1.0
14445,2007-2008,12,SBV Excelsior,PSV,1,4,2,0,3,5,-3,5.0,10.0
14446,2007-2008,12,Heracles Almelo,VVV-Venlo,0,0,3,1,1,0,0,3.0,7.0
14447,2007-2008,12,FC Utrecht,NEC Nijmegen,3,2,1,3,0,5,1,7.0,7.0
14448,2007-2008,12,Sparta Rotterdam,FC Twente,1,1,3,1,1,2,0,1.0,8.0
14449,2007-2008,12,AFC Ajax,Vitesse,4,1,1,3,0,5,3,11.0,5.0
14450,2007-2008,12,FC Groningen,Feyenoord,3,2,1,3,0,5,1,7.0,7.0
14451,2007-2008,13,FC Utrecht,Sparta Rotterdam,7,1,1,3,0,8,6,9.0,1.0
14452,2007-2008,13,Willem II,SBV Excelsior,6,0,1,3,0,6,6,3.0,5.0
14453,2007-2008,13,Roda JC Kerkrade,Vitesse,3,2,1,3,0,5,1,10.0,4.0
14454,2007-2008,13,FC Groningen,VVV-Venlo,1,0,1,3,0,1,1,7.0,7.0
14455,2007-2008,13,De Graafschap,PSV,0,1,2,0,3,1,-1,4.0,10.0
14456,2007-2008,13,Feyenoord,Heracles Almelo,6,0,1,3,0,6,6,7.0,2.0
14457,2007-2008,13,FC Twente,AZ Alkmaar,2,1,1,3,0,3,1,11.0,10.0
14458,2007-2008,13,AFC Ajax,NAC Breda,1,3,2,0,3,4,-2,10.0,8.0
14459,2007-2008,13,NEC Nijmegen,sc Heerenveen,0,1,2,0,3,1,-1,6.0,12.0
14460,2007-2008,14,PSV,Roda JC Kerkrade,2,4,2,0,3,6,-2,7.0,10.0
14461,2007-2008,14,Willem II,AFC Ajax,2,3,2,0,3,5,-1,3.0,10.0
14462,2007-2008,14,SBV Excelsior,NAC Breda,0,3,2,0,3,3,-3,4.0,11.0
14463,2007-2008,14,Heracles Almelo,De Graafschap,2,0,1,3,0,2,2,4.0,4.0
14464,2007-2008,14,Vitesse,FC Twente,2,2,3,1,1,4,0,2.0,9.0
14465,2007-2008,14,VVV-Venlo,Feyenoord,0,0,3,1,1,0,0,8.0,8.0
14466,2007-2008,14,sc Heerenveen,FC Groningen,4,2,1,3,0,6,2,12.0,7.0
14467,2007-2008,14,Sparta Rotterdam,NEC Nijmegen,1,0,1,3,0,1,1,4.0,3.0
14468,2007-2008,14,AZ Alkmaar,FC Utrecht,2,1,1,3,0,3,1,10.0,9.0
14469,2007-2008,15,Roda JC Kerkrade,Sparta Rotterdam,2,3,2,0,3,5,-1,10.0,7.0
14470,2007-2008,15,NAC Breda,sc Heerenveen,1,5,2,0,3,6,-4,8.0,12.0
14471,2007-2008,15,FC Twente,VVV-Venlo,1,1,3,1,1,2,0,7.0,6.0
14472,2007-2008,15,De Graafschap,NEC Nijmegen,1,1,3,1,1,2,0,5.0,4.0
14473,2007-2008,15,FC Utrecht,Heracles Almelo,3,1,1,3,0,4,2,12.0,4.0
14474,2007-2008,15,Vitesse,SBV Excelsior,3,0,1,3,0,3,3,4.0,1.0
14475,2007-2008,15,FC Groningen,Willem II,1,0,1,3,0,1,1,9.0,3.0
14476,2007-2008,15,Feyenoord,AZ Alkmaar,2,2,3,1,1,4,0,6.0,8.0
14477,2007-2008,15,AFC Ajax,PSV,0,2,2,0,3,2,-2,7.0,10.0
14478,2007-2008,16,Willem II,De Graafschap,1,2,2,0,3,3,-1,3.0,7.0
14479,2007-2008,16,sc Heerenveen,FC Twente,1,2,2,0,3,3,-1,9.0,9.0
14480,2007-2008,16,PSV,FC Utrecht,4,1,1,3,0,5,3,12.0,9.0
14481,2007-2008,16,Heracles Almelo,FC Groningen,1,2,2,0,3,3,-1,4.0,12.0
14482,2007-2008,16,SBV Excelsior,AFC Ajax,2,1,1,3,0,3,1,3.0,6.0
14483,2007-2008,16,NEC Nijmegen,Feyenoord,0,2,2,0,3,2,-2,1.0,8.0
14484,2007-2008,16,VVV-Venlo,Vitesse,2,0,1,3,0,2,2,6.0,4.0
14485,2007-2008,16,AZ Alkmaar,Roda JC Kerkrade,1,1,3,1,1,2,0,8.0,8.0
14486,2007-2008,16,Sparta Rotterdam,NAC Breda,0,1,2,0,3,1,-1,7.0,10.0
14487,2007-2008,17,Feyenoord,Sparta Rotterdam,2,0,1,3,0,2,2,11.0,6.0
14488,2007-2008,17,NEC Nijmegen,VVV-Venlo,2,2,3,1,1,4,0,2.0,6.0
14489,2007-2008,17,FC Groningen,PSV,2,1,1,3,0,3,1,12.0,9.0
14490,2007-2008,17,FC Utrecht,SBV Excelsior,4,1,1,3,0,5,3,9.0,3.0
14491,2007-2008,17,NAC Breda,Vitesse,1,2,2,0,3,3,-1,9.0,7.0
14492,2007-2008,17,Roda JC Kerkrade,sc Heerenveen,1,0,1,3,0,1,1,10.0,9.0
14493,2007-2008,17,AFC Ajax,FC Twente,2,2,3,1,1,4,0,4.0,9.0
14494,2007-2008,17,Heracles Almelo,Willem II,1,0,1,3,0,1,1,6.0,3.0
14495,2007-2008,17,De Graafschap,AZ Alkmaar,1,2,2,0,3,3,-1,4.0,8.0
14496,2007-2008,18,Sparta Rotterdam,FC Groningen,1,3,2,0,3,4,-2,6.0,12.0
14497,2007-2008,18,VVV-Venlo,AFC Ajax,2,2,3,1,1,4,0,7.0,5.0
14498,2007-2008,18,sc Heerenveen,Feyenoord,1,1,3,1,1,2,0,7.0,9.0
14499,2007-2008,18,AZ Alkmaar,Heracles Almelo,1,0,1,3,0,1,1,11.0,6.0
14500,2007-2008,18,Willem II,NEC Nijmegen,3,0,1,3,0,3,3,3.0,2.0
14501,2007-2008,18,FC Twente,De Graafschap,2,0,1,3,0,2,2,9.0,4.0
14502,2007-2008,18,PSV,NAC Breda,2,0,1,3,0,2,2,9.0,6.0
14503,2007-2008,18,SBV Excelsior,Roda JC Kerkrade,1,2,2,0,3,3,-1,3.0,10.0
14504,2007-2008,18,Vitesse,FC Utrecht,2,2,3,1,1,4,0,8.0,7.0
14505,2007-2008,19,NEC Nijmegen,FC Twente,2,2,3,1,1,4,0,3.0,9.0
14506,2007-2008,19,NAC Breda,VVV-Venlo,0,0,3,1,1,0,0,4.0,7.0
14507,2007-2008,19,Roda JC Kerkrade,Willem II,1,1,3,1,1,2,0,8.0,4.0
14508,2007-2008,19,FC Groningen,SBV Excelsior,3,2,1,3,0,5,1,15.0,3.0
14509,2007-2008,19,Feyenoord,PSV,0,1,2,0,3,1,-1,8.0,12.0
14510,2007-2008,19,De Graafschap,Vitesse,0,3,2,0,3,3,-3,4.0,10.0
14511,2007-2008,19,FC Utrecht,sc Heerenveen,2,2,3,1,1,4,0,8.0,5.0
14512,2007-2008,19,AFC Ajax,AZ Alkmaar,6,1,1,3,0,7,5,5.0,8.0
14513,2007-2008,19,Heracles Almelo,Sparta Rotterdam,2,0,1,3,0,2,2,6.0,3.0
14514,2007-2008,20,SBV Excelsior,Feyenoord,2,1,1,3,0,3,1,6.0,7.0
14515,2007-2008,20,sc Heerenveen,AZ Alkmaar,4,0,1,3,0,4,4,5.0,7.0
14516,2007-2008,20,NAC Breda,Willem II,1,0,1,3,0,1,1,7.0,4.0
14517,2007-2008,20,FC Utrecht,Roda JC Kerkrade,3,1,1,3,0,4,2,8.0,8.0
14518,2007-2008,20,Vitesse,Heracles Almelo,2,0,1,3,0,2,2,10.0,6.0
14519,2007-2008,20,NEC Nijmegen,AFC Ajax,1,1,3,1,1,2,0,3.0,6.0
14520,2007-2008,20,VVV-Venlo,PSV,1,1,3,1,1,2,0,7.0,10.0
14521,2007-2008,20,Sparta Rotterdam,De Graafschap,6,1,1,3,0,7,5,3.0,3.0
14522,2007-2008,20,FC Twente,FC Groningen,3,1,1,3,0,4,2,11.0,12.0
14523,2007-2008,21,AZ Alkmaar,NAC Breda,1,2,2,0,3,3,-1,6.0,7.0
14524,2007-2008,21,Willem II,Vitesse,4,0,1,3,0,4,4,7.0,10.0
14525,2007-2008,21,Heracles Almelo,SBV Excelsior,2,0,1,3,0,2,2,9.0,3.0
14526,2007-2008,21,AFC Ajax,FC Utrecht,2,0,1,3,0,2,2,9.0,8.0
14527,2007-2008,21,sc Heerenveen,VVV-Venlo,5,1,1,3,0,6,4,8.0,4.0
14528,2007-2008,21,PSV,Sparta Rotterdam,3,1,1,3,0,4,2,10.0,3.0
14529,2007-2008,21,De Graafschap,Roda JC Kerkrade,2,1,1,3,0,3,1,3.0,7.0
14530,2007-2008,21,FC Groningen,NEC Nijmegen,5,1,1,3,0,6,4,12.0,3.0
14531,2007-2008,21,Feyenoord,FC Twente,3,1,1,3,0,4,2,7.0,8.0
14532,2007-2008,22,Willem II,AZ Alkmaar,3,0,1,3,0,3,3,10.0,3.0
14533,2007-2008,22,PSV,SBV Excelsior,2,1,1,3,0,3,1,13.0,3.0
14534,2007-2008,22,Roda JC Kerkrade,NAC Breda,0,2,2,0,3,2,-2,4.0,10.0
14535,2007-2008,22,De Graafschap,sc Heerenveen,0,3,2,0,3,3,-3,3.0,11.0
14536,2007-2008,22,NEC Nijmegen,FC Utrecht,2,0,1,3,0,2,2,5.0,5.0
14537,2007-2008,22,Vitesse,AFC Ajax,2,2,3,1,1,4,0,8.0,9.0
14538,2007-2008,22,VVV-Venlo,Heracles Almelo,0,5,2,0,3,5,-5,3.0,9.0
14539,2007-2008,22,Feyenoord,FC Groningen,1,1,3,1,1,2,0,5.0,10.0
14540,2007-2008,22,FC Twente,Sparta Rotterdam,1,2,2,0,3,3,-1,7.0,6.0
14541,2007-2008,23,NAC Breda,FC Twente,1,0,1,3,0,1,1,13.0,4.0
14542,2007-2008,23,sc Heerenveen,Vitesse,7,0,1,3,0,7,7,13.0,7.0
14543,2007-2008,23,AZ Alkmaar,PSV,0,2,2,0,3,2,-2,0.0,13.0
14544,2007-2008,23,SBV Excelsior,De Graafschap,1,1,3,1,1,2,0,4.0,4.0
14545,2007-2008,23,Heracles Almelo,NEC Nijmegen,0,2,2,0,3,2,-2,9.0,8.0
14546,2007-2008,23,AFC Ajax,Feyenoord,3,0,1,3,0,3,3,11.0,4.0
14547,2007-2008,23,FC Utrecht,Willem II,2,0,1,3,0,2,2,7.0,7.0
14548,2007-2008,23,Sparta Rotterdam,VVV-Venlo,2,0,1,3,0,2,2,9.0,2.0
14549,2007-2008,23,FC Groningen,Roda JC Kerkrade,1,1,3,1,1,2,0,8.0,2.0
14550,2007-2008,24,FC Twente,Heracles Almelo,2,1,1,3,0,3,1,6.0,6.0
14551,2007-2008,24,NAC Breda,FC Utrecht,1,0,1,3,0,1,1,15.0,6.0
14552,2007-2008,24,PSV,sc Heerenveen,1,1,3,1,1,2,0,11.0,13.0
14553,2007-2008,24,De Graafschap,Feyenoord,1,3,2,0,3,4,-2,4.0,7.0
14554,2007-2008,24,Vitesse,FC Groningen,2,1,1,3,0,3,1,7.0,5.0
14555,2007-2008,24,Roda JC Kerkrade,AFC Ajax,2,1,1,3,0,3,1,4.0,8.0
14556,2007-2008,24,VVV-Venlo,Willem II,1,1,3,1,1,2,0,2.0,7.0
14557,2007-2008,24,Sparta Rotterdam,SBV Excelsior,0,1,2,0,3,1,-1,9.0,7.0
14558,2007-2008,24,NEC Nijmegen,AZ Alkmaar,5,2,1,3,0,7,3,10.0,0.0
14559,2007-2008,25,AFC Ajax,Sparta Rotterdam,6,2,1,3,0,8,4,10.0,6.0
14560,2007-2008,25,Willem II,PSV,0,1,2,0,3,1,-1,7.0,13.0
14561,2007-2008,25,Roda JC Kerkrade,FC Twente,3,1,1,3,0,4,2,7.0,3.0
14562,2007-2008,25,Heracles Almelo,sc Heerenveen,2,2,3,1,1,4,0,7.0,11.0
14563,2007-2008,25,NEC Nijmegen,SBV Excelsior,0,1,2,0,3,1,-1,9.0,7.0
14564,2007-2008,25,De Graafschap,NAC Breda,0,1,2,0,3,1,-1,4.0,15.0
14565,2007-2008,25,FC Utrecht,VVV-Venlo,1,4,2,0,3,5,-3,3.0,4.0
14566,2007-2008,25,Feyenoord,Vitesse,1,0,1,3,0,1,1,10.0,4.0
14567,2007-2008,25,FC Groningen,AZ Alkmaar,2,1,1,3,0,3,1,8.0,0.0
14568,2007-2008,26,Sparta Rotterdam,FC Utrecht,2,1,1,3,0,3,1,9.0,3.0
14569,2007-2008,26,AZ Alkmaar,FC Twente,0,0,3,1,1,0,0,1.0,4.0
14570,2007-2008,26,SBV Excelsior,Willem II,0,0,3,1,1,0,0,8.0,5.0
14571,2007-2008,26,Heracles Almelo,Feyenoord,3,3,3,1,1,6,0,5.0,8.0
14572,2007-2008,26,Vitesse,Roda JC Kerkrade,1,1,3,1,1,2,0,5.0,8.0
14573,2007-2008,26,NAC Breda,AFC Ajax,2,3,2,0,3,5,-1,12.0,10.0
14574,2007-2008,26,VVV-Venlo,FC Groningen,2,5,2,0,3,7,-3,4.0,8.0
14575,2007-2008,26,sc Heerenveen,NEC Nijmegen,2,3,2,0,3,5,-1,8.0,12.0
14576,2007-2008,26,PSV,De Graafschap,4,1,1,3,0,5,3,13.0,1.0
14577,2007-2008,27,Vitesse,VVV-Venlo,1,3,2,0,3,4,-2,4.0,7.0
14578,2007-2008,27,NAC Breda,Sparta Rotterdam,3,0,1,3,0,3,3,12.0,6.0
14579,2007-2008,27,Roda JC Kerkrade,AZ Alkmaar,1,1,3,1,1,2,0,9.0,2.0
14580,2007-2008,27,FC Twente,sc Heerenveen,1,0,1,3,0,1,1,7.0,5.0
14581,2007-2008,27,De Graafschap,Willem II,1,2,2,0,3,3,-1,1.0,5.0
14582,2007-2008,27,FC Utrecht,PSV,3,1,1,3,0,4,2,6.0,10.0
14583,2007-2008,27,Feyenoord,NEC Nijmegen,1,3,2,0,3,4,-2,7.0,12.0
14584,2007-2008,27,AFC Ajax,SBV Excelsior,4,0,1,3,0,4,4,12.0,8.0
14585,2007-2008,27,FC Groningen,Heracles Almelo,1,2,2,0,3,3,-1,7.0,5.0
14586,2007-2008,28,Heracles Almelo,FC Utrecht,2,1,1,3,0,3,1,8.0,3.0
14587,2007-2008,28,sc Heerenveen,NAC Breda,3,0,1,3,0,3,3,5.0,9.0
14588,2007-2008,28,Willem II,FC Groningen,1,2,2,0,3,3,-1,5.0,9.0
14589,2007-2008,28,SBV Excelsior,Vitesse,1,2,2,0,3,3,-1,7.0,7.0
14590,2007-2008,28,NEC Nijmegen,De Graafschap,3,1,1,3,0,4,2,12.0,0.0
14591,2007-2008,28,Sparta Rotterdam,Roda JC Kerkrade,4,1,1,3,0,5,3,6.0,8.0
14592,2007-2008,28,VVV-Venlo,FC Twente,0,2,2,0,3,2,-2,7.0,10.0
14593,2007-2008,28,AZ Alkmaar,Feyenoord,0,1,2,0,3,1,-1,2.0,10.0
14594,2007-2008,28,PSV,AFC Ajax,0,0,3,1,1,0,0,8.0,10.0
14595,2007-2008,29,FC Groningen,sc Heerenveen,0,1,2,0,3,1,-1,9.0,7.0
14596,2007-2008,29,NAC Breda,SBV Excelsior,2,0,1,3,0,2,2,9.0,4.0
14597,2007-2008,29,Feyenoord,VVV-Venlo,4,1,1,3,0,5,3,10.0,6.0
14598,2007-2008,29,FC Twente,Vitesse,4,3,1,3,0,7,1,10.0,4.0
14599,2007-2008,29,De Graafschap,Heracles Almelo,0,0,3,1,1,0,0,1.0,9.0
14600,2007-2008,29,FC Utrecht,AZ Alkmaar,2,2,3,1,1,4,0,4.0,3.0
14601,2007-2008,29,AFC Ajax,Willem II,4,1,1,3,0,5,3,13.0,4.0
14602,2007-2008,29,NEC Nijmegen,Sparta Rotterdam,4,2,1,3,0,6,2,12.0,6.0
14603,2007-2008,29,Roda JC Kerkrade,PSV,1,1,3,1,1,2,0,6.0,8.0
14604,2007-2008,30,Vitesse,NAC Breda,3,3,3,1,1,6,0,5.0,7.0
14605,2007-2008,30,sc Heerenveen,Roda JC Kerkrade,4,3,1,3,0,7,1,9.0,3.0
14606,2007-2008,30,PSV,FC Groningen,3,0,1,3,0,3,3,8.0,6.0
14607,2007-2008,30,AZ Alkmaar,De Graafschap,0,0,3,1,1,0,0,4.0,2.0
14608,2007-2008,30,SBV Excelsior,FC Utrecht,0,2,2,0,3,2,-2,1.0,7.0
14609,2007-2008,30,VVV-Venlo,NEC Nijmegen,1,2,2,0,3,3,-1,3.0,15.0
14610,2007-2008,30,Sparta Rotterdam,Feyenoord,3,2,1,3,0,5,1,9.0,7.0
14611,2007-2008,30,Willem II,Heracles Almelo,2,1,1,3,0,3,1,7.0,8.0
14612,2007-2008,30,FC Twente,AFC Ajax,2,1,1,3,0,3,1,13.0,10.0
14613,2007-2008,31,De Graafschap,FC Groningen,1,1,3,1,1,2,0,3.0,4.0
14614,2007-2008,31,sc Heerenveen,AFC Ajax,2,4,2,0,3,6,-2,9.0,10.0
14615,2007-2008,31,SBV Excelsior,VVV-Venlo,2,1,1,3,0,3,1,3.0,3.0
14616,2007-2008,31,Heracles Almelo,Roda JC Kerkrade,0,0,3,1,1,0,0,8.0,3.0
14617,2007-2008,31,NEC Nijmegen,PSV,0,0,3,1,1,0,0,13.0,6.0
14618,2007-2008,31,NAC Breda,Feyenoord,3,1,1,3,0,4,2,10.0,6.0
14619,2007-2008,31,FC Utrecht,FC Twente,0,1,2,0,3,1,-1,7.0,15.0
14620,2007-2008,31,Sparta Rotterdam,Willem II,2,2,3,1,1,4,0,7.0,7.0
14621,2007-2008,31,AZ Alkmaar,Vitesse,2,1,1,3,0,3,1,6.0,4.0
14622,2007-2008,32,Roda JC Kerkrade,NEC Nijmegen,0,2,2,0,3,2,-2,2.0,13.0
14623,2007-2008,32,Willem II,sc Heerenveen,2,3,2,0,3,5,-1,4.0,12.0
14624,2007-2008,32,FC Twente,SBV Excelsior,1,0,1,3,0,1,1,15.0,3.0
14625,2007-2008,32,Vitesse,Sparta Rotterdam,3,0,1,3,0,3,3,7.0,7.0
14626,2007-2008,32,VVV-Venlo,AZ Alkmaar,2,3,2,0,3,5,-1,0.0,8.0
14627,2007-2008,32,PSV,Heracles Almelo,2,0,1,3,0,2,2,9.0,5.0
14628,2007-2008,32,Feyenoord,FC Utrecht,3,1,1,3,0,4,2,9.0,4.0
14629,2007-2008,32,AFC Ajax,De Graafschap,4,1,1,3,0,5,3,10.0,3.0
14630,2007-2008,32,FC Groningen,NAC Breda,1,2,2,0,3,3,-1,4.0,10.0
14631,2007-2008,33,Sparta Rotterdam,sc Heerenveen,4,2,1,3,0,6,2,7.0,9.0
14632,2007-2008,33,Willem II,Feyenoord,3,1,1,3,0,4,2,7.0,6.0
14633,2007-2008,33,PSV,FC Twente,1,1,3,1,1,2,0,9.0,13.0
14634,2007-2008,33,SBV Excelsior,AZ Alkmaar,1,1,3,1,1,2,0,4.0,9.0
14635,2007-2008,33,Heracles Almelo,NAC Breda,0,1,2,0,3,1,-1,2.0,13.0
14636,2007-2008,33,De Graafschap,FC Utrecht,1,1,3,1,1,2,0,4.0,5.0
14637,2007-2008,33,NEC Nijmegen,Vitesse,1,0,1,3,0,1,1,13.0,4.0
14638,2007-2008,33,Roda JC Kerkrade,VVV-Venlo,4,1,1,3,0,5,3,5.0,0.0
14639,2007-2008,33,FC Groningen,AFC Ajax,1,2,2,0,3,3,-1,1.0,12.0
14640,2007-2008,34,sc Heerenveen,SBV Excelsior,5,0,1,3,0,5,5,9.0,4.0
14641,2007-2008,34,FC Utrecht,FC Groningen,1,0,1,3,0,1,1,7.0,1.0
14642,2007-2008,34,Feyenoord,Roda JC Kerkrade,3,0,1,3,0,3,3,6.0,4.0
14643,2007-2008,34,AZ Alkmaar,Sparta Rotterdam,1,0,1,3,0,1,1,11.0,7.0
14644,2007-2008,34,NAC Breda,NEC Nijmegen,1,3,2,0,3,4,-2,10.0,13.0
14645,2007-2008,34,FC Twente,Willem II,2,0,1,3,0,2,2,13.0,7.0
14646,2007-2008,34,AFC Ajax,Heracles Almelo,5,1,1,3,0,6,4,12.0,1.0
14647,2007-2008,34,Vitesse,PSV,0,1,2,0,3,1,-1,4.0,11.0
14648,2007-2008,34,VVV-Venlo,De Graafschap,3,0,1,3,0,3,3,3.0,3.0
14649,2008-2009,1,Vitesse,FC Groningen,0,4,2,0,3,4,-4,3.0,4.0
14650,2008-2009,1,FC Utrecht,PSV,1,5,2,0,3,6,-4,4.0,11.0
14651,2008-2009,1,Willem II,AFC Ajax,2,1,1,3,0,3,1,7.0,12.0
14652,2008-2009,1,Roda JC Kerkrade,FC Twente,1,1,3,1,1,2,0,5.0,11.0
14653,2008-2009,1,NEC Nijmegen,De Graafschap,2,0,1,3,0,2,2,13.0,2.0
14654,2008-2009,1,Heracles Almelo,Feyenoord,3,1,1,3,0,4,2,4.0,6.0
14655,2008-2009,1,FC Volendam,sc Heerenveen,2,3,2,0,3,5,-1,4.0,9.0
14656,2008-2009,1,Sparta Rotterdam,ADO Den Haag,2,5,2,0,3,7,-3,4.0,4.0
14657,2008-2009,1,AZ Alkmaar,NAC Breda,1,2,2,0,3,3,-1,10.0,12.0
14658,2008-2009,2,sc Heerenveen,Heracles Almelo,2,2,3,1,1,4,0,10.0,4.0
14659,2008-2009,2,PSV,Sparta Rotterdam,1,0,1,3,0,1,1,13.0,3.0
14660,2008-2009,2,ADO Den Haag,AZ Alkmaar,3,0,1,3,0,3,3,6.0,7.0
14661,2008-2009,2,FC Twente,NEC Nijmegen,1,1,3,1,1,2,0,9.0,13.0
14662,2008-2009,2,Feyenoord,FC Volendam,5,0,1,3,0,5,5,9.0,4.0
14663,2008-2009,2,De Graafschap,Vitesse,1,0,1,3,0,1,1,4.0,3.0
14664,2008-2009,2,NAC Breda,Willem II,1,3,2,0,3,4,-2,9.0,9.0
14665,2008-2009,2,AFC Ajax,Roda JC Kerkrade,1,0,1,3,0,1,1,12.0,4.0
14666,2008-2009,2,FC Groningen,FC Utrecht,2,0,1,3,0,2,2,6.0,4.0
14667,2008-2009,3,FC Utrecht,Willem II,1,0,1,3,0,1,1,7.0,9.0
14668,2008-2009,3,Vitesse,Sparta Rotterdam,1,1,3,1,1,2,0,1.0,4.0
14669,2008-2009,3,Heracles Almelo,FC Groningen,1,1,3,1,1,2,0,5.0,7.0
14670,2008-2009,3,AZ Alkmaar,PSV,1,0,1,3,0,1,1,7.0,10.0
14671,2008-2009,3,Feyenoord,AFC Ajax,2,2,3,1,1,4,0,7.0,10.0
14672,2008-2009,3,De Graafschap,ADO Den Haag,2,0,1,3,0,2,2,7.0,6.0
14673,2008-2009,3,FC Volendam,FC Twente,1,2,2,0,3,3,-1,4.0,9.0
14674,2008-2009,3,Roda JC Kerkrade,NAC Breda,0,3,2,0,3,3,-3,4.0,9.0
14675,2008-2009,3,sc Heerenveen,NEC Nijmegen,2,1,1,3,0,3,1,10.0,10.0
14676,2008-2009,4,NAC Breda,sc Heerenveen,4,2,1,3,0,6,2,9.0,10.0
14677,2008-2009,4,PSV,FC Volendam,1,0,1,3,0,1,1,12.0,3.0
14678,2008-2009,4,FC Twente,De Graafschap,3,0,1,3,0,3,3,11.0,6.0
14679,2008-2009,4,Willem II,AZ Alkmaar,2,5,2,0,3,7,-3,6.0,9.0
14680,2008-2009,4,ADO Den Haag,FC Utrecht,0,0,3,1,1,0,0,7.0,7.0
14681,2008-2009,4,FC Groningen,Feyenoord,3,1,1,3,0,4,2,10.0,7.0
14682,2008-2009,4,Sparta Rotterdam,Roda JC Kerkrade,2,2,3,1,1,4,0,2.0,2.0
14683,2008-2009,4,NEC Nijmegen,Heracles Almelo,1,1,3,1,1,2,0,8.0,6.0
14684,2008-2009,4,AFC Ajax,Vitesse,3,0,1,3,0,3,3,10.0,1.0
14685,2008-2009,5,AZ Alkmaar,Sparta Rotterdam,6,0,1,3,0,6,6,9.0,2.0
14686,2008-2009,5,Vitesse,Willem II,2,2,3,1,1,4,0,2.0,7.0
14687,2008-2009,5,PSV,De Graafschap,3,0,1,3,0,3,3,12.0,6.0
14688,2008-2009,5,Heracles Almelo,Roda JC Kerkrade,2,0,1,3,0,2,2,9.0,2.0
14689,2008-2009,5,FC Groningen,ADO Den Haag,3,0,1,3,0,3,3,13.0,7.0
14690,2008-2009,5,FC Volendam,NAC Breda,2,4,2,0,3,6,-2,0.0,12.0
14691,2008-2009,5,Feyenoord,NEC Nijmegen,0,2,2,0,3,2,-2,4.0,8.0
14692,2008-2009,5,FC Utrecht,FC Twente,3,0,1,3,0,3,3,7.0,8.0
14693,2008-2009,5,sc Heerenveen,AFC Ajax,5,2,1,3,0,7,3,10.0,7.0
14694,2008-2009,6,ADO Den Haag,FC Volendam,2,0,1,3,0,2,2,7.0,0.0
14695,2008-2009,6,FC Twente,Heracles Almelo,2,0,1,3,0,2,2,10.0,6.0
14696,2008-2009,6,NAC Breda,PSV,2,1,1,3,0,3,1,12.0,9.0
14697,2008-2009,6,Roda JC Kerkrade,sc Heerenveen,2,2,3,1,1,4,0,2.0,8.0
14698,2008-2009,6,AFC Ajax,FC Groningen,1,0,1,3,0,1,1,10.0,10.0
14699,2008-2009,6,NEC Nijmegen,Vitesse,3,1,1,3,0,4,2,8.0,2.0
14700,2008-2009,6,Willem II,Feyenoord,1,0,1,3,0,1,1,7.0,4.0
14701,2008-2009,6,De Graafschap,AZ Alkmaar,0,2,2,0,3,2,-2,6.0,12.0
14702,2008-2009,6,Sparta Rotterdam,FC Utrecht,1,0,1,3,0,1,1,5.0,7.0
14703,2008-2009,7,Heracles Almelo,ADO Den Haag,3,1,1,3,0,4,2,8.0,4.0
14704,2008-2009,7,AZ Alkmaar,FC Volendam,3,0,1,3,0,3,3,15.0,0.0
14705,2008-2009,7,Willem II,De Graafschap,1,1,3,1,1,2,0,5.0,4.0
14706,2008-2009,7,FC Groningen,Sparta Rotterdam,3,0,1,3,0,3,3,10.0,5.0
14707,2008-2009,7,PSV,Roda JC Kerkrade,2,3,2,0,3,5,-1,6.0,5.0
14708,2008-2009,7,AFC Ajax,NEC Nijmegen,2,0,1,3,0,2,2,10.0,7.0
14709,2008-2009,7,Vitesse,FC Twente,0,2,2,0,3,2,-2,2.0,12.0
14710,2008-2009,7,FC Utrecht,NAC Breda,0,0,3,1,1,0,0,8.0,13.0
14711,2008-2009,7,Feyenoord,sc Heerenveen,2,2,3,1,1,4,0,2.0,8.0
14712,2008-2009,8,ADO Den Haag,PSV,0,2,2,0,3,2,-2,4.0,9.0
14713,2008-2009,8,Roda JC Kerkrade,AZ Alkmaar,0,2,2,0,3,2,-2,5.0,15.0
14714,2008-2009,8,FC Volendam,Willem II,2,2,3,1,1,4,0,1.0,6.0
14715,2008-2009,8,Heracles Almelo,AFC Ajax,1,3,2,0,3,4,-2,7.0,12.0
14716,2008-2009,8,sc Heerenveen,Vitesse,0,2,2,0,3,2,-2,5.0,4.0
14717,2008-2009,8,NAC Breda,FC Twente,0,1,2,0,3,1,-1,10.0,12.0
14718,2008-2009,8,NEC Nijmegen,FC Groningen,2,2,3,1,1,4,0,8.0,10.0
14719,2008-2009,8,Sparta Rotterdam,Feyenoord,2,1,1,3,0,3,1,7.0,1.0
14720,2008-2009,8,De Graafschap,FC Utrecht,0,2,2,0,3,2,-2,1.0,8.0
14721,2008-2009,9,FC Twente,AFC Ajax,0,2,2,0,3,2,-2,9.0,12.0
14722,2008-2009,9,NAC Breda,FC Groningen,1,0,1,3,0,1,1,10.0,7.0
14723,2008-2009,9,PSV,Willem II,2,0,1,3,0,2,2,9.0,6.0
14724,2008-2009,9,sc Heerenveen,AZ Alkmaar,3,3,3,1,1,6,0,6.0,13.0
14725,2008-2009,9,Vitesse,ADO Den Haag,3,1,1,3,0,4,2,7.0,3.0
14726,2008-2009,9,Roda JC Kerkrade,Feyenoord,0,4,2,0,3,4,-4,4.0,4.0
14727,2008-2009,9,FC Volendam,De Graafschap,3,1,1,3,0,4,2,4.0,1.0
14728,2008-2009,9,Sparta Rotterdam,NEC Nijmegen,0,2,2,0,3,2,-2,6.0,10.0
14729,2008-2009,9,FC Utrecht,Heracles Almelo,2,0,1,3,0,2,2,10.0,6.0
14730,2008-2009,10,De Graafschap,NAC Breda,0,2,2,0,3,2,-2,1.0,10.0
14731,2008-2009,10,NEC Nijmegen,PSV,1,0,1,3,0,1,1,10.0,6.0
14732,2008-2009,10,Heracles Almelo,Vitesse,0,0,3,1,1,0,0,4.0,7.0
14733,2008-2009,10,Willem II,Roda JC Kerkrade,2,1,1,3,0,3,1,8.0,4.0
14734,2008-2009,10,AZ Alkmaar,FC Twente,3,0,1,3,0,3,3,13.0,9.0
14735,2008-2009,10,AFC Ajax,Sparta Rotterdam,5,2,1,3,0,7,3,15.0,6.0
14736,2008-2009,10,Feyenoord,FC Utrecht,5,2,1,3,0,7,3,7.0,7.0
14737,2008-2009,10,FC Groningen,FC Volendam,5,0,1,3,0,5,5,7.0,4.0
14738,2008-2009,10,ADO Den Haag,sc Heerenveen,0,1,2,0,3,1,-1,3.0,6.0
14739,2008-2009,11,NAC Breda,Heracles Almelo,3,0,1,3,0,3,3,10.0,4.0
14740,2008-2009,11,ADO Den Haag,Willem II,0,1,2,0,3,1,-1,0.0,8.0
14741,2008-2009,11,Sparta Rotterdam,FC Volendam,4,0,1,3,0,4,4,6.0,4.0
14742,2008-2009,11,sc Heerenveen,FC Utrecht,3,2,1,3,0,5,1,8.0,7.0
14743,2008-2009,11,Roda JC Kerkrade,NEC Nijmegen,3,0,1,3,0,3,3,6.0,7.0
14744,2008-2009,11,AFC Ajax,PSV,4,1,1,3,0,5,3,15.0,6.0
14745,2008-2009,11,FC Twente,Feyenoord,1,1,3,1,1,2,0,7.0,8.0
14746,2008-2009,11,Vitesse,AZ Alkmaar,1,1,3,1,1,2,0,8.0,11.0
14747,2008-2009,11,FC Groningen,De Graafschap,3,0,1,3,0,3,3,10.0,1.0
14748,2008-2009,12,FC Volendam,Roda JC Kerkrade,3,1,1,3,0,4,2,7.0,3.0
14749,2008-2009,12,NAC Breda,NEC Nijmegen,1,1,3,1,1,2,0,10.0,8.0
14750,2008-2009,12,FC Twente,sc Heerenveen,6,0,1,3,0,6,6,7.0,7.0
14751,2008-2009,12,PSV,Heracles Almelo,4,0,1,3,0,4,4,9.0,1.0
14752,2008-2009,12,De Graafschap,Sparta Rotterdam,3,3,3,1,1,6,0,1.0,7.0
14753,2008-2009,12,Feyenoord,ADO Den Haag,3,1,1,3,0,4,2,10.0,0.0
14754,2008-2009,12,AZ Alkmaar,AFC Ajax,2,0,1,3,0,2,2,11.0,12.0
14755,2008-2009,12,Willem II,FC Groningen,3,0,1,3,0,3,3,10.0,7.0
14756,2008-2009,12,FC Utrecht,Vitesse,4,0,1,3,0,4,4,9.0,8.0
14757,2008-2009,13,FC Groningen,AZ Alkmaar,0,2,2,0,3,2,-2,6.0,11.0
14758,2008-2009,13,De Graafschap,Roda JC Kerkrade,1,1,3,1,1,2,0,2.0,4.0
14759,2008-2009,13,ADO Den Haag,FC Twente,1,2,2,0,3,3,-1,0.0,7.0
14760,2008-2009,13,Heracles Almelo,Willem II,1,0,1,3,0,1,1,4.0,9.0
14761,2008-2009,13,sc Heerenveen,PSV,2,2,3,1,1,4,0,8.0,7.0
14762,2008-2009,13,Vitesse,Feyenoord,1,1,3,1,1,2,0,6.0,11.0
14763,2008-2009,13,AFC Ajax,FC Utrecht,1,1,3,1,1,2,0,10.0,7.0
14764,2008-2009,13,NEC Nijmegen,FC Volendam,6,1,1,3,0,7,5,10.0,6.0
14765,2008-2009,13,Sparta Rotterdam,NAC Breda,4,0,1,3,0,4,4,7.0,10.0
14766,2008-2009,14,PSV,FC Groningen,4,2,1,3,0,6,2,7.0,6.0
14767,2008-2009,14,Roda JC Kerkrade,Vitesse,3,0,1,3,0,3,3,7.0,3.0
14768,2008-2009,14,FC Twente,Sparta Rotterdam,6,2,1,3,0,8,4,10.0,7.0
14769,2008-2009,14,AZ Alkmaar,Heracles Almelo,2,0,1,3,0,2,2,13.0,4.0
14770,2008-2009,14,FC Volendam,AFC Ajax,1,2,2,0,3,3,-1,3.0,10.0
14771,2008-2009,14,Willem II,sc Heerenveen,1,3,2,0,3,4,-2,9.0,10.0
14772,2008-2009,14,NAC Breda,ADO Den Haag,0,4,2,0,3,4,-4,7.0,3.0
14773,2008-2009,14,NEC Nijmegen,FC Utrecht,1,2,2,0,3,3,-1,7.0,7.0
14774,2008-2009,14,Feyenoord,De Graafschap,1,3,2,0,3,4,-2,8.0,5.0
14775,2008-2009,15,AFC Ajax,NAC Breda,3,0,1,3,0,3,3,10.0,4.0
14776,2008-2009,15,ADO Den Haag,Roda JC Kerkrade,1,1,3,1,1,2,0,4.0,8.0
14777,2008-2009,15,sc Heerenveen,De Graafschap,2,0,1,3,0,2,2,10.0,5.0
14778,2008-2009,15,Willem II,NEC Nijmegen,1,2,2,0,3,3,-1,6.0,7.0
14779,2008-2009,15,Feyenoord,AZ Alkmaar,0,1,2,0,3,1,-1,5.0,13.0
14780,2008-2009,15,Vitesse,PSV,1,1,3,1,1,2,0,3.0,8.0
14781,2008-2009,15,FC Utrecht,FC Volendam,0,0,3,1,1,0,0,8.0,4.0
14782,2008-2009,15,FC Groningen,FC Twente,1,4,2,0,3,5,-3,3.0,13.0
14783,2008-2009,15,Heracles Almelo,Sparta Rotterdam,2,1,1,3,0,3,1,6.0,7.0
14784,2008-2009,16,AZ Alkmaar,FC Utrecht,2,0,1,3,0,2,2,15.0,8.0
14785,2008-2009,16,Sparta Rotterdam,sc Heerenveen,4,1,1,3,0,5,3,7.0,7.0
14786,2008-2009,16,NAC Breda,Vitesse,2,0,1,3,0,2,2,4.0,2.0
14787,2008-2009,16,Roda JC Kerkrade,FC Groningen,2,5,2,0,3,7,-3,5.0,3.0
14788,2008-2009,16,NEC Nijmegen,ADO Den Haag,0,0,3,1,1,0,0,8.0,5.0
14789,2008-2009,16,De Graafschap,AFC Ajax,0,6,2,0,3,6,-6,5.0,10.0
14790,2008-2009,16,FC Twente,Willem II,2,0,1,3,0,2,2,15.0,3.0
14791,2008-2009,16,FC Volendam,Heracles Almelo,3,1,1,3,0,4,2,7.0,6.0
14792,2008-2009,16,PSV,Feyenoord,1,0,1,3,0,1,1,11.0,4.0
14793,2008-2009,17,Feyenoord,NAC Breda,3,1,1,3,0,4,2,4.0,3.0
14794,2008-2009,17,PSV,FC Twente,0,0,3,1,1,0,0,9.0,13.0
14795,2008-2009,17,Heracles Almelo,De Graafschap,0,0,3,1,1,0,0,7.0,5.0
14796,2008-2009,17,Willem II,Sparta Rotterdam,3,2,1,3,0,5,1,3.0,6.0
14797,2008-2009,17,Vitesse,FC Volendam,3,1,1,3,0,4,2,5.0,4.0
14798,2008-2009,17,AFC Ajax,ADO Den Haag,3,0,1,3,0,3,3,13.0,5.0
14799,2008-2009,17,AZ Alkmaar,NEC Nijmegen,1,0,1,3,0,1,1,15.0,7.0
14800,2008-2009,17,FC Utrecht,Roda JC Kerkrade,3,1,1,3,0,4,2,8.0,5.0
14801,2008-2009,17,FC Groningen,sc Heerenveen,2,3,2,0,3,5,-1,3.0,10.0
14802,2008-2009,18,sc Heerenveen,Feyenoord,3,1,1,3,0,4,2,12.0,3.0
14803,2008-2009,18,De Graafschap,Willem II,1,0,1,3,0,1,1,7.0,3.0
14804,2008-2009,18,FC Twente,Vitesse,2,1,1,3,0,3,1,13.0,4.0
14805,2008-2009,18,ADO Den Haag,Heracles Almelo,2,2,3,1,1,4,0,6.0,5.0
14806,2008-2009,18,NAC Breda,FC Utrecht,1,1,3,1,1,2,0,4.0,8.0
14807,2008-2009,18,Roda JC Kerkrade,PSV,1,1,3,1,1,2,0,5.0,9.0
14808,2008-2009,18,FC Volendam,AZ Alkmaar,0,2,2,0,3,2,-2,4.0,15.0
14809,2008-2009,18,NEC Nijmegen,AFC Ajax,2,4,2,0,3,6,-2,4.0,15.0
14810,2008-2009,18,Sparta Rotterdam,FC Groningen,1,1,3,1,1,2,0,4.0,4.0
14811,2008-2009,19,sc Heerenveen,Roda JC Kerkrade,2,0,1,3,0,2,2,12.0,2.0
14812,2008-2009,19,PSV,NAC Breda,2,2,3,1,1,4,0,7.0,5.0
14813,2008-2009,19,AZ Alkmaar,De Graafschap,2,0,1,3,0,2,2,15.0,4.0
14814,2008-2009,19,Feyenoord,Willem II,1,1,3,1,1,2,0,4.0,4.0
14815,2008-2009,19,Vitesse,NEC Nijmegen,0,0,3,1,1,0,0,5.0,5.0
14816,2008-2009,19,FC Groningen,AFC Ajax,1,0,1,3,0,1,1,7.0,12.0
14817,2008-2009,19,Heracles Almelo,FC Twente,1,2,2,0,3,3,-1,5.0,13.0
14818,2008-2009,19,FC Volendam,ADO Den Haag,0,1,2,0,3,1,-1,4.0,6.0
14819,2008-2009,19,FC Utrecht,Sparta Rotterdam,3,3,3,1,1,6,0,6.0,5.0
14820,2008-2009,20,Roda JC Kerkrade,Heracles Almelo,3,1,1,3,0,4,2,4.0,2.0
14821,2008-2009,20,ADO Den Haag,FC Groningen,0,1,2,0,3,1,-1,5.0,10.0
14822,2008-2009,20,Willem II,Vitesse,0,2,2,0,3,2,-2,4.0,7.0
14823,2008-2009,20,NAC Breda,FC Volendam,1,1,3,1,1,2,0,6.0,4.0
14824,2008-2009,20,AFC Ajax,sc Heerenveen,0,1,2,0,3,1,-1,9.0,12.0
14825,2008-2009,20,FC Twente,FC Utrecht,0,0,3,1,1,0,0,11.0,6.0
14826,2008-2009,20,Sparta Rotterdam,AZ Alkmaar,0,2,2,0,3,2,-2,5.0,15.0
14827,2008-2009,20,De Graafschap,PSV,0,3,2,0,3,3,-3,4.0,9.0
14828,2008-2009,20,NEC Nijmegen,Feyenoord,1,0,1,3,0,1,1,5.0,4.0
14829,2008-2009,21,Willem II,FC Volendam,1,2,2,0,3,3,-1,4.0,4.0
14830,2008-2009,21,Vitesse,sc Heerenveen,1,0,1,3,0,1,1,10.0,12.0
14831,2008-2009,21,AFC Ajax,Heracles Almelo,2,2,3,1,1,4,0,7.0,3.0
14832,2008-2009,21,FC Twente,NAC Breda,4,1,1,3,0,5,3,11.0,3.0
14833,2008-2009,21,AZ Alkmaar,Roda JC Kerkrade,1,0,1,3,0,1,1,15.0,4.0
14834,2008-2009,21,Feyenoord,Sparta Rotterdam,1,0,1,3,0,1,1,7.0,2.0
14835,2008-2009,21,FC Utrecht,De Graafschap,3,0,1,3,0,3,3,9.0,4.0
14836,2008-2009,21,FC Groningen,NEC Nijmegen,2,0,1,3,0,2,2,10.0,4.0
14837,2008-2009,21,PSV,ADO Den Haag,6,0,1,3,0,6,6,9.0,4.0
14838,2008-2009,22,Roda JC Kerkrade,Sparta Rotterdam,0,1,2,0,3,1,-1,4.0,5.0
14839,2008-2009,22,sc Heerenveen,NAC Breda,3,1,1,3,0,4,2,12.0,3.0
14840,2008-2009,22,AZ Alkmaar,Willem II,3,1,1,3,0,4,2,15.0,1.0
14841,2008-2009,22,Heracles Almelo,NEC Nijmegen,1,1,3,1,1,2,0,3.0,5.0
14842,2008-2009,22,FC Utrecht,ADO Den Haag,3,1,1,3,0,4,2,9.0,4.0
14843,2008-2009,22,Vitesse,AFC Ajax,4,1,1,3,0,5,3,10.0,4.0
14844,2008-2009,22,Feyenoord,FC Groningen,0,0,3,1,1,0,0,5.0,11.0
14845,2008-2009,22,De Graafschap,FC Twente,2,2,3,1,1,4,0,4.0,11.0
14846,2008-2009,22,FC Volendam,PSV,3,5,2,0,3,8,-2,4.0,11.0
14847,2008-2009,23,Willem II,FC Utrecht,0,2,2,0,3,2,-2,1.0,11.0
14848,2008-2009,23,ADO Den Haag,De Graafschap,1,0,1,3,0,1,1,6.0,1.0
14849,2008-2009,23,PSV,AZ Alkmaar,2,2,3,1,1,4,0,11.0,13.0
14850,2008-2009,23,FC Twente,FC Volendam,2,1,1,3,0,3,1,11.0,4.0
14851,2008-2009,23,NAC Breda,Roda JC Kerkrade,1,0,1,3,0,1,1,5.0,3.0
14852,2008-2009,23,AFC Ajax,Feyenoord,2,0,1,3,0,2,2,4.0,5.0
14853,2008-2009,23,Sparta Rotterdam,Vitesse,0,0,3,1,1,0,0,5.0,11.0
14854,2008-2009,23,NEC Nijmegen,sc Heerenveen,1,1,3,1,1,2,0,6.0,10.0
14855,2008-2009,23,FC Groningen,Heracles Almelo,2,0,1,3,0,2,2,13.0,2.0
14856,2008-2009,24,Vitesse,Roda JC Kerkrade,3,0,1,3,0,3,3,13.0,3.0
14857,2008-2009,24,sc Heerenveen,Willem II,3,1,1,3,0,4,2,10.0,0.0
14858,2008-2009,24,ADO Den Haag,NAC Breda,1,1,3,1,1,2,0,4.0,5.0
14859,2008-2009,24,Heracles Almelo,AZ Alkmaar,0,2,2,0,3,2,-2,2.0,13.0
14860,2008-2009,24,FC Groningen,PSV,0,1,2,0,3,1,-1,10.0,13.0
14861,2008-2009,24,FC Utrecht,NEC Nijmegen,0,2,2,0,3,2,-2,10.0,8.0
14862,2008-2009,24,De Graafschap,Feyenoord,0,2,2,0,3,2,-2,1.0,7.0
14863,2008-2009,24,Sparta Rotterdam,FC Twente,1,2,2,0,3,3,-1,4.0,11.0
14864,2008-2009,24,AFC Ajax,FC Volendam,2,1,1,3,0,3,1,7.0,4.0
14865,2008-2009,25,PSV,sc Heerenveen,2,3,2,0,3,5,-1,10.0,10.0
14866,2008-2009,25,Willem II,Heracles Almelo,0,3,2,0,3,3,-3,0.0,5.0
14867,2008-2009,25,NAC Breda,Sparta Rotterdam,3,1,1,3,0,4,2,7.0,4.0
14868,2008-2009,25,Roda JC Kerkrade,De Graafschap,3,1,1,3,0,4,2,3.0,1.0
14869,2008-2009,25,AZ Alkmaar,FC Groningen,3,0,1,3,0,3,3,13.0,7.0
14870,2008-2009,25,FC Utrecht,AFC Ajax,0,2,2,0,3,2,-2,9.0,10.0
14871,2008-2009,25,Feyenoord,Vitesse,2,2,3,1,1,4,0,8.0,11.0
14872,2008-2009,25,FC Twente,ADO Den Haag,1,0,1,3,0,1,1,13.0,4.0
14873,2008-2009,25,FC Volendam,NEC Nijmegen,1,1,3,1,1,2,0,4.0,6.0
14874,2008-2009,26,Sparta Rotterdam,Willem II,0,1,2,0,3,1,-1,4.0,3.0
14875,2008-2009,26,sc Heerenveen,FC Groningen,2,1,1,3,0,3,1,13.0,4.0
14876,2008-2009,26,De Graafschap,Heracles Almelo,1,0,1,3,0,1,1,4.0,4.0
14877,2008-2009,26,ADO Den Haag,AFC Ajax,1,1,3,1,1,2,0,5.0,10.0
14878,2008-2009,26,NEC Nijmegen,AZ Alkmaar,0,1,2,0,3,1,-1,6.0,13.0
14879,2008-2009,26,FC Volendam,Vitesse,1,0,1,3,0,1,1,4.0,8.0
14880,2008-2009,26,NAC Breda,Feyenoord,1,2,2,0,3,3,-1,7.0,8.0
14881,2008-2009,26,Roda JC Kerkrade,FC Utrecht,0,0,3,1,1,0,0,4.0,7.0
14882,2008-2009,26,FC Twente,PSV,1,1,3,1,1,2,0,11.0,8.0
14883,2008-2009,27,FC Groningen,Roda JC Kerkrade,2,0,1,3,0,2,2,6.0,4.0
14884,2008-2009,27,Vitesse,NAC Breda,0,3,2,0,3,3,-3,5.0,10.0
14885,2008-2009,27,Willem II,FC Twente,0,2,2,0,3,2,-2,3.0,13.0
14886,2008-2009,27,sc Heerenveen,Sparta Rotterdam,5,1,1,3,0,6,4,13.0,1.0
14887,2008-2009,27,Heracles Almelo,FC Volendam,1,1,3,1,1,2,0,4.0,5.0
14888,2008-2009,27,Feyenoord,PSV,1,0,1,3,0,1,1,10.0,5.0
14889,2008-2009,27,ADO Den Haag,NEC Nijmegen,3,0,1,3,0,3,3,8.0,5.0
14890,2008-2009,27,AFC Ajax,De Graafschap,3,0,1,3,0,3,3,13.0,3.0
14891,2008-2009,27,FC Utrecht,AZ Alkmaar,0,1,2,0,3,1,-1,4.0,13.0
14892,2008-2009,28,De Graafschap,sc Heerenveen,2,0,1,3,0,2,2,6.0,12.0
14893,2008-2009,28,NEC Nijmegen,Willem II,0,0,3,1,1,0,0,5.0,4.0
14894,2008-2009,28,PSV,Vitesse,2,0,1,3,0,2,2,7.0,4.0
14895,2008-2009,28,Sparta Rotterdam,Heracles Almelo,1,0,1,3,0,1,1,3.0,4.0
14896,2008-2009,28,Roda JC Kerkrade,ADO Den Haag,2,0,1,3,0,2,2,7.0,5.0
14897,2008-2009,28,NAC Breda,AFC Ajax,0,3,2,0,3,3,-3,7.0,13.0
14898,2008-2009,28,AZ Alkmaar,Feyenoord,0,0,3,1,1,0,0,13.0,11.0
14899,2008-2009,28,FC Volendam,FC Utrecht,0,0,3,1,1,0,0,6.0,2.0
14900,2008-2009,28,FC Twente,FC Groningen,2,1,1,3,0,3,1,13.0,3.0
14901,2008-2009,29,NEC Nijmegen,FC Twente,1,1,3,1,1,2,0,3.0,11.0
14902,2008-2009,29,FC Utrecht,FC Groningen,0,1,2,0,3,1,-1,2.0,6.0
14903,2008-2009,29,Heracles Almelo,sc Heerenveen,1,1,3,1,1,2,0,5.0,10.0
14904,2008-2009,29,AZ Alkmaar,ADO Den Haag,4,1,1,3,0,5,3,13.0,4.0
14905,2008-2009,29,Sparta Rotterdam,PSV,0,2,2,0,3,2,-2,3.0,7.0
14906,2008-2009,29,Roda JC Kerkrade,AFC Ajax,1,2,2,0,3,3,-1,7.0,13.0
14907,2008-2009,29,FC Volendam,Feyenoord,2,1,1,3,0,3,1,9.0,8.0
14908,2008-2009,29,Willem II,NAC Breda,2,0,1,3,0,2,2,7.0,6.0
14909,2008-2009,29,Vitesse,De Graafschap,0,0,3,1,1,0,0,2.0,7.0
14910,2008-2009,30,NAC Breda,AZ Alkmaar,0,1,2,0,3,1,-1,3.0,13.0
14911,2008-2009,30,De Graafschap,NEC Nijmegen,2,2,3,1,1,4,0,8.0,3.0
14912,2008-2009,30,ADO Den Haag,Sparta Rotterdam,1,2,2,0,3,3,-1,4.0,6.0
14913,2008-2009,30,PSV,FC Utrecht,2,0,1,3,0,2,2,10.0,2.0
14914,2008-2009,30,FC Twente,Roda JC Kerkrade,4,2,1,3,0,6,2,11.0,4.0
14915,2008-2009,30,sc Heerenveen,FC Volendam,1,0,1,3,0,1,1,10.0,8.0
14916,2008-2009,30,FC Groningen,Vitesse,2,3,2,0,3,5,-1,6.0,4.0
14917,2008-2009,30,Feyenoord,Heracles Almelo,5,1,1,3,0,6,4,10.0,2.0
14918,2008-2009,30,AFC Ajax,Willem II,7,0,1,3,0,7,7,13.0,7.0
14919,2008-2009,31,Heracles Almelo,NAC Breda,4,0,1,3,0,4,4,5.0,3.0
14920,2008-2009,31,NEC Nijmegen,Roda JC Kerkrade,1,1,3,1,1,2,0,4.0,4.0
14921,2008-2009,31,De Graafschap,FC Groningen,0,1,2,0,3,1,-1,5.0,9.0
14922,2008-2009,31,AZ Alkmaar,Vitesse,1,2,2,0,3,3,-1,10.0,7.0
14923,2008-2009,31,Feyenoord,FC Twente,1,0,1,3,0,1,1,10.0,10.0
14924,2008-2009,31,FC Utrecht,sc Heerenveen,2,1,1,3,0,3,1,4.0,7.0
14925,2008-2009,31,Willem II,ADO Den Haag,3,3,3,1,1,6,0,5.0,4.0
14926,2008-2009,31,FC Volendam,Sparta Rotterdam,3,0,1,3,0,3,3,8.0,6.0
14927,2008-2009,31,PSV,AFC Ajax,6,2,1,3,0,8,4,12.0,12.0
14928,2008-2009,32,Sparta Rotterdam,De Graafschap,0,0,3,1,1,0,0,7.0,6.0
14929,2008-2009,32,Roda JC Kerkrade,FC Volendam,1,1,3,1,1,2,0,5.0,8.0
14930,2008-2009,32,sc Heerenveen,FC Twente,1,1,3,1,1,2,0,5.0,8.0
14931,2008-2009,32,NEC Nijmegen,NAC Breda,2,3,2,0,3,5,-1,4.0,3.0
14932,2008-2009,32,Heracles Almelo,PSV,0,2,2,0,3,2,-2,4.0,15.0
14933,2008-2009,32,ADO Den Haag,Feyenoord,2,3,2,0,3,5,-1,1.0,10.0
14934,2008-2009,32,Vitesse,FC Utrecht,6,1,1,3,0,7,5,10.0,4.0
14935,2008-2009,32,FC Groningen,Willem II,0,0,3,1,1,0,0,7.0,6.0
14936,2008-2009,32,AFC Ajax,AZ Alkmaar,1,1,3,1,1,2,0,10.0,8.0
14937,2008-2009,33,Roda JC Kerkrade,Willem II,0,1,2,0,3,1,-1,2.0,8.0
14938,2008-2009,33,Vitesse,Heracles Almelo,1,0,1,3,0,1,1,13.0,4.0
14939,2008-2009,33,PSV,NEC Nijmegen,1,1,3,1,1,2,0,13.0,4.0
14940,2008-2009,33,FC Twente,AZ Alkmaar,3,0,1,3,0,3,3,8.0,7.0
14941,2008-2009,33,Sparta Rotterdam,AFC Ajax,4,0,1,3,0,4,4,7.0,7.0
14942,2008-2009,33,NAC Breda,De Graafschap,0,1,2,0,3,1,-1,3.0,6.0
14943,2008-2009,33,FC Utrecht,Feyenoord,2,2,3,1,1,4,0,4.0,10.0
14944,2008-2009,33,FC Volendam,FC Groningen,0,1,2,0,3,1,-1,7.0,10.0
14945,2008-2009,33,sc Heerenveen,ADO Den Haag,2,2,3,1,1,4,0,6.0,2.0
14946,2008-2009,34,Heracles Almelo,FC Utrecht,1,1,3,1,1,2,0,4.0,5.0
14947,2008-2009,34,AFC Ajax,FC Twente,1,0,1,3,0,1,1,7.0,7.0
14948,2008-2009,34,ADO Den Haag,Vitesse,3,1,1,3,0,4,2,5.0,12.0
14949,2008-2009,34,FC Groningen,NAC Breda,1,0,1,3,0,1,1,10.0,3.0
14950,2008-2009,34,AZ Alkmaar,sc Heerenveen,3,1,1,3,0,4,2,7.0,5.0
14951,2008-2009,34,De Graafschap,FC Volendam,2,2,3,1,1,4,0,6.0,5.0
14952,2008-2009,34,NEC Nijmegen,Sparta Rotterdam,1,1,3,1,1,2,0,4.0,8.0
14953,2008-2009,34,Willem II,PSV,0,3,2,0,3,3,-3,5.0,13.0
14954,2008-2009,34,Feyenoord,Roda JC Kerkrade,2,3,2,0,3,5,-1,10.0,5.0
14955,2009-2010,1,sc Heerenveen,Roda JC Kerkrade,0,0,3,1,1,0,0,3.0,6.0
14956,2009-2010,1,Willem II,Vitesse,3,1,1,3,0,4,2,8.0,9.0
14957,2009-2010,1,Heracles Almelo,AZ Alkmaar,3,2,1,3,0,5,1,7.0,4.0
14958,2009-2010,1,Sparta Rotterdam,FC Twente,0,2,2,0,3,2,-2,5.0,7.0
14959,2009-2010,1,RKC Waalwijk,FC Utrecht,0,1,2,0,3,1,-1,5.0,8.0
14960,2009-2010,1,ADO Den Haag,NAC Breda,1,2,2,0,3,3,-1,5.0,6.0
14961,2009-2010,1,Feyenoord,NEC Nijmegen,2,0,1,3,0,2,2,10.0,3.0
14962,2009-2010,1,FC Groningen,AFC Ajax,0,2,2,0,3,2,-2,10.0,7.0
14963,2009-2010,1,PSV,VVV-Venlo,3,3,3,1,1,6,0,11.0,4.0
14964,2009-2010,2,NEC Nijmegen,sc Heerenveen,4,1,1,3,0,5,3,5.0,3.0
14965,2009-2010,2,AZ Alkmaar,Sparta Rotterdam,2,0,1,3,0,2,2,7.0,5.0
14966,2009-2010,2,AFC Ajax,RKC Waalwijk,4,1,1,3,0,5,3,10.0,4.0
14967,2009-2010,2,Roda JC Kerkrade,FC Groningen,1,1,3,1,1,2,0,6.0,8.0
14968,2009-2010,2,NAC Breda,Heracles Almelo,0,0,3,1,1,0,0,7.0,5.0
14969,2009-2010,2,Vitesse,Feyenoord,0,0,3,1,1,0,0,7.0,8.0
14970,2009-2010,2,FC Twente,PSV,1,1,3,1,1,2,0,8.0,9.0
14971,2009-2010,2,FC Utrecht,Willem II,1,0,1,3,0,1,1,8.0,7.0
14972,2009-2010,2,VVV-Venlo,ADO Den Haag,2,2,3,1,1,4,0,5.0,5.0
14973,2009-2010,3,Sparta Rotterdam,Willem II,2,1,1,3,0,3,1,7.0,6.0
14974,2009-2010,3,ADO Den Haag,FC Twente,0,1,2,0,3,1,-1,5.0,10.0
14975,2009-2010,3,RKC Waalwijk,AZ Alkmaar,0,6,2,0,3,6,-6,1.0,9.0
14976,2009-2010,3,sc Heerenveen,Vitesse,1,0,1,3,0,1,1,5.0,4.0
14977,2009-2010,3,PSV,AFC Ajax,4,3,1,3,0,7,1,9.0,9.0
14978,2009-2010,3,Roda JC Kerkrade,NEC Nijmegen,1,0,1,3,0,1,1,8.0,5.0
14979,2009-2010,3,Heracles Almelo,Feyenoord,0,1,2,0,3,1,-1,5.0,8.0
14980,2009-2010,3,FC Utrecht,VVV-Venlo,2,2,3,1,1,4,0,9.0,6.0
14981,2009-2010,3,FC Groningen,NAC Breda,1,2,2,0,3,3,-1,7.0,7.0
14982,2009-2010,4,Vitesse,ADO Den Haag,1,3,2,0,3,4,-2,1.0,7.0
14983,2009-2010,4,Willem II,Heracles Almelo,0,1,2,0,3,1,-1,3.0,8.0
14984,2009-2010,4,VVV-Venlo,FC Groningen,2,2,3,1,1,4,0,7.0,5.0
14985,2009-2010,4,FC Twente,RKC Waalwijk,2,1,1,3,0,3,1,10.0,0.0
14986,2009-2010,4,AFC Ajax,Sparta Rotterdam,0,0,3,1,1,0,0,10.0,5.0
14987,2009-2010,4,sc Heerenveen,AZ Alkmaar,0,2,2,0,3,2,-2,4.0,12.0
14988,2009-2010,4,PSV,NAC Breda,3,1,1,3,0,4,2,11.0,7.0
14989,2009-2010,4,Feyenoord,Roda JC Kerkrade,4,0,1,3,0,4,4,10.0,8.0
14990,2009-2010,4,NEC Nijmegen,FC Utrecht,1,1,3,1,1,2,0,5.0,9.0
14991,2009-2010,5,RKC Waalwijk,ADO Den Haag,0,2,2,0,3,2,-2,0.0,7.0
14992,2009-2010,5,Roda JC Kerkrade,Vitesse,3,4,2,0,3,7,-1,5.0,4.0
14993,2009-2010,5,NEC Nijmegen,VVV-Venlo,1,1,3,1,1,2,0,5.0,5.0
14994,2009-2010,5,AZ Alkmaar,Willem II,2,1,1,3,0,3,1,12.0,3.0
14995,2009-2010,5,FC Utrecht,Sparta Rotterdam,2,0,1,3,0,2,2,11.0,4.0
14996,2009-2010,5,Feyenoord,FC Twente,1,1,3,1,1,2,0,11.0,11.0
14997,2009-2010,5,FC Groningen,PSV,0,2,2,0,3,2,-2,2.0,11.0
14998,2009-2010,5,NAC Breda,sc Heerenveen,2,0,1,3,0,2,2,10.0,4.0
14999,2009-2010,5,Heracles Almelo,AFC Ajax,0,3,2,0,3,3,-3,7.0,10.0
15000,2009-2010,6,PSV,Roda JC Kerkrade,3,0,1,3,0,3,3,13.0,4.0
15001,2009-2010,6,FC Twente,FC Utrecht,3,2,1,3,0,5,1,11.0,8.0
15002,2009-2010,6,sc Heerenveen,FC Groningen,0,1,2,0,3,1,-1,3.0,5.0
15003,2009-2010,6,ADO Den Haag,AZ Alkmaar,2,1,1,3,0,3,1,10.0,12.0
15004,2009-2010,6,Willem II,Feyenoord,2,3,2,0,3,5,-1,0.0,11.0
15005,2009-2010,6,Sparta Rotterdam,RKC Waalwijk,1,0,1,3,0,1,1,7.0,0.0
15006,2009-2010,6,AFC Ajax,NAC Breda,6,0,1,3,0,6,6,10.0,7.0
15007,2009-2010,6,VVV-Venlo,Heracles Almelo,1,0,1,3,0,1,1,7.0,4.0
15008,2009-2010,6,Vitesse,NEC Nijmegen,2,2,3,1,1,4,0,5.0,6.0
15009,2009-2010,7,Willem II,FC Groningen,2,1,1,3,0,3,1,3.0,4.0
15010,2009-2010,7,Heracles Almelo,Sparta Rotterdam,1,1,3,1,1,2,0,4.0,8.0
15011,2009-2010,7,Vitesse,RKC Waalwijk,3,1,1,3,0,4,2,7.0,0.0
15012,2009-2010,7,Roda JC Kerkrade,NAC Breda,2,0,1,3,0,2,2,6.0,6.0
15013,2009-2010,7,AZ Alkmaar,NEC Nijmegen,0,1,2,0,3,1,-1,9.0,6.0
15014,2009-2010,7,ADO Den Haag,FC Utrecht,0,1,2,0,3,1,-1,9.0,8.0
15015,2009-2010,7,sc Heerenveen,FC Twente,0,2,2,0,3,2,-2,3.0,13.0
15016,2009-2010,7,Feyenoord,PSV,1,3,2,0,3,4,-2,10.0,15.0
15017,2009-2010,7,VVV-Venlo,AFC Ajax,0,4,2,0,3,4,-4,6.0,10.0
15018,2009-2010,8,FC Utrecht,AZ Alkmaar,1,0,1,3,0,1,1,10.0,6.0
15019,2009-2010,8,PSV,Willem II,3,1,1,3,0,4,2,15.0,3.0
15020,2009-2010,8,RKC Waalwijk,Roda JC Kerkrade,4,1,1,3,0,5,3,3.0,3.0
15021,2009-2010,8,FC Twente,VVV-Venlo,2,1,1,3,0,3,1,13.0,5.0
15022,2009-2010,8,AFC Ajax,ADO Den Haag,3,0,1,3,0,3,3,13.0,9.0
15023,2009-2010,8,FC Groningen,Vitesse,1,0,1,3,0,1,1,7.0,7.0
15024,2009-2010,8,Sparta Rotterdam,sc Heerenveen,0,2,2,0,3,2,-2,5.0,3.0
15025,2009-2010,8,NAC Breda,Feyenoord,0,2,2,0,3,2,-2,3.0,10.0
15026,2009-2010,8,NEC Nijmegen,Heracles Almelo,0,2,2,0,3,2,-2,6.0,7.0
15027,2009-2010,9,Vitesse,Sparta Rotterdam,2,0,1,3,0,2,2,10.0,4.0
15028,2009-2010,9,ADO Den Haag,FC Groningen,1,1,3,1,1,2,0,7.0,7.0
15029,2009-2010,9,AZ Alkmaar,NAC Breda,1,0,1,3,0,1,1,6.0,3.0
15030,2009-2010,9,Willem II,NEC Nijmegen,1,1,3,1,1,2,0,4.0,6.0
15031,2009-2010,9,Feyenoord,RKC Waalwijk,3,0,1,3,0,3,3,10.0,3.0
15032,2009-2010,9,Roda JC Kerkrade,AFC Ajax,2,2,3,1,1,4,0,4.0,13.0
15033,2009-2010,9,Heracles Almelo,FC Twente,1,3,2,0,3,4,-2,4.0,13.0
15034,2009-2010,9,sc Heerenveen,VVV-Venlo,1,1,3,1,1,2,0,4.0,5.0
15035,2009-2010,9,FC Utrecht,PSV,0,0,3,1,1,0,0,10.0,13.0
15036,2009-2010,10,AFC Ajax,Willem II,4,0,1,3,0,4,4,13.0,4.0
15037,2009-2010,10,FC Twente,AZ Alkmaar,3,2,1,3,0,5,1,15.0,3.0
15038,2009-2010,10,NAC Breda,Vitesse,4,0,1,3,0,4,4,3.0,7.0
15039,2009-2010,10,PSV,sc Heerenveen,1,0,1,3,0,1,1,13.0,4.0
15040,2009-2010,10,VVV-Venlo,Roda JC Kerkrade,1,1,3,1,1,2,0,5.0,5.0
15041,2009-2010,10,RKC Waalwijk,Heracles Almelo,0,1,2,0,3,1,-1,3.0,7.0
15042,2009-2010,10,NEC Nijmegen,ADO Den Haag,1,1,3,1,1,2,0,6.0,5.0
15043,2009-2010,10,FC Groningen,FC Utrecht,0,0,3,1,1,0,0,8.0,8.0
15044,2009-2010,10,Sparta Rotterdam,Feyenoord,2,1,1,3,0,3,1,7.0,9.0
15045,2009-2010,11,FC Utrecht,Roda JC Kerkrade,2,1,1,3,0,3,1,11.0,5.0
15046,2009-2010,11,ADO Den Haag,Sparta Rotterdam,2,3,2,0,3,5,-1,2.0,7.0
15047,2009-2010,11,Feyenoord,VVV-Venlo,1,0,1,3,0,1,1,9.0,2.0
15048,2009-2010,11,Vitesse,Heracles Almelo,0,2,2,0,3,2,-2,6.0,10.0
15049,2009-2010,11,NAC Breda,RKC Waalwijk,1,0,1,3,0,1,1,6.0,3.0
15050,2009-2010,11,FC Twente,FC Groningen,4,0,1,3,0,4,4,15.0,5.0
15051,2009-2010,11,AZ Alkmaar,AFC Ajax,2,4,2,0,3,6,-2,3.0,13.0
15052,2009-2010,11,Willem II,sc Heerenveen,4,1,1,3,0,5,3,7.0,4.0
15053,2009-2010,11,NEC Nijmegen,PSV,0,4,2,0,3,4,-4,5.0,13.0
15054,2009-2010,12,VVV-Venlo,NAC Breda,1,1,3,1,1,2,0,3.0,7.0
15055,2009-2010,12,sc Heerenveen,ADO Den Haag,3,0,1,3,0,3,3,7.0,2.0
15056,2009-2010,12,Roda JC Kerkrade,FC Twente,1,2,2,0,3,3,-1,2.0,15.0
15057,2009-2010,12,PSV,Vitesse,1,0,1,3,0,1,1,13.0,3.0
15058,2009-2010,12,FC Groningen,AZ Alkmaar,0,1,2,0,3,1,-1,5.0,6.0
15059,2009-2010,12,AFC Ajax,Feyenoord,5,1,1,3,0,6,4,13.0,9.0
15060,2009-2010,12,RKC Waalwijk,Willem II,0,1,2,0,3,1,-1,3.0,7.0
15061,2009-2010,12,Sparta Rotterdam,NEC Nijmegen,2,0,1,3,0,2,2,9.0,2.0
15062,2009-2010,12,Heracles Almelo,FC Utrecht,3,1,1,3,0,4,2,12.0,8.0
15063,2009-2010,13,FC Groningen,Heracles Almelo,4,1,1,3,0,5,3,5.0,9.0
15064,2009-2010,13,Vitesse,VVV-Venlo,2,0,1,3,0,2,2,6.0,3.0
15065,2009-2010,13,Sparta Rotterdam,Roda JC Kerkrade,1,2,2,0,3,3,-1,9.0,5.0
15066,2009-2010,13,NEC Nijmegen,RKC Waalwijk,0,1,2,0,3,1,-1,2.0,3.0
15067,2009-2010,13,NAC Breda,Willem II,4,0,1,3,0,4,4,10.0,7.0
15068,2009-2010,13,ADO Den Haag,PSV,1,5,2,0,3,6,-4,2.0,13.0
15069,2009-2010,13,AZ Alkmaar,Feyenoord,1,1,3,1,1,2,0,7.0,7.0
15070,2009-2010,13,FC Utrecht,sc Heerenveen,2,3,2,0,3,5,-1,5.0,7.0
15071,2009-2010,13,FC Twente,AFC Ajax,1,0,1,3,0,1,1,15.0,10.0
15072,2009-2010,14,Roda JC Kerkrade,AZ Alkmaar,2,4,2,0,3,6,-2,4.0,7.0
15073,2009-2010,14,NAC Breda,NEC Nijmegen,3,3,3,1,1,6,0,11.0,2.0
15074,2009-2010,14,RKC Waalwijk,FC Groningen,3,1,1,3,0,4,2,6.0,4.0
15075,2009-2010,14,FC Twente,Vitesse,1,0,1,3,0,1,1,15.0,3.0
15076,2009-2010,14,Feyenoord,FC Utrecht,0,0,3,1,1,0,0,5.0,5.0
15077,2009-2010,14,AFC Ajax,sc Heerenveen,5,1,1,3,0,6,4,12.0,6.0
15078,2009-2010,14,Willem II,ADO Den Haag,1,1,3,1,1,2,0,7.0,2.0
15079,2009-2010,14,VVV-Venlo,Sparta Rotterdam,5,0,1,3,0,5,5,5.0,9.0
15080,2009-2010,14,PSV,Heracles Almelo,4,0,1,3,0,4,4,15.0,9.0
15081,2009-2010,15,Sparta Rotterdam,PSV,2,3,2,0,3,5,-1,6.0,15.0
15082,2009-2010,15,AZ Alkmaar,VVV-Venlo,2,0,1,3,0,2,2,10.0,4.0
15083,2009-2010,15,Heracles Almelo,Roda JC Kerkrade,3,2,1,3,0,5,1,9.0,3.0
15084,2009-2010,15,sc Heerenveen,RKC Waalwijk,3,1,1,3,0,4,2,9.0,6.0
15085,2009-2010,15,Willem II,FC Twente,1,3,2,0,3,4,-2,7.0,15.0
15086,2009-2010,15,Vitesse,AFC Ajax,1,5,2,0,3,6,-4,3.0,12.0
15087,2009-2010,15,ADO Den Haag,Feyenoord,0,2,2,0,3,2,-2,1.0,8.0
15088,2009-2010,15,FC Utrecht,NAC Breda,3,1,1,3,0,4,2,7.0,8.0
15089,2009-2010,15,FC Groningen,NEC Nijmegen,2,2,3,1,1,4,0,4.0,2.0
15090,2009-2010,16,VVV-Venlo,Willem II,2,1,1,3,0,3,1,7.0,4.0
15091,2009-2010,16,AZ Alkmaar,Vitesse,1,2,2,0,3,3,-1,10.0,6.0
15092,2009-2010,16,Roda JC Kerkrade,ADO Den Haag,1,1,3,1,1,2,0,4.0,2.0
15093,2009-2010,16,NAC Breda,Sparta Rotterdam,2,2,3,1,1,4,0,6.0,4.0
15094,2009-2010,16,FC Utrecht,AFC Ajax,2,0,1,3,0,2,2,7.0,9.0
15095,2009-2010,16,RKC Waalwijk,PSV,0,2,2,0,3,2,-2,6.0,15.0
15096,2009-2010,16,Feyenoord,FC Groningen,3,1,1,3,0,4,2,8.0,4.0
15097,2009-2010,16,NEC Nijmegen,FC Twente,3,4,2,0,3,7,-1,2.0,15.0
15098,2009-2010,16,Heracles Almelo,sc Heerenveen,3,1,1,3,0,4,2,9.0,9.0
15099,2009-2010,17,AFC Ajax,NEC Nijmegen,3,0,1,3,0,3,3,9.0,2.0
15100,2009-2010,17,VVV-Venlo,RKC Waalwijk,3,0,1,3,0,3,3,9.0,6.0
15101,2009-2010,17,FC Twente,NAC Breda,3,1,1,3,0,4,2,15.0,5.0
15102,2009-2010,17,sc Heerenveen,Feyenoord,0,2,2,0,3,2,-2,6.0,11.0
15103,2009-2010,17,PSV,AZ Alkmaar,1,0,1,3,0,1,1,15.0,7.0
15104,2009-2010,17,Vitesse,FC Utrecht,2,2,3,1,1,4,0,7.0,8.0
15105,2009-2010,17,Willem II,Roda JC Kerkrade,1,3,2,0,3,4,-2,1.0,7.0
15106,2009-2010,17,ADO Den Haag,Heracles Almelo,1,4,2,0,3,5,-3,2.0,9.0
15107,2009-2010,17,Sparta Rotterdam,FC Groningen,2,4,2,0,3,6,-2,1.0,7.0
15108,2009-2010,18,Heracles Almelo,VVV-Venlo,1,0,1,3,0,1,1,12.0,9.0
15109,2009-2010,18,AZ Alkmaar,ADO Den Haag,3,0,1,3,0,3,3,9.0,2.0
15110,2009-2010,18,Feyenoord,Willem II,1,0,1,3,0,1,1,13.0,1.0
15111,2009-2010,18,RKC Waalwijk,Sparta Rotterdam,4,1,1,3,0,5,3,6.0,1.0
15112,2009-2010,18,NEC Nijmegen,Vitesse,2,1,1,3,0,3,1,5.0,4.0
15113,2009-2010,18,FC Utrecht,FC Twente,0,0,3,1,1,0,0,9.0,13.0
15114,2009-2010,18,NAC Breda,AFC Ajax,1,1,3,1,1,2,0,3.0,10.0
15115,2009-2010,18,Roda JC Kerkrade,PSV,0,1,2,0,3,1,-1,4.0,15.0
15116,2009-2010,18,FC Groningen,sc Heerenveen,2,0,1,3,0,2,2,7.0,3.0
15117,2009-2010,19,PSV,NEC Nijmegen,3,0,1,3,0,3,3,15.0,4.0
15118,2009-2010,19,Heracles Almelo,Vitesse,1,2,2,0,3,3,-1,12.0,7.0
15119,2009-2010,19,Roda JC Kerkrade,FC Utrecht,2,0,1,3,0,2,2,7.0,8.0
15120,2009-2010,19,sc Heerenveen,Willem II,4,2,1,3,0,6,2,6.0,0.0
15121,2009-2010,19,RKC Waalwijk,NAC Breda,0,1,2,0,3,1,-1,3.0,5.0
15122,2009-2010,19,AFC Ajax,AZ Alkmaar,1,0,1,3,0,1,1,10.0,6.0
15123,2009-2010,19,FC Groningen,FC Twente,0,0,3,1,1,0,0,8.0,11.0
15124,2009-2010,19,VVV-Venlo,Feyenoord,1,1,3,1,1,2,0,7.0,13.0
15125,2009-2010,19,Sparta Rotterdam,ADO Den Haag,0,0,3,1,1,0,0,2.0,2.0
15126,2009-2010,20,Willem II,RKC Waalwijk,2,1,1,3,0,3,1,3.0,3.0
15127,2009-2010,20,NEC Nijmegen,Sparta Rotterdam,1,0,1,3,0,1,1,6.0,2.0
15128,2009-2010,20,NAC Breda,VVV-Venlo,2,0,1,3,0,2,2,8.0,7.0
15129,2009-2010,20,AZ Alkmaar,FC Groningen,0,1,2,0,3,1,-1,3.0,10.0
15130,2009-2010,20,ADO Den Haag,sc Heerenveen,2,1,1,3,0,3,1,5.0,3.0
15131,2009-2010,20,Feyenoord,AFC Ajax,1,1,3,1,1,2,0,11.0,8.0
15132,2009-2010,20,FC Twente,Roda JC Kerkrade,2,0,1,3,0,2,2,11.0,7.0
15133,2009-2010,20,FC Utrecht,Heracles Almelo,0,0,3,1,1,0,0,6.0,10.0
15134,2009-2010,20,Vitesse,PSV,0,0,3,1,1,0,0,8.0,13.0
15135,2009-2010,21,VVV-Venlo,sc Heerenveen,3,1,1,3,0,4,2,7.0,3.0
15136,2009-2010,21,NAC Breda,AZ Alkmaar,1,1,3,1,1,2,0,8.0,4.0
15137,2009-2010,21,FC Groningen,ADO Den Haag,2,0,1,3,0,2,2,13.0,4.0
15138,2009-2010,21,FC Twente,Heracles Almelo,2,0,1,3,0,2,2,11.0,7.0
15139,2009-2010,21,PSV,FC Utrecht,2,1,1,3,0,3,1,13.0,3.0
15140,2009-2010,21,AFC Ajax,Roda JC Kerkrade,4,0,1,3,0,4,4,11.0,6.0
15141,2009-2010,21,Sparta Rotterdam,Vitesse,1,1,3,1,1,2,0,2.0,6.0
15142,2009-2010,21,RKC Waalwijk,Feyenoord,0,1,2,0,3,1,-1,3.0,11.0
15143,2009-2010,21,NEC Nijmegen,Willem II,2,1,1,3,0,3,1,9.0,3.0
15144,2009-2010,22,Willem II,NAC Breda,1,2,2,0,3,3,-1,3.0,11.0
15145,2009-2010,22,PSV,ADO Den Haag,2,0,1,3,0,2,2,13.0,4.0
15146,2009-2010,22,Roda JC Kerkrade,Sparta Rotterdam,2,1,1,3,0,3,1,6.0,2.0
15147,2009-2010,22,sc Heerenveen,FC Utrecht,2,0,1,3,0,2,2,6.0,2.0
15148,2009-2010,22,Heracles Almelo,FC Groningen,4,3,1,3,0,7,1,7.0,10.0
15149,2009-2010,22,RKC Waalwijk,NEC Nijmegen,0,1,2,0,3,1,-1,3.0,12.0
15150,2009-2010,22,Feyenoord,AZ Alkmaar,1,2,2,0,3,3,-1,8.0,7.0
15151,2009-2010,22,VVV-Venlo,Vitesse,2,0,1,3,0,2,2,7.0,5.0
15152,2009-2010,22,AFC Ajax,FC Twente,3,0,1,3,0,3,3,11.0,8.0
15153,2009-2010,23,NEC Nijmegen,NAC Breda,4,2,1,3,0,6,2,12.0,10.0
15154,2009-2010,23,Vitesse,FC Twente,1,2,2,0,3,3,-1,5.0,10.0
15155,2009-2010,23,sc Heerenveen,AFC Ajax,0,2,2,0,3,2,-2,6.0,13.0
15156,2009-2010,23,ADO Den Haag,Willem II,3,0,1,3,0,3,3,7.0,3.0
15157,2009-2010,23,AZ Alkmaar,Roda JC Kerkrade,2,0,1,3,0,2,2,7.0,6.0
15158,2009-2010,23,FC Utrecht,Feyenoord,0,0,3,1,1,0,0,2.0,6.0
15159,2009-2010,23,Heracles Almelo,PSV,0,1,2,0,3,1,-1,4.0,13.0
15160,2009-2010,23,Sparta Rotterdam,VVV-Venlo,2,0,1,3,0,2,2,5.0,7.0
15161,2009-2010,23,FC Groningen,RKC Waalwijk,2,1,1,3,0,3,1,10.0,0.0
15162,2009-2010,24,Roda JC Kerkrade,Heracles Almelo,2,1,1,3,0,3,1,6.0,4.0
15163,2009-2010,24,NAC Breda,FC Utrecht,0,2,2,0,3,2,-2,7.0,5.0
15164,2009-2010,24,VVV-Venlo,AZ Alkmaar,3,3,3,1,1,6,0,7.0,8.0
15165,2009-2010,24,RKC Waalwijk,sc Heerenveen,1,2,2,0,3,3,-1,0.0,6.0
15166,2009-2010,24,NEC Nijmegen,FC Groningen,0,2,2,0,3,2,-2,12.0,12.0
15167,2009-2010,24,Feyenoord,ADO Den Haag,2,2,3,1,1,4,0,6.0,7.0
15168,2009-2010,24,FC Twente,Willem II,1,0,1,3,0,1,1,12.0,3.0
15169,2009-2010,24,PSV,Sparta Rotterdam,1,1,3,1,1,2,0,11.0,5.0
15170,2009-2010,24,AFC Ajax,Vitesse,4,0,1,3,0,4,4,13.0,2.0
15171,2009-2010,25,ADO Den Haag,Roda JC Kerkrade,1,2,2,0,3,3,-1,4.0,9.0
15172,2009-2010,25,sc Heerenveen,Heracles Almelo,1,2,2,0,3,3,-1,6.0,6.0
15173,2009-2010,25,Vitesse,AZ Alkmaar,0,3,2,0,3,3,-3,1.0,11.0
15174,2009-2010,25,Willem II,VVV-Venlo,2,1,1,3,0,3,1,3.0,7.0
15175,2009-2010,25,AFC Ajax,FC Utrecht,4,0,1,3,0,4,4,15.0,4.0
15176,2009-2010,25,PSV,RKC Waalwijk,5,1,1,3,0,6,4,13.0,0.0
15177,2009-2010,25,FC Groningen,Feyenoord,2,3,2,0,3,5,-1,9.0,8.0
15178,2009-2010,25,FC Twente,NEC Nijmegen,2,1,1,3,0,3,1,12.0,9.0
15179,2009-2010,25,Sparta Rotterdam,NAC Breda,2,2,3,1,1,4,0,6.0,5.0
15180,2009-2010,26,AZ Alkmaar,sc Heerenveen,4,1,1,3,0,5,3,13.0,6.0
15181,2009-2010,26,ADO Den Haag,Vitesse,1,1,3,1,1,2,0,5.0,1.0
15182,2009-2010,26,Heracles Almelo,Willem II,3,2,1,3,0,5,1,9.0,3.0
15183,2009-2010,26,NAC Breda,PSV,2,1,1,3,0,3,1,7.0,10.0
15184,2009-2010,26,Roda JC Kerkrade,Feyenoord,2,4,2,0,3,6,-2,9.0,8.0
15185,2009-2010,26,Sparta Rotterdam,AFC Ajax,0,3,2,0,3,3,-3,5.0,15.0
15186,2009-2010,26,FC Groningen,VVV-Venlo,1,0,1,3,0,1,1,9.0,4.0
15187,2009-2010,26,FC Utrecht,NEC Nijmegen,1,0,1,3,0,1,1,7.0,6.0
15188,2009-2010,26,RKC Waalwijk,FC Twente,0,1,2,0,3,1,-1,0.0,12.0
15189,2009-2010,27,FC Twente,ADO Den Haag,3,1,1,3,0,4,2,15.0,5.0
15190,2009-2010,27,NAC Breda,FC Groningen,0,3,2,0,3,3,-3,4.0,12.0
15191,2009-2010,27,VVV-Venlo,FC Utrecht,0,1,2,0,3,1,-1,1.0,10.0
15192,2009-2010,27,AZ Alkmaar,RKC Waalwijk,6,2,1,3,0,8,4,13.0,0.0
15193,2009-2010,27,NEC Nijmegen,Roda JC Kerkrade,0,2,2,0,3,2,-2,3.0,9.0
15194,2009-2010,27,Feyenoord,Heracles Almelo,1,1,3,1,1,2,0,9.0,7.0
15195,2009-2010,27,Vitesse,sc Heerenveen,0,1,2,0,3,1,-1,1.0,6.0
15196,2009-2010,27,Willem II,Sparta Rotterdam,3,1,1,3,0,4,2,6.0,5.0
15197,2009-2010,27,AFC Ajax,PSV,4,1,1,3,0,5,3,15.0,7.0
15198,2009-2010,28,sc Heerenveen,NEC Nijmegen,4,1,1,3,0,5,3,9.0,0.0
15199,2009-2010,28,Willem II,FC Utrecht,0,3,2,0,3,3,-3,6.0,12.0
15200,2009-2010,28,PSV,FC Twente,1,1,3,1,1,2,0,5.0,13.0
15201,2009-2010,28,Heracles Almelo,NAC Breda,3,0,1,3,0,3,3,10.0,4.0
15202,2009-2010,28,RKC Waalwijk,AFC Ajax,1,5,2,0,3,6,-4,0.0,15.0
15203,2009-2010,28,ADO Den Haag,VVV-Venlo,0,0,3,1,1,0,0,3.0,2.0
15204,2009-2010,28,Sparta Rotterdam,AZ Alkmaar,0,1,2,0,3,1,-1,2.0,13.0
15205,2009-2010,28,FC Groningen,Roda JC Kerkrade,1,0,1,3,0,1,1,12.0,9.0
15206,2009-2010,28,Feyenoord,Vitesse,2,1,1,3,0,3,1,11.0,1.0
15207,2009-2010,29,NAC Breda,ADO Den Haag,3,0,1,3,0,3,3,7.0,2.0
15208,2009-2010,29,Vitesse,Willem II,2,1,1,3,0,3,1,4.0,6.0
15209,2009-2010,29,Roda JC Kerkrade,sc Heerenveen,4,2,1,3,0,6,2,9.0,6.0
15210,2009-2010,29,AZ Alkmaar,Heracles Almelo,3,2,1,3,0,5,1,15.0,10.0
15211,2009-2010,29,FC Twente,Sparta Rotterdam,3,0,1,3,0,3,3,13.0,1.0
15212,2009-2010,29,NEC Nijmegen,Feyenoord,0,0,3,1,1,0,0,1.0,11.0
15213,2009-2010,29,AFC Ajax,FC Groningen,3,0,1,3,0,3,3,15.0,9.0
15214,2009-2010,29,FC Utrecht,RKC Waalwijk,2,0,1,3,0,2,2,12.0,0.0
15215,2009-2010,29,VVV-Venlo,PSV,2,4,2,0,3,6,-2,1.0,7.0
15216,2009-2010,30,VVV-Venlo,FC Twente,0,2,2,0,3,2,-2,1.0,13.0
15217,2009-2010,30,Vitesse,FC Groningen,3,0,1,3,0,3,3,7.0,9.0
15218,2009-2010,30,AZ Alkmaar,FC Utrecht,2,0,1,3,0,2,2,15.0,12.0
15219,2009-2010,30,Roda JC Kerkrade,RKC Waalwijk,5,1,1,3,0,6,4,9.0,0.0
15220,2009-2010,30,sc Heerenveen,Sparta Rotterdam,4,1,1,3,0,5,3,9.0,0.0
15221,2009-2010,30,Feyenoord,NAC Breda,0,0,3,1,1,0,0,9.0,7.0
15222,2009-2010,30,ADO Den Haag,AFC Ajax,0,1,2,0,3,1,-1,2.0,15.0
15223,2009-2010,30,Heracles Almelo,NEC Nijmegen,2,0,1,3,0,2,2,10.0,1.0
15224,2009-2010,30,Willem II,PSV,0,1,2,0,3,1,-1,3.0,7.0
15225,2009-2010,31,RKC Waalwijk,Vitesse,4,1,1,3,0,5,3,3.0,6.0
15226,2009-2010,31,FC Twente,sc Heerenveen,2,0,1,3,0,2,2,13.0,9.0
15227,2009-2010,31,NEC Nijmegen,AZ Alkmaar,0,0,3,1,1,0,0,2.0,13.0
15228,2009-2010,31,NAC Breda,Roda JC Kerkrade,1,0,1,3,0,1,1,7.0,9.0
15229,2009-2010,31,Sparta Rotterdam,Heracles Almelo,1,1,3,1,1,2,0,1.0,8.0
15230,2009-2010,31,PSV,Feyenoord,0,0,3,1,1,0,0,8.0,7.0
15231,2009-2010,31,FC Utrecht,ADO Den Haag,0,2,2,0,3,2,-2,9.0,4.0
15232,2009-2010,31,AFC Ajax,VVV-Venlo,7,0,1,3,0,7,7,15.0,1.0
15233,2009-2010,31,FC Groningen,Willem II,4,0,1,3,0,4,4,9.0,3.0
15234,2009-2010,32,Heracles Almelo,RKC Waalwijk,4,1,1,3,0,5,3,10.0,3.0
15235,2009-2010,32,Vitesse,NAC Breda,1,1,3,1,1,2,0,7.0,8.0
15236,2009-2010,32,AZ Alkmaar,FC Twente,1,0,1,3,0,1,1,13.0,10.0
15237,2009-2010,32,Willem II,AFC Ajax,0,2,2,0,3,2,-2,0.0,15.0
15238,2009-2010,32,Roda JC Kerkrade,VVV-Venlo,4,2,1,3,0,6,2,9.0,1.0
15239,2009-2010,32,Feyenoord,Sparta Rotterdam,3,0,1,3,0,3,3,9.0,1.0
15240,2009-2010,32,sc Heerenveen,PSV,2,2,3,1,1,4,0,7.0,9.0
15241,2009-2010,32,ADO Den Haag,NEC Nijmegen,2,3,2,0,3,5,-1,4.0,5.0
15242,2009-2010,32,FC Utrecht,FC Groningen,1,1,3,1,1,2,0,7.0,7.0
15243,2009-2010,33,sc Heerenveen,NAC Breda,0,0,3,1,1,0,0,5.0,9.0
15244,2009-2010,33,FC Twente,Feyenoord,2,0,1,3,0,2,2,12.0,6.0
15245,2009-2010,33,PSV,FC Groningen,3,1,1,3,0,4,2,11.0,4.0
15246,2009-2010,33,Willem II,AZ Alkmaar,0,3,2,0,3,3,-3,0.0,13.0
15247,2009-2010,33,ADO Den Haag,RKC Waalwijk,4,0,1,3,0,4,4,6.0,3.0
15248,2009-2010,33,Vitesse,Roda JC Kerkrade,2,5,2,0,3,7,-3,7.0,12.0
15249,2009-2010,33,VVV-Venlo,NEC Nijmegen,2,0,1,3,0,2,2,3.0,5.0
15250,2009-2010,33,Sparta Rotterdam,FC Utrecht,0,3,2,0,3,3,-3,1.0,7.0
15251,2009-2010,33,AFC Ajax,Heracles Almelo,4,0,1,3,0,4,4,15.0,7.0
15252,2009-2010,34,AZ Alkmaar,PSV,1,1,3,1,1,2,0,11.0,9.0
15253,2009-2010,34,Feyenoord,sc Heerenveen,6,2,1,3,0,8,4,8.0,5.0
15254,2009-2010,34,RKC Waalwijk,VVV-Venlo,1,2,2,0,3,3,-1,3.0,6.0
15255,2009-2010,34,Heracles Almelo,ADO Den Haag,4,2,1,3,0,6,2,10.0,6.0
15256,2009-2010,34,FC Utrecht,Vitesse,2,2,3,1,1,4,0,5.0,5.0
15257,2009-2010,34,FC Groningen,Sparta Rotterdam,3,1,1,3,0,4,2,7.0,1.0
15258,2009-2010,34,NEC Nijmegen,AFC Ajax,1,4,2,0,3,5,-3,4.0,15.0
15259,2009-2010,34,Roda JC Kerkrade,Willem II,3,2,1,3,0,5,1,12.0,0.0
15260,2009-2010,34,NAC Breda,FC Twente,0,2,2,0,3,2,-2,6.0,12.0
15261,2010-2011,1,Roda JC Kerkrade,FC Twente,0,0,3,1,1,0,0,10.0,10.0
15262,2010-2011,1,NEC Nijmegen,VVV-Venlo,1,0,1,3,0,1,1,7.0,6.0
15263,2010-2011,1,Heracles Almelo,Willem II,3,0,1,3,0,3,3,10.0,0.0
15264,2010-2011,1,De Graafschap,SBV Excelsior,3,0,1,3,0,3,3,8.0,4.0
15265,2010-2011,1,sc Heerenveen,PSV,1,3,2,0,3,4,-2,2.0,9.0
15266,2010-2011,1,Vitesse,ADO Den Haag,3,1,1,3,0,4,2,5.0,6.0
15267,2010-2011,1,Feyenoord,FC Utrecht,3,1,1,3,0,4,2,10.0,5.0
15268,2010-2011,1,FC Groningen,AFC Ajax,2,2,3,1,1,4,0,8.0,13.0
15269,2010-2011,1,NAC Breda,AZ Alkmaar,1,1,3,1,1,2,0,6.0,9.0
15270,2010-2011,2,AFC Ajax,Vitesse,4,2,1,3,0,6,2,13.0,5.0
15271,2010-2011,2,PSV,De Graafschap,6,0,1,3,0,6,6,11.0,8.0
15272,2010-2011,2,VVV-Venlo,Heracles Almelo,1,0,1,3,0,1,1,9.0,9.0
15273,2010-2011,2,AZ Alkmaar,FC Groningen,1,1,3,1,1,2,0,9.0,6.0
15274,2010-2011,2,FC Twente,sc Heerenveen,0,0,3,1,1,0,0,8.0,3.0
15275,2010-2011,2,SBV Excelsior,Feyenoord,3,2,1,3,0,5,1,4.0,9.0
15276,2010-2011,2,FC Utrecht,NAC Breda,3,1,1,3,0,4,2,8.0,3.0
15277,2010-2011,2,Willem II,NEC Nijmegen,3,5,2,0,3,8,-2,0.0,9.0
15278,2010-2011,2,ADO Den Haag,Roda JC Kerkrade,1,3,2,0,3,4,-2,3.0,13.0
15279,2010-2011,3,SBV Excelsior,NEC Nijmegen,4,2,1,3,0,6,2,7.0,6.0
15280,2010-2011,3,Vitesse,FC Twente,0,3,2,0,3,3,-3,4.0,11.0
15281,2010-2011,3,FC Groningen,De Graafschap,2,1,1,3,0,3,1,8.0,7.0
15282,2010-2011,3,sc Heerenveen,NAC Breda,3,1,1,3,0,4,2,5.0,2.0
15283,2010-2011,3,AFC Ajax,Roda JC Kerkrade,3,0,1,3,0,3,3,13.0,10.0
15284,2010-2011,3,FC Utrecht,Willem II,3,0,1,3,0,3,3,10.0,0.0
15285,2010-2011,3,Heracles Almelo,Feyenoord,1,1,3,1,1,2,0,7.0,7.0
15286,2010-2011,3,VVV-Venlo,ADO Den Haag,2,3,2,0,3,5,-1,9.0,6.0
15287,2010-2011,3,PSV,AZ Alkmaar,3,1,1,3,0,4,2,13.0,6.0
15288,2010-2011,4,Willem II,FC Groningen,0,3,2,0,3,3,-3,0.0,11.0
15289,2010-2011,4,NAC Breda,VVV-Venlo,2,0,1,3,0,2,2,4.0,6.0
15290,2010-2011,4,Roda JC Kerkrade,Heracles Almelo,4,2,1,3,0,6,2,10.0,7.0
15291,2010-2011,4,NEC Nijmegen,sc Heerenveen,2,2,3,1,1,4,0,7.0,5.0
15292,2010-2011,4,De Graafschap,AFC Ajax,0,5,2,0,3,5,-5,4.0,13.0
15293,2010-2011,4,FC Twente,FC Utrecht,4,0,1,3,0,4,4,11.0,7.0
15294,2010-2011,4,Feyenoord,Vitesse,4,0,1,3,0,4,4,10.0,4.0
15295,2010-2011,4,ADO Den Haag,PSV,2,2,3,1,1,4,0,4.0,11.0
15296,2010-2011,4,AZ Alkmaar,SBV Excelsior,1,1,3,1,1,2,0,4.0,7.0
15297,2010-2011,5,VVV-Venlo,FC Twente,1,2,2,0,3,3,-1,3.0,11.0
15298,2010-2011,5,AFC Ajax,Willem II,2,0,1,3,0,2,2,13.0,0.0
15299,2010-2011,5,PSV,NEC Nijmegen,3,1,1,3,0,4,2,13.0,7.0
15300,2010-2011,5,sc Heerenveen,Vitesse,2,1,1,3,0,3,1,8.0,3.0
15301,2010-2011,5,SBV Excelsior,Heracles Almelo,2,1,1,3,0,3,1,10.0,4.0
15302,2010-2011,5,AZ Alkmaar,Roda JC Kerkrade,1,2,2,0,3,3,-1,3.0,10.0
15303,2010-2011,5,NAC Breda,Feyenoord,2,0,1,3,0,2,2,7.0,7.0
15304,2010-2011,5,ADO Den Haag,De Graafschap,2,2,3,1,1,4,0,5.0,4.0
15305,2010-2011,5,FC Groningen,FC Utrecht,1,0,1,3,0,1,1,11.0,6.0
15306,2010-2011,6,De Graafschap,sc Heerenveen,3,2,1,3,0,5,1,4.0,8.0
15307,2010-2011,6,FC Groningen,SBV Excelsior,2,0,1,3,0,2,2,13.0,10.0
15308,2010-2011,6,Vitesse,NAC Breda,0,0,3,1,1,0,0,1.0,7.0
15309,2010-2011,6,Willem II,ADO Den Haag,2,4,2,0,3,6,-2,0.0,8.0
15310,2010-2011,6,Feyenoord,AFC Ajax,1,2,2,0,3,3,-1,4.0,15.0
15311,2010-2011,6,NEC Nijmegen,AZ Alkmaar,0,1,2,0,3,1,-1,4.0,5.0
15312,2010-2011,6,Roda JC Kerkrade,PSV,0,0,3,1,1,0,0,10.0,11.0
15313,2010-2011,6,FC Utrecht,VVV-Venlo,3,2,1,3,0,5,1,9.0,3.0
15314,2010-2011,6,Heracles Almelo,FC Twente,0,0,3,1,1,0,0,2.0,11.0
15315,2010-2011,7,sc Heerenveen,Roda JC Kerkrade,2,2,3,1,1,4,0,8.0,8.0
15316,2010-2011,7,PSV,FC Groningen,1,1,3,1,1,2,0,9.0,13.0
15317,2010-2011,7,AZ Alkmaar,FC Utrecht,1,0,1,3,0,1,1,7.0,6.0
15318,2010-2011,7,ADO Den Haag,Heracles Almelo,3,2,1,3,0,5,1,11.0,2.0
15319,2010-2011,7,FC Twente,AFC Ajax,2,2,3,1,1,4,0,11.0,13.0
15320,2010-2011,7,SBV Excelsior,Vitesse,0,2,2,0,3,2,-2,7.0,4.0
15321,2010-2011,7,NAC Breda,Willem II,2,1,1,3,0,3,1,10.0,0.0
15322,2010-2011,7,NEC Nijmegen,Feyenoord,3,0,1,3,0,3,3,4.0,4.0
15323,2010-2011,7,VVV-Venlo,De Graafschap,1,0,1,3,0,1,1,3.0,4.0
15324,2010-2011,8,Vitesse,Willem II,0,0,3,1,1,0,0,5.0,1.0
15325,2010-2011,8,NAC Breda,NEC Nijmegen,2,0,1,3,0,2,2,13.0,4.0
15326,2010-2011,8,SBV Excelsior,Roda JC Kerkrade,1,2,2,0,3,3,-1,4.0,11.0
15327,2010-2011,8,AFC Ajax,FC Utrecht,1,2,2,0,3,3,-1,10.0,6.0
15328,2010-2011,8,FC Twente,FC Groningen,4,2,1,3,0,6,2,11.0,10.0
15329,2010-2011,8,AZ Alkmaar,Heracles Almelo,2,1,1,3,0,3,1,10.0,1.0
15330,2010-2011,8,De Graafschap,Feyenoord,1,1,3,1,1,2,0,5.0,4.0
15331,2010-2011,8,sc Heerenveen,ADO Den Haag,0,0,3,1,1,0,0,6.0,9.0
15332,2010-2011,8,PSV,VVV-Venlo,3,0,1,3,0,3,3,9.0,3.0
15333,2010-2011,9,AFC Ajax,NAC Breda,3,0,1,3,0,3,3,10.0,10.0
15334,2010-2011,9,FC Utrecht,De Graafschap,2,2,3,1,1,4,0,7.0,6.0
15335,2010-2011,9,ADO Den Haag,SBV Excelsior,2,1,1,3,0,3,1,11.0,3.0
15336,2010-2011,9,VVV-Venlo,AZ Alkmaar,0,1,2,0,3,1,-1,3.0,12.0
15337,2010-2011,9,Feyenoord,FC Twente,0,1,2,0,3,1,-1,1.0,11.0
15338,2010-2011,9,Willem II,PSV,2,4,2,0,3,6,-2,1.0,11.0
15339,2010-2011,9,FC Groningen,sc Heerenveen,1,0,1,3,0,1,1,10.0,5.0
15340,2010-2011,9,Roda JC Kerkrade,Vitesse,4,1,1,3,0,5,3,11.0,5.0
15341,2010-2011,9,Heracles Almelo,NEC Nijmegen,3,2,1,3,0,5,1,4.0,3.0
15342,2010-2011,10,NAC Breda,Roda JC Kerkrade,1,2,2,0,3,3,-1,7.0,11.0
15343,2010-2011,10,De Graafschap,Heracles Almelo,1,1,3,1,1,2,0,6.0,5.0
15344,2010-2011,10,NEC Nijmegen,FC Groningen,3,2,1,3,0,5,1,6.0,7.0
15345,2010-2011,10,sc Heerenveen,VVV-Venlo,2,0,1,3,0,2,2,5.0,3.0
15346,2010-2011,10,SBV Excelsior,AFC Ajax,2,2,3,1,1,4,0,1.0,8.0
15347,2010-2011,10,PSV,Feyenoord,10,0,1,3,0,10,10,11.0,1.0
15348,2010-2011,10,FC Twente,ADO Den Haag,3,2,1,3,0,5,1,11.0,10.0
15349,2010-2011,10,AZ Alkmaar,Willem II,3,0,1,3,0,3,3,15.0,1.0
15350,2010-2011,10,Vitesse,FC Utrecht,1,4,2,0,3,5,-3,5.0,10.0
15351,2010-2011,11,Roda JC Kerkrade,NEC Nijmegen,1,1,3,1,1,2,0,11.0,7.0
15352,2010-2011,11,Heracles Almelo,NAC Breda,4,1,1,3,0,5,3,7.0,6.0
15353,2010-2011,11,FC Groningen,ADO Den Haag,3,1,1,3,0,4,2,7.0,7.0
15354,2010-2011,11,AFC Ajax,sc Heerenveen,3,1,1,3,0,4,2,8.0,5.0
15355,2010-2011,11,De Graafschap,AZ Alkmaar,2,1,1,3,0,3,1,6.0,12.0
15356,2010-2011,11,Willem II,FC Twente,1,3,2,0,3,4,-2,1.0,13.0
15357,2010-2011,11,Feyenoord,VVV-Venlo,3,0,1,3,0,3,3,4.0,3.0
15358,2010-2011,11,Vitesse,PSV,0,2,2,0,3,2,-2,4.0,13.0
15359,2010-2011,11,FC Utrecht,SBV Excelsior,2,0,1,3,0,2,2,10.0,1.0
15360,2010-2011,12,VVV-Venlo,FC Groningen,3,5,2,0,3,8,-2,0.0,9.0
15361,2010-2011,12,NAC Breda,De Graafschap,2,0,1,3,0,2,2,6.0,6.0
15362,2010-2011,12,SBV Excelsior,sc Heerenveen,0,2,2,0,3,2,-2,1.0,7.0
15363,2010-2011,12,Heracles Almelo,AFC Ajax,1,4,2,0,3,5,-3,7.0,10.0
15364,2010-2011,12,PSV,FC Twente,0,1,2,0,3,1,-1,12.0,15.0
15365,2010-2011,12,ADO Den Haag,FC Utrecht,1,0,1,3,0,1,1,7.0,10.0
15366,2010-2011,12,NEC Nijmegen,Vitesse,0,0,3,1,1,0,0,5.0,2.0
15367,2010-2011,12,Roda JC Kerkrade,Willem II,2,2,3,1,1,4,0,11.0,2.0
15368,2010-2011,12,AZ Alkmaar,Feyenoord,2,1,1,3,0,3,1,12.0,4.0
15369,2010-2011,13,Willem II,VVV-Venlo,1,4,2,0,3,5,-3,1.0,3.0
15370,2010-2011,13,FC Twente,SBV Excelsior,2,1,1,3,0,3,1,15.0,1.0
15371,2010-2011,13,FC Groningen,NAC Breda,2,1,1,3,0,3,1,12.0,3.0
15372,2010-2011,13,sc Heerenveen,Heracles Almelo,3,2,1,3,0,5,1,9.0,7.0
15373,2010-2011,13,De Graafschap,NEC Nijmegen,1,4,2,0,3,5,-3,5.0,8.0
15374,2010-2011,13,AFC Ajax,ADO Den Haag,0,1,2,0,3,1,-1,10.0,9.0
15375,2010-2011,13,FC Utrecht,PSV,1,2,2,0,3,3,-1,7.0,12.0
15376,2010-2011,13,Vitesse,AZ Alkmaar,1,1,3,1,1,2,0,2.0,10.0
15377,2010-2011,13,Feyenoord,Roda JC Kerkrade,1,1,3,1,1,2,0,4.0,9.0
15378,2010-2011,14,PSV,SBV Excelsior,4,2,1,3,0,6,2,12.0,1.0
15379,2010-2011,14,NAC Breda,FC Twente,2,1,1,3,0,3,1,6.0,12.0
15380,2010-2011,14,NEC Nijmegen,ADO Den Haag,1,1,3,1,1,2,0,9.0,7.0
15381,2010-2011,14,VVV-Venlo,Vitesse,1,5,2,0,3,6,-4,3.0,5.0
15382,2010-2011,14,AZ Alkmaar,AFC Ajax,2,0,1,3,0,2,2,10.0,7.0
15383,2010-2011,14,Heracles Almelo,FC Groningen,3,0,1,3,0,3,3,7.0,9.0
15384,2010-2011,14,Feyenoord,sc Heerenveen,2,2,3,1,1,4,0,5.0,10.0
15385,2010-2011,14,Willem II,De Graafschap,0,1,2,0,3,1,-1,1.0,7.0
15386,2010-2011,14,Roda JC Kerkrade,FC Utrecht,1,1,3,1,1,2,0,7.0,7.0
15387,2010-2011,15,SBV Excelsior,VVV-Venlo,1,0,1,3,0,1,1,3.0,3.0
15388,2010-2011,15,Vitesse,Heracles Almelo,2,0,1,3,0,2,2,8.0,6.0
15389,2010-2011,15,De Graafschap,Roda JC Kerkrade,3,1,1,3,0,4,2,9.0,4.0
15390,2010-2011,15,FC Twente,AZ Alkmaar,1,2,2,0,3,3,-1,9.0,10.0
15391,2010-2011,15,AFC Ajax,PSV,0,0,3,1,1,0,0,7.0,10.0
15392,2010-2011,15,FC Groningen,Feyenoord,2,0,1,3,0,2,2,12.0,5.0
15393,2010-2011,15,ADO Den Haag,NAC Breda,3,0,1,3,0,3,3,10.0,6.0
15394,2010-2011,15,sc Heerenveen,Willem II,5,0,1,3,0,5,5,10.0,1.0
15395,2010-2011,15,FC Utrecht,NEC Nijmegen,4,0,1,3,0,4,4,7.0,6.0
15396,2010-2011,16,NAC Breda,PSV,4,2,1,3,0,6,2,9.0,7.0
15397,2010-2011,16,AZ Alkmaar,sc Heerenveen,2,2,3,1,1,4,0,11.0,11.0
15398,2010-2011,16,Willem II,SBV Excelsior,1,1,3,1,1,2,0,2.0,4.0
15399,2010-2011,16,Roda JC Kerkrade,FC Groningen,1,0,1,3,0,1,1,6.0,9.0
15400,2010-2011,16,NEC Nijmegen,FC Twente,2,4,2,0,3,6,-2,5.0,9.0
15401,2010-2011,16,Feyenoord,ADO Den Haag,2,1,1,3,0,3,1,5.0,10.0
15402,2010-2011,16,De Graafschap,Vitesse,1,1,3,1,1,2,0,7.0,9.0
15403,2010-2011,16,VVV-Venlo,AFC Ajax,0,2,2,0,3,2,-2,3.0,7.0
15404,2010-2011,16,Heracles Almelo,FC Utrecht,2,1,1,3,0,3,1,6.0,4.0
15405,2010-2011,17,FC Groningen,Vitesse,4,1,1,3,0,5,3,9.0,8.0
15406,2010-2011,17,AFC Ajax,NEC Nijmegen,1,1,3,1,1,2,0,5.0,5.0
15407,2010-2011,17,PSV,Heracles Almelo,5,2,1,3,0,7,3,10.0,6.0
15408,2010-2011,17,FC Twente,De Graafschap,2,0,1,3,0,2,2,9.0,7.0
15409,2010-2011,17,Willem II,Feyenoord,1,1,3,1,1,2,0,2.0,6.0
15410,2010-2011,17,FC Utrecht,sc Heerenveen,2,1,1,3,0,3,1,7.0,8.0
15411,2010-2011,17,ADO Den Haag,AZ Alkmaar,0,2,2,0,3,2,-2,7.0,11.0
15412,2010-2011,17,VVV-Venlo,Roda JC Kerkrade,0,4,2,0,3,4,-4,3.0,8.0
15413,2010-2011,17,SBV Excelsior,NAC Breda,1,3,2,0,3,4,-2,4.0,9.0
15414,2010-2011,18,Heracles Almelo,VVV-Venlo,2,2,3,1,1,4,0,7.0,1.0
15415,2010-2011,18,NAC Breda,FC Utrecht,3,1,1,3,0,4,2,12.0,7.0
15416,2010-2011,18,NEC Nijmegen,Willem II,3,1,1,3,0,4,2,5.0,2.0
15417,2010-2011,18,Roda JC Kerkrade,ADO Den Haag,1,1,3,1,1,2,0,8.0,5.0
15418,2010-2011,18,De Graafschap,PSV,0,0,3,1,1,0,0,8.0,8.0
15419,2010-2011,18,Vitesse,AFC Ajax,0,1,2,0,3,1,-1,7.0,8.0
15420,2010-2011,18,FC Groningen,AZ Alkmaar,2,0,1,3,0,2,2,9.0,10.0
15421,2010-2011,18,sc Heerenveen,FC Twente,6,2,1,3,0,8,4,8.0,6.0
15422,2010-2011,18,Feyenoord,SBV Excelsior,1,0,1,3,0,1,1,8.0,4.0
15423,2010-2011,19,sc Heerenveen,De Graafschap,4,0,1,3,0,4,4,10.0,5.0
15424,2010-2011,19,SBV Excelsior,FC Groningen,2,2,3,1,1,4,0,5.0,10.0
15425,2010-2011,19,NAC Breda,Vitesse,1,1,3,1,1,2,0,10.0,5.0
15426,2010-2011,19,ADO Den Haag,Willem II,2,1,1,3,0,3,1,7.0,2.0
15427,2010-2011,19,PSV,Roda JC Kerkrade,3,1,1,3,0,4,2,8.0,7.0
15428,2010-2011,19,FC Twente,Heracles Almelo,5,0,1,3,0,5,5,9.0,4.0
15429,2010-2011,19,VVV-Venlo,FC Utrecht,1,2,2,0,3,3,-1,1.0,9.0
15430,2010-2011,19,AFC Ajax,Feyenoord,2,0,1,3,0,2,2,11.0,7.0
15431,2010-2011,19,AZ Alkmaar,NEC Nijmegen,2,2,3,1,1,4,0,8.0,5.0
15432,2010-2011,20,ADO Den Haag,sc Heerenveen,3,1,1,3,0,4,2,7.0,7.0
15433,2010-2011,20,Heracles Almelo,AZ Alkmaar,0,0,3,1,1,0,0,5.0,6.0
15434,2010-2011,20,NEC Nijmegen,NAC Breda,2,2,3,1,1,4,0,6.0,11.0
15435,2010-2011,20,Willem II,Vitesse,1,0,1,3,0,1,1,5.0,2.0
15436,2010-2011,20,Feyenoord,De Graafschap,0,1,2,0,3,1,-1,7.0,5.0
15437,2010-2011,20,FC Utrecht,AFC Ajax,3,0,1,3,0,3,3,9.0,10.0
15438,2010-2011,20,Roda JC Kerkrade,SBV Excelsior,3,0,1,3,0,3,3,10.0,2.0
15439,2010-2011,20,FC Groningen,FC Twente,1,2,2,0,3,3,-1,7.0,12.0
15440,2010-2011,20,VVV-Venlo,PSV,0,3,2,0,3,3,-3,1.0,10.0
15441,2010-2011,21,NEC Nijmegen,Heracles Almelo,1,1,3,1,1,2,0,7.0,3.0
15442,2010-2011,21,Vitesse,Roda JC Kerkrade,5,2,1,3,0,7,3,4.0,7.0
15443,2010-2011,21,AZ Alkmaar,VVV-Venlo,6,1,1,3,0,7,5,8.0,1.0
15444,2010-2011,21,PSV,Willem II,2,1,1,3,0,3,1,13.0,4.0
15445,2010-2011,21,SBV Excelsior,ADO Den Haag,1,5,2,0,3,6,-4,1.0,10.0
15446,2010-2011,21,NAC Breda,AFC Ajax,0,3,2,0,3,3,-3,8.0,10.0
15447,2010-2011,21,sc Heerenveen,FC Groningen,1,4,2,0,3,5,-3,6.0,10.0
15448,2010-2011,21,FC Twente,Feyenoord,2,1,1,3,0,3,1,12.0,4.0
15449,2010-2011,21,De Graafschap,FC Utrecht,0,0,3,1,1,0,0,5.0,10.0
15450,2010-2011,22,AFC Ajax,De Graafschap,2,0,1,3,0,2,2,12.0,5.0
15451,2010-2011,22,sc Heerenveen,NEC Nijmegen,0,0,3,1,1,0,0,7.0,7.0
15452,2010-2011,22,PSV,ADO Den Haag,0,1,2,0,3,1,-1,10.0,13.0
15453,2010-2011,22,SBV Excelsior,AZ Alkmaar,2,1,1,3,0,3,1,4.0,5.0
15454,2010-2011,22,VVV-Venlo,NAC Breda,3,0,1,3,0,3,3,4.0,5.0
15455,2010-2011,22,Vitesse,Feyenoord,1,1,3,1,1,2,0,5.0,4.0
15456,2010-2011,22,FC Groningen,Willem II,7,1,1,3,0,8,6,10.0,3.0
15457,2010-2011,22,FC Utrecht,FC Twente,1,1,3,1,1,2,0,8.0,10.0
15458,2010-2011,22,Heracles Almelo,Roda JC Kerkrade,1,0,1,3,0,1,1,6.0,4.0
15459,2010-2011,23,ADO Den Haag,VVV-Venlo,3,0,1,3,0,3,3,15.0,3.0
15460,2010-2011,23,Willem II,FC Utrecht,3,3,3,1,1,6,0,4.0,9.0
15461,2010-2011,23,Feyenoord,Heracles Almelo,2,1,1,3,0,3,1,4.0,5.0
15462,2010-2011,23,FC Twente,Vitesse,1,0,1,3,0,1,1,13.0,5.0
15463,2010-2011,23,AZ Alkmaar,PSV,0,4,2,0,3,4,-4,5.0,12.0
15464,2010-2011,23,NAC Breda,sc Heerenveen,0,2,2,0,3,2,-2,2.0,7.0
15465,2010-2011,23,Roda JC Kerkrade,AFC Ajax,2,2,3,1,1,4,0,4.0,10.0
15466,2010-2011,23,NEC Nijmegen,SBV Excelsior,2,0,1,3,0,2,2,7.0,4.0
15467,2010-2011,23,De Graafschap,FC Groningen,1,1,3,1,1,2,0,5.0,8.0
15468,2010-2011,24,FC Utrecht,Heracles Almelo,1,1,3,1,1,2,0,7.0,6.0
15469,2010-2011,24,SBV Excelsior,Willem II,4,0,1,3,0,4,4,6.0,4.0
15470,2010-2011,24,sc Heerenveen,AZ Alkmaar,0,2,2,0,3,2,-2,4.0,7.0
15471,2010-2011,24,FC Groningen,Roda JC Kerkrade,1,4,2,0,3,5,-3,7.0,7.0
15472,2010-2011,24,ADO Den Haag,Feyenoord,2,2,3,1,1,4,0,13.0,5.0
15473,2010-2011,24,FC Twente,NEC Nijmegen,1,1,3,1,1,2,0,11.0,7.0
15474,2010-2011,24,AFC Ajax,VVV-Venlo,1,0,1,3,0,1,1,10.0,3.0
15475,2010-2011,24,Vitesse,De Graafschap,2,0,1,3,0,2,2,7.0,5.0
15476,2010-2011,24,PSV,NAC Breda,4,1,1,3,0,5,3,12.0,1.0
15477,2010-2011,25,VVV-Venlo,SBV Excelsior,1,0,1,3,0,1,1,6.0,6.0
15478,2010-2011,25,Willem II,sc Heerenveen,4,3,1,3,0,7,1,4.0,4.0
15479,2010-2011,25,Heracles Almelo,Vitesse,6,1,1,3,0,7,5,8.0,7.0
15480,2010-2011,25,Roda JC Kerkrade,De Graafschap,1,1,3,1,1,2,0,5.0,3.0
15481,2010-2011,25,NAC Breda,ADO Den Haag,3,2,1,3,0,5,1,3.0,10.0
15482,2010-2011,25,Feyenoord,FC Groningen,5,1,1,3,0,6,4,8.0,7.0
15483,2010-2011,25,AZ Alkmaar,FC Twente,2,1,1,3,0,3,1,9.0,8.0
15484,2010-2011,25,PSV,AFC Ajax,0,0,3,1,1,0,0,10.0,11.0
15485,2010-2011,25,NEC Nijmegen,FC Utrecht,1,1,3,1,1,2,0,7.0,5.0
15486,2010-2011,26,De Graafschap,Willem II,2,1,1,3,0,3,1,5.0,4.0
15487,2010-2011,26,FC Twente,NAC Breda,2,0,1,3,0,2,2,8.0,3.0
15488,2010-2011,26,Vitesse,VVV-Venlo,2,0,1,3,0,2,2,7.0,6.0
15489,2010-2011,26,ADO Den Haag,NEC Nijmegen,5,1,1,3,0,6,4,10.0,6.0
15490,2010-2011,26,SBV Excelsior,PSV,2,3,2,0,3,5,-1,6.0,10.0
15491,2010-2011,26,sc Heerenveen,Feyenoord,0,1,2,0,3,1,-1,4.0,11.0
15492,2010-2011,26,FC Utrecht,Roda JC Kerkrade,1,1,3,1,1,2,0,5.0,6.0
15493,2010-2011,26,FC Groningen,Heracles Almelo,1,4,2,0,3,5,-3,4.0,10.0
15494,2010-2011,26,AFC Ajax,AZ Alkmaar,4,0,1,3,0,4,4,11.0,6.0
15495,2010-2011,27,FC Utrecht,FC Groningen,1,0,1,3,0,1,1,7.0,1.0
15496,2010-2011,27,Heracles Almelo,SBV Excelsior,4,1,1,3,0,5,3,10.0,3.0
15497,2010-2011,27,Roda JC Kerkrade,AZ Alkmaar,1,2,2,0,3,3,-1,6.0,9.0
15498,2010-2011,27,Vitesse,sc Heerenveen,1,1,3,1,1,2,0,7.0,4.0
15499,2010-2011,27,De Graafschap,ADO Den Haag,1,0,1,3,0,1,1,8.0,7.0
15500,2010-2011,27,FC Twente,VVV-Venlo,2,1,1,3,0,3,1,10.0,3.0
15501,2010-2011,27,Feyenoord,NAC Breda,2,1,1,3,0,3,1,13.0,3.0
15502,2010-2011,27,Willem II,AFC Ajax,1,3,2,0,3,4,-2,4.0,11.0
15503,2010-2011,27,NEC Nijmegen,PSV,2,2,3,1,1,4,0,6.0,11.0
15504,2010-2011,28,AZ Alkmaar,Vitesse,3,1,1,3,0,4,2,12.0,7.0
15505,2010-2011,28,NAC Breda,FC Groningen,0,1,2,0,3,1,-1,3.0,3.0
15506,2010-2011,28,VVV-Venlo,Willem II,0,0,3,1,1,0,0,4.0,4.0
15507,2010-2011,28,Heracles Almelo,sc Heerenveen,4,2,1,3,0,6,2,13.0,1.0
15508,2010-2011,28,NEC Nijmegen,De Graafschap,1,0,1,3,0,1,1,6.0,7.0
15509,2010-2011,28,ADO Den Haag,AFC Ajax,3,2,1,3,0,5,1,7.0,10.0
15510,2010-2011,28,PSV,FC Utrecht,1,0,1,3,0,1,1,11.0,6.0
15511,2010-2011,28,Roda JC Kerkrade,Feyenoord,3,0,1,3,0,3,3,8.0,10.0
15512,2010-2011,28,SBV Excelsior,FC Twente,0,2,2,0,3,2,-2,3.0,10.0
15513,2010-2011,29,FC Twente,PSV,2,0,1,3,0,2,2,12.0,8.0
15514,2010-2011,29,De Graafschap,NAC Breda,1,3,2,0,3,4,-2,7.0,6.0
15515,2010-2011,29,sc Heerenveen,SBV Excelsior,2,3,2,0,3,5,-1,1.0,3.0
15516,2010-2011,29,Willem II,Roda JC Kerkrade,4,5,2,0,3,9,-1,4.0,8.0
15517,2010-2011,29,Feyenoord,AZ Alkmaar,0,1,2,0,3,1,-1,9.0,12.0
15518,2010-2011,29,Vitesse,NEC Nijmegen,2,1,1,3,0,3,1,7.0,5.0
15519,2010-2011,29,FC Utrecht,ADO Den Haag,2,3,2,0,3,5,-1,5.0,9.0
15520,2010-2011,29,AFC Ajax,Heracles Almelo,3,0,1,3,0,3,3,10.0,12.0
15521,2010-2011,29,FC Groningen,VVV-Venlo,3,2,1,3,0,5,1,6.0,4.0
15522,2010-2011,30,AZ Alkmaar,NAC Breda,1,1,3,1,1,2,0,10.0,4.0
15523,2010-2011,30,VVV-Venlo,NEC Nijmegen,1,4,2,0,3,5,-3,1.0,7.0
15524,2010-2011,30,ADO Den Haag,Vitesse,1,0,1,3,0,1,1,12.0,7.0
15525,2010-2011,30,SBV Excelsior,De Graafschap,0,0,3,1,1,0,0,4.0,7.0
15526,2010-2011,30,Willem II,Heracles Almelo,2,6,2,0,3,8,-4,1.0,12.0
15527,2010-2011,30,FC Twente,Roda JC Kerkrade,1,1,3,1,1,2,0,13.0,8.0
15528,2010-2011,30,AFC Ajax,FC Groningen,2,0,1,3,0,2,2,12.0,6.0
15529,2010-2011,30,FC Utrecht,Feyenoord,0,4,2,0,3,4,-4,4.0,9.0
15530,2010-2011,30,PSV,sc Heerenveen,2,2,3,1,1,4,0,8.0,2.0
15531,2010-2011,31,sc Heerenveen,FC Utrecht,3,0,1,3,0,3,3,5.0,3.0
15532,2010-2011,31,Vitesse,FC Groningen,2,1,1,3,0,3,1,7.0,6.0
15533,2010-2011,31,Roda JC Kerkrade,VVV-Venlo,5,2,1,3,0,7,3,10.0,1.0
15534,2010-2011,31,NAC Breda,SBV Excelsior,1,2,2,0,3,3,-1,4.0,7.0
15535,2010-2011,31,AZ Alkmaar,ADO Den Haag,3,1,1,3,0,4,2,13.0,9.0
15536,2010-2011,31,Heracles Almelo,PSV,0,2,2,0,3,2,-2,9.0,8.0
15537,2010-2011,31,De Graafschap,FC Twente,1,1,3,1,1,2,0,5.0,11.0
15538,2010-2011,31,NEC Nijmegen,AFC Ajax,1,2,2,0,3,3,-1,7.0,12.0
15539,2010-2011,31,Feyenoord,Willem II,6,1,1,3,0,7,5,9.0,1.0
15540,2010-2011,32,ADO Den Haag,FC Twente,1,2,2,0,3,3,-1,9.0,11.0
15541,2010-2011,32,Willem II,AZ Alkmaar,2,1,1,3,0,3,1,4.0,10.0
15542,2010-2011,32,Heracles Almelo,De Graafschap,2,0,1,3,0,2,2,9.0,2.0
15543,2010-2011,32,Roda JC Kerkrade,NAC Breda,5,1,1,3,0,6,4,13.0,4.0
15544,2010-2011,32,VVV-Venlo,sc Heerenveen,2,2,3,1,1,4,0,2.0,5.0
15545,2010-2011,32,AFC Ajax,SBV Excelsior,4,1,1,3,0,5,3,12.0,7.0
15546,2010-2011,32,FC Utrecht,Vitesse,4,2,1,3,0,6,2,3.0,6.0
15547,2010-2011,32,Feyenoord,PSV,3,1,1,3,0,4,2,9.0,7.0
15548,2010-2011,32,FC Groningen,NEC Nijmegen,3,1,1,3,0,4,2,9.0,6.0
15549,2010-2011,33,SBV Excelsior,FC Utrecht,3,1,1,3,0,4,2,10.0,3.0
15550,2010-2011,33,FC Twente,Willem II,4,0,1,3,0,4,4,11.0,3.0
15551,2010-2011,33,sc Heerenveen,AFC Ajax,1,2,2,0,3,3,-1,5.0,15.0
15552,2010-2011,33,VVV-Venlo,Feyenoord,3,2,1,3,0,5,1,4.0,9.0
15553,2010-2011,33,NAC Breda,Heracles Almelo,1,2,2,0,3,3,-1,4.0,9.0
15554,2010-2011,33,PSV,Vitesse,2,1,1,3,0,3,1,7.0,6.0
15555,2010-2011,33,AZ Alkmaar,De Graafschap,5,1,1,3,0,6,4,10.0,2.0
15556,2010-2011,33,ADO Den Haag,FC Groningen,2,4,2,0,3,6,-2,6.0,9.0
15557,2010-2011,33,NEC Nijmegen,Roda JC Kerkrade,5,0,1,3,0,5,5,6.0,10.0
15558,2010-2011,34,Willem II,NAC Breda,0,1,2,0,3,1,-1,3.0,4.0
15559,2010-2011,34,Roda JC Kerkrade,sc Heerenveen,0,0,3,1,1,0,0,8.0,6.0
15560,2010-2011,34,Heracles Almelo,ADO Den Haag,3,0,1,3,0,3,3,12.0,3.0
15561,2010-2011,34,Feyenoord,NEC Nijmegen,1,1,3,1,1,2,0,10.0,7.0
15562,2010-2011,34,De Graafschap,VVV-Venlo,1,0,1,3,0,1,1,5.0,4.0
15563,2010-2011,34,FC Utrecht,AZ Alkmaar,5,1,1,3,0,6,4,6.0,7.0
15564,2010-2011,34,Vitesse,SBV Excelsior,1,4,2,0,3,5,-3,3.0,10.0
15565,2010-2011,34,FC Groningen,PSV,0,0,3,1,1,0,0,7.0,8.0
15566,2010-2011,34,AFC Ajax,FC Twente,3,1,1,3,0,4,2,15.0,8.0
15567,2011-2012,1,SBV Excelsior,Feyenoord,0,2,2,0,3,2,-2,9.0,10.0
15568,2011-2012,1,Roda JC Kerkrade,FC Groningen,2,1,1,3,0,3,1,10.0,7.0
15569,2011-2012,1,sc Heerenveen,NEC Nijmegen,2,2,3,1,1,4,0,6.0,5.0
15570,2011-2012,1,RKC Waalwijk,Heracles Almelo,2,2,3,1,1,4,0,4.0,10.0
15571,2011-2012,1,VVV-Venlo,FC Utrecht,0,0,3,1,1,0,0,5.0,7.0
15572,2011-2012,1,AZ Alkmaar,PSV,3,1,1,3,0,4,2,9.0,7.0
15573,2011-2012,1,De Graafschap,AFC Ajax,1,4,2,0,3,5,-3,4.0,15.0
15574,2011-2012,1,ADO Den Haag,Vitesse,0,0,3,1,1,0,0,1.0,4.0
15575,2011-2012,1,NAC Breda,FC Twente,0,1,2,0,3,1,-1,3.0,10.0
15576,2011-2012,2,FC Twente,AZ Alkmaar,2,0,1,3,0,2,2,12.0,6.0
15577,2011-2012,2,Vitesse,VVV-Venlo,4,0,1,3,0,4,4,4.0,5.0
15578,2011-2012,2,PSV,RKC Waalwijk,1,0,1,3,0,1,1,7.0,1.0
15579,2011-2012,2,Feyenoord,Roda JC Kerkrade,3,0,1,3,0,3,3,10.0,7.0
15580,2011-2012,2,Heracles Almelo,NAC Breda,2,1,1,3,0,3,1,13.0,3.0
15581,2011-2012,2,FC Utrecht,De Graafschap,2,2,3,1,1,4,0,8.0,4.0
15582,2011-2012,2,AFC Ajax,sc Heerenveen,5,1,1,3,0,6,4,15.0,3.0
15583,2011-2012,2,FC Groningen,ADO Den Haag,4,2,1,3,0,6,2,10.0,1.0
15584,2011-2012,2,NEC Nijmegen,SBV Excelsior,2,0,1,3,0,2,2,8.0,6.0
15585,2011-2012,3,Roda JC Kerkrade,RKC Waalwijk,0,2,2,0,3,2,-2,4.0,4.0
15586,2011-2012,3,Vitesse,FC Utrecht,2,1,1,3,0,3,1,7.0,5.0
15587,2011-2012,3,SBV Excelsior,De Graafschap,1,1,3,1,1,2,0,7.0,5.0
15588,2011-2012,3,sc Heerenveen,FC Twente,1,5,2,0,3,6,-4,2.0,12.0
15589,2011-2012,3,NAC Breda,FC Groningen,2,2,3,1,1,4,0,4.0,8.0
15590,2011-2012,3,Heracles Almelo,Feyenoord,1,1,3,1,1,2,0,11.0,8.0
15591,2011-2012,3,VVV-Venlo,AFC Ajax,2,2,3,1,1,4,0,5.0,13.0
15592,2011-2012,3,AZ Alkmaar,NEC Nijmegen,4,0,1,3,0,4,4,9.0,8.0
15593,2011-2012,3,ADO Den Haag,PSV,0,3,2,0,3,3,-3,1.0,10.0
15594,2011-2012,4,AFC Ajax,Vitesse,4,1,1,3,0,5,3,13.0,7.0
15595,2011-2012,4,RKC Waalwijk,NAC Breda,2,1,1,3,0,3,1,7.0,4.0
15596,2011-2012,4,NEC Nijmegen,Heracles Almelo,2,1,1,3,0,3,1,8.0,8.0
15597,2011-2012,4,FC Twente,VVV-Venlo,4,1,1,3,0,5,3,12.0,2.0
15598,2011-2012,4,FC Utrecht,Roda JC Kerkrade,3,1,1,3,0,4,2,8.0,4.0
15599,2011-2012,4,De Graafschap,ADO Den Haag,0,3,2,0,3,3,-3,5.0,4.0
15600,2011-2012,4,FC Groningen,AZ Alkmaar,0,3,2,0,3,3,-3,5.0,9.0
15601,2011-2012,4,Feyenoord,sc Heerenveen,2,2,3,1,1,4,0,9.0,3.0
15602,2011-2012,4,PSV,SBV Excelsior,6,1,1,3,0,7,5,10.0,4.0
15603,2011-2012,5,Roda JC Kerkrade,FC Twente,2,1,1,3,0,3,1,6.0,12.0
15604,2011-2012,5,AZ Alkmaar,Vitesse,4,0,1,3,0,4,4,12.0,7.0
15605,2011-2012,5,ADO Den Haag,RKC Waalwijk,0,1,2,0,3,1,-1,4.0,10.0
15606,2011-2012,5,De Graafschap,NEC Nijmegen,1,0,1,3,0,1,1,5.0,7.0
15607,2011-2012,5,Heracles Almelo,AFC Ajax,2,3,2,0,3,5,-1,5.0,13.0
15608,2011-2012,5,sc Heerenveen,FC Groningen,3,0,1,3,0,3,3,5.0,4.0
15609,2011-2012,5,NAC Breda,Feyenoord,1,3,2,0,3,4,-2,1.0,11.0
15610,2011-2012,5,VVV-Venlo,PSV,3,3,3,1,1,6,0,3.0,10.0
15611,2011-2012,5,SBV Excelsior,FC Utrecht,2,3,2,0,3,5,-1,1.0,8.0
15612,2011-2012,6,NEC Nijmegen,NAC Breda,1,2,2,0,3,3,-1,6.0,4.0
15613,2011-2012,6,FC Groningen,SBV Excelsior,2,0,1,3,0,2,2,7.0,1.0
15614,2011-2012,6,VVV-Venlo,sc Heerenveen,0,3,2,0,3,3,-3,2.0,7.0
15615,2011-2012,6,Vitesse,Roda JC Kerkrade,5,0,1,3,0,5,5,9.0,3.0
15616,2011-2012,6,Feyenoord,De Graafschap,4,0,1,3,0,4,4,11.0,5.0
15617,2011-2012,6,PSV,AFC Ajax,2,2,3,1,1,4,0,11.0,11.0
15618,2011-2012,6,FC Twente,ADO Den Haag,5,2,1,3,0,7,3,12.0,3.0
15619,2011-2012,6,RKC Waalwijk,AZ Alkmaar,1,2,2,0,3,3,-1,9.0,12.0
15620,2011-2012,6,FC Utrecht,Heracles Almelo,2,2,3,1,1,4,0,8.0,5.0
15621,2011-2012,7,PSV,Roda JC Kerkrade,7,1,1,3,0,8,6,11.0,3.0
15622,2011-2012,7,sc Heerenveen,Heracles Almelo,1,1,3,1,1,2,0,8.0,3.0
15623,2011-2012,7,ADO Den Haag,VVV-Venlo,2,0,1,3,0,2,2,6.0,2.0
15624,2011-2012,7,NAC Breda,FC Utrecht,1,0,1,3,0,1,1,7.0,7.0
15625,2011-2012,7,AFC Ajax,FC Twente,1,1,3,1,1,2,0,9.0,10.0
15626,2011-2012,7,AZ Alkmaar,Feyenoord,2,1,1,3,0,3,1,15.0,8.0
15627,2011-2012,7,RKC Waalwijk,NEC Nijmegen,2,0,1,3,0,2,2,12.0,3.0
15628,2011-2012,7,De Graafschap,FC Groningen,2,3,2,0,3,5,-1,4.0,7.0
15629,2011-2012,7,SBV Excelsior,Vitesse,0,2,2,0,3,2,-2,1.0,9.0
15630,2011-2012,8,Heracles Almelo,De Graafschap,2,0,1,3,0,2,2,5.0,3.0
15631,2011-2012,8,FC Utrecht,RKC Waalwijk,3,0,1,3,0,3,3,10.0,9.0
15632,2011-2012,8,Vitesse,sc Heerenveen,1,1,3,1,1,2,0,7.0,9.0
15633,2011-2012,8,Roda JC Kerkrade,NAC Breda,4,3,1,3,0,7,1,6.0,6.0
15634,2011-2012,8,VVV-Venlo,AZ Alkmaar,1,3,2,0,3,4,-2,1.0,15.0
15635,2011-2012,8,FC Twente,SBV Excelsior,2,2,3,1,1,4,0,8.0,1.0
15636,2011-2012,8,Feyenoord,ADO Den Haag,0,3,2,0,3,3,-3,7.0,9.0
15637,2011-2012,8,FC Groningen,AFC Ajax,1,0,1,3,0,1,1,9.0,8.0
15638,2011-2012,8,NEC Nijmegen,PSV,0,2,2,0,3,2,-2,3.0,11.0
15639,2011-2012,9,AFC Ajax,AZ Alkmaar,2,2,3,1,1,4,0,6.0,13.0
15640,2011-2012,9,sc Heerenveen,De Graafschap,1,1,3,1,1,2,0,9.0,4.0
15641,2011-2012,9,Heracles Almelo,FC Groningen,2,1,1,3,0,3,1,8.0,9.0
15642,2011-2012,9,RKC Waalwijk,FC Twente,0,4,2,0,3,4,-4,6.0,8.0
15643,2011-2012,9,PSV,FC Utrecht,1,0,1,3,0,1,1,11.0,7.0
15644,2011-2012,9,NEC Nijmegen,Vitesse,0,1,2,0,3,1,-1,0.0,10.0
15645,2011-2012,9,Feyenoord,VVV-Venlo,4,0,1,3,0,4,4,9.0,1.0
15646,2011-2012,9,Roda JC Kerkrade,ADO Den Haag,4,1,1,3,0,5,3,9.0,6.0
15647,2011-2012,9,NAC Breda,SBV Excelsior,2,0,1,3,0,2,2,9.0,1.0
15648,2011-2012,10,De Graafschap,NAC Breda,3,1,1,3,0,4,2,4.0,9.0
15649,2011-2012,10,VVV-Venlo,RKC Waalwijk,4,1,1,3,0,5,3,3.0,3.0
15650,2011-2012,10,SBV Excelsior,Heracles Almelo,0,2,2,0,3,2,-2,1.0,11.0
15651,2011-2012,10,ADO Den Haag,NEC Nijmegen,1,0,1,3,0,1,1,9.0,0.0
15652,2011-2012,10,FC Utrecht,sc Heerenveen,1,4,2,0,3,5,-3,4.0,9.0
15653,2011-2012,10,AFC Ajax,Feyenoord,1,1,3,1,1,2,0,4.0,7.0
15654,2011-2012,10,AZ Alkmaar,Roda JC Kerkrade,1,0,1,3,0,1,1,13.0,6.0
15655,2011-2012,10,FC Groningen,FC Twente,1,1,3,1,1,2,0,10.0,9.0
15656,2011-2012,10,Vitesse,PSV,1,1,3,1,1,2,0,11.0,11.0
15657,2011-2012,11,NAC Breda,VVV-Venlo,3,1,1,3,0,4,2,9.0,3.0
15658,2011-2012,11,Roda JC Kerkrade,AFC Ajax,0,4,2,0,3,4,-4,6.0,6.0
15659,2011-2012,11,SBV Excelsior,RKC Waalwijk,1,0,1,3,0,1,1,4.0,3.0
15660,2011-2012,11,sc Heerenveen,ADO Den Haag,4,0,1,3,0,4,4,9.0,9.0
15661,2011-2012,11,FC Twente,PSV,2,2,3,1,1,4,0,7.0,11.0
15662,2011-2012,11,De Graafschap,Vitesse,0,1,2,0,3,1,-1,4.0,11.0
15663,2011-2012,11,FC Groningen,Feyenoord,6,0,1,3,0,6,6,10.0,4.0
15664,2011-2012,11,NEC Nijmegen,FC Utrecht,3,1,1,3,0,4,2,3.0,3.0
15665,2011-2012,11,Heracles Almelo,AZ Alkmaar,0,1,2,0,3,1,-1,10.0,13.0
15666,2011-2012,12,VVV-Venlo,SBV Excelsior,0,0,3,1,1,0,0,4.0,5.0
15667,2011-2012,12,NAC Breda,Vitesse,1,0,1,3,0,1,1,9.0,8.0
15668,2011-2012,12,Roda JC Kerkrade,sc Heerenveen,1,2,2,0,3,3,-1,6.0,11.0
15669,2011-2012,12,RKC Waalwijk,FC Groningen,1,1,3,1,1,2,0,1.0,8.0
15670,2011-2012,12,Feyenoord,NEC Nijmegen,0,1,2,0,3,1,-1,4.0,6.0
15671,2011-2012,12,FC Utrecht,AFC Ajax,6,4,1,3,0,10,2,6.0,5.0
15672,2011-2012,12,FC Twente,De Graafschap,4,0,1,3,0,4,4,9.0,4.0
15673,2011-2012,12,AZ Alkmaar,ADO Den Haag,3,0,1,3,0,3,3,13.0,6.0
15674,2011-2012,12,PSV,Heracles Almelo,4,1,1,3,0,5,3,11.0,9.0
15675,2011-2012,13,De Graafschap,PSV,1,3,2,0,3,4,-2,4.0,11.0
15676,2011-2012,13,Heracles Almelo,FC Twente,1,1,3,1,1,2,0,7.0,9.0
15677,2011-2012,13,sc Heerenveen,RKC Waalwijk,1,1,3,1,1,2,0,11.0,2.0
15678,2011-2012,13,NEC Nijmegen,Roda JC Kerkrade,1,2,2,0,3,3,-1,6.0,6.0
15679,2011-2012,13,AFC Ajax,NAC Breda,2,2,3,1,1,4,0,6.0,10.0
15680,2011-2012,13,Vitesse,Feyenoord,0,4,2,0,3,4,-4,7.0,7.0
15681,2011-2012,13,ADO Den Haag,FC Utrecht,2,2,3,1,1,4,0,4.0,4.0
15682,2011-2012,13,FC Groningen,VVV-Venlo,2,1,1,3,0,3,1,8.0,4.0
15683,2011-2012,13,SBV Excelsior,AZ Alkmaar,0,0,3,1,1,0,0,5.0,11.0
15684,2011-2012,14,AZ Alkmaar,FC Utrecht,2,0,1,3,0,2,2,13.0,4.0
15685,2011-2012,14,NAC Breda,sc Heerenveen,2,2,3,1,1,4,0,8.0,11.0
15686,2011-2012,14,Roda JC Kerkrade,Heracles Almelo,3,1,1,3,0,4,2,6.0,4.0
15687,2011-2012,14,VVV-Venlo,De Graafschap,1,2,2,0,3,3,-1,4.0,6.0
15688,2011-2012,14,PSV,FC Groningen,6,1,1,3,0,7,5,11.0,8.0
15689,2011-2012,14,RKC Waalwijk,Feyenoord,1,2,2,0,3,3,-1,2.0,7.0
15690,2011-2012,14,SBV Excelsior,ADO Den Haag,1,1,3,1,1,2,0,6.0,5.0
15691,2011-2012,14,NEC Nijmegen,AFC Ajax,0,3,2,0,3,3,-3,6.0,8.0
15692,2011-2012,14,FC Twente,Vitesse,0,0,3,1,1,0,0,7.0,5.0
15693,2011-2012,15,Heracles Almelo,VVV-Venlo,7,0,1,3,0,7,7,4.0,1.0
15694,2011-2012,15,FC Groningen,NEC Nijmegen,3,3,3,1,1,6,0,8.0,7.0
15695,2011-2012,15,De Graafschap,Roda JC Kerkrade,1,2,2,0,3,3,-1,3.0,9.0
15696,2011-2012,15,ADO Den Haag,NAC Breda,3,0,1,3,0,3,3,5.0,8.0
15697,2011-2012,15,AFC Ajax,SBV Excelsior,4,1,1,3,0,5,3,10.0,6.0
15698,2011-2012,15,Feyenoord,PSV,2,0,1,3,0,2,2,9.0,10.0
15699,2011-2012,15,Vitesse,RKC Waalwijk,4,0,1,3,0,4,4,7.0,2.0
15700,2011-2012,15,FC Utrecht,FC Twente,2,6,2,0,3,8,-4,4.0,9.0
15701,2011-2012,15,sc Heerenveen,AZ Alkmaar,5,1,1,3,0,6,4,11.0,10.0
15702,2011-2012,16,ADO Den Haag,Heracles Almelo,2,0,1,3,0,2,2,8.0,4.0
15703,2011-2012,16,FC Twente,NEC Nijmegen,2,0,1,3,0,2,2,11.0,4.0
15704,2011-2012,16,SBV Excelsior,sc Heerenveen,0,5,2,0,3,5,-5,3.0,11.0
15705,2011-2012,16,AZ Alkmaar,De Graafschap,4,0,1,3,0,4,4,10.0,3.0
15706,2011-2012,16,PSV,NAC Breda,1,0,1,3,0,1,1,12.0,5.0
15707,2011-2012,16,VVV-Venlo,Roda JC Kerkrade,2,0,1,3,0,2,2,4.0,9.0
15708,2011-2012,16,RKC Waalwijk,AFC Ajax,0,1,2,0,3,1,-1,2.0,10.0
15709,2011-2012,16,FC Utrecht,Feyenoord,2,2,3,1,1,4,0,5.0,10.0
15710,2011-2012,16,Vitesse,FC Groningen,0,0,3,1,1,0,0,5.0,6.0
15711,2011-2012,17,De Graafschap,RKC Waalwijk,1,3,2,0,3,4,-2,3.0,4.0
15712,2011-2012,17,Heracles Almelo,Vitesse,0,1,2,0,3,1,-1,4.0,8.0
15713,2011-2012,17,Roda JC Kerkrade,SBV Excelsior,7,0,1,3,0,7,7,12.0,2.0
15714,2011-2012,17,NEC Nijmegen,VVV-Venlo,2,0,1,3,0,2,2,4.0,3.0
15715,2011-2012,17,FC Groningen,FC Utrecht,1,0,1,3,0,1,1,8.0,2.0
15716,2011-2012,17,AFC Ajax,ADO Den Haag,4,0,1,3,0,4,4,13.0,8.0
15717,2011-2012,17,Feyenoord,FC Twente,3,2,1,3,0,5,1,13.0,8.0
15718,2011-2012,17,NAC Breda,AZ Alkmaar,2,1,1,3,0,3,1,5.0,7.0
15719,2011-2012,17,sc Heerenveen,PSV,1,5,2,0,3,6,-4,8.0,12.0
15720,2011-2012,18,ADO Den Haag,Roda JC Kerkrade,3,3,3,1,1,6,0,8.0,10.0
15721,2011-2012,18,De Graafschap,sc Heerenveen,0,2,2,0,3,2,-2,3.0,10.0
15722,2011-2012,18,SBV Excelsior,NAC Breda,3,0,1,3,0,3,3,4.0,4.0
15723,2011-2012,18,FC Twente,RKC Waalwijk,5,0,1,3,0,5,5,10.0,3.0
15724,2011-2012,18,Vitesse,NEC Nijmegen,0,1,2,0,3,1,-1,8.0,7.0
15725,2011-2012,18,FC Groningen,Heracles Almelo,2,1,1,3,0,3,1,8.0,3.0
15726,2011-2012,18,VVV-Venlo,Feyenoord,2,1,1,3,0,3,1,6.0,10.0
15727,2011-2012,18,AZ Alkmaar,AFC Ajax,1,1,3,1,1,2,0,7.0,13.0
15728,2011-2012,18,FC Utrecht,PSV,1,1,3,1,1,2,0,2.0,10.0
15729,2011-2012,19,PSV,Vitesse,3,1,1,3,0,4,2,10.0,7.0
15730,2011-2012,19,sc Heerenveen,FC Utrecht,2,0,1,3,0,2,2,12.0,2.0
15731,2011-2012,19,Heracles Almelo,SBV Excelsior,3,0,1,3,0,3,3,6.0,3.0
15732,2011-2012,19,NAC Breda,De Graafschap,1,1,3,1,1,2,0,4.0,1.0
15733,2011-2012,19,Roda JC Kerkrade,AZ Alkmaar,2,0,1,3,0,2,2,10.0,4.0
15734,2011-2012,19,Feyenoord,AFC Ajax,4,2,1,3,0,6,2,10.0,10.0
15735,2011-2012,19,FC Twente,FC Groningen,4,1,1,3,0,5,3,12.0,8.0
15736,2011-2012,19,RKC Waalwijk,VVV-Venlo,4,0,1,3,0,4,4,6.0,6.0
15737,2011-2012,19,NEC Nijmegen,ADO Den Haag,2,0,1,3,0,2,2,10.0,7.0
15738,2011-2012,20,sc Heerenveen,Roda JC Kerkrade,4,3,1,3,0,7,1,12.0,7.0
15739,2011-2012,20,SBV Excelsior,VVV-Venlo,3,1,1,3,0,4,2,6.0,6.0
15740,2011-2012,20,Vitesse,NAC Breda,1,0,1,3,0,1,1,7.0,4.0
15741,2011-2012,20,AFC Ajax,FC Utrecht,0,2,2,0,3,2,-2,7.0,5.0
15742,2011-2012,20,Heracles Almelo,PSV,1,1,3,1,1,2,0,4.0,11.0
15743,2011-2012,20,NEC Nijmegen,Feyenoord,0,2,2,0,3,2,-2,9.0,10.0
15744,2011-2012,20,FC Groningen,RKC Waalwijk,0,3,2,0,3,3,-3,7.0,9.0
15745,2011-2012,20,ADO Den Haag,AZ Alkmaar,0,6,2,0,3,6,-6,4.0,7.0
15746,2011-2012,20,De Graafschap,FC Twente,1,2,2,0,3,3,-1,1.0,12.0
15747,2011-2012,21,FC Twente,Heracles Almelo,2,3,2,0,3,5,-1,9.0,7.0
15748,2011-2012,21,AZ Alkmaar,SBV Excelsior,2,0,1,3,0,2,2,7.0,6.0
15749,2011-2012,21,Roda JC Kerkrade,NEC Nijmegen,1,0,1,3,0,1,1,10.0,9.0
15750,2011-2012,21,VVV-Venlo,FC Groningen,2,0,1,3,0,2,2,6.0,6.0
15751,2011-2012,21,NAC Breda,AFC Ajax,0,2,2,0,3,2,-2,4.0,7.0
15752,2011-2012,21,FC Utrecht,ADO Den Haag,1,1,3,1,1,2,0,5.0,2.0
15753,2011-2012,21,PSV,De Graafschap,4,1,1,3,0,5,3,11.0,1.0
15754,2011-2012,21,RKC Waalwijk,sc Heerenveen,0,1,2,0,3,1,-1,9.0,12.0
15755,2011-2012,21,Feyenoord,Vitesse,3,1,1,3,0,4,2,12.0,6.0
15756,2011-2012,22,sc Heerenveen,NAC Breda,1,0,1,3,0,1,1,15.0,1.0
15757,2011-2012,22,Feyenoord,RKC Waalwijk,1,1,3,1,1,2,0,10.0,7.0
15758,2011-2012,22,De Graafschap,VVV-Venlo,1,4,2,0,3,5,-3,1.0,9.0
15759,2011-2012,22,ADO Den Haag,SBV Excelsior,1,1,3,1,1,2,0,3.0,7.0
15760,2011-2012,22,Heracles Almelo,Roda JC Kerkrade,2,1,1,3,0,3,1,10.0,7.0
15761,2011-2012,22,FC Groningen,PSV,3,0,1,3,0,3,3,6.0,8.0
15762,2011-2012,22,AFC Ajax,NEC Nijmegen,4,1,1,3,0,5,3,7.0,6.0
15763,2011-2012,22,FC Utrecht,AZ Alkmaar,3,0,1,3,0,3,3,8.0,7.0
15764,2011-2012,22,Vitesse,FC Twente,1,4,2,0,3,5,-3,3.0,12.0
15765,2011-2012,23,RKC Waalwijk,Vitesse,1,0,1,3,0,1,1,10.0,3.0
15766,2011-2012,23,NAC Breda,ADO Den Haag,4,0,1,3,0,4,4,4.0,2.0
15767,2011-2012,23,Roda JC Kerkrade,De Graafschap,0,2,2,0,3,2,-2,6.0,4.0
15768,2011-2012,23,VVV-Venlo,Heracles Almelo,3,1,1,3,0,4,2,9.0,10.0
15769,2011-2012,23,NEC Nijmegen,FC Groningen,4,0,1,3,0,4,4,6.0,3.0
15770,2011-2012,23,SBV Excelsior,AFC Ajax,1,4,2,0,3,5,-3,4.0,9.0
15771,2011-2012,23,PSV,Feyenoord,3,2,1,3,0,5,1,10.0,10.0
15772,2011-2012,23,FC Twente,FC Utrecht,1,0,1,3,0,1,1,12.0,7.0
15773,2011-2012,23,AZ Alkmaar,sc Heerenveen,3,3,3,1,1,6,0,7.0,13.0
15774,2011-2012,24,ADO Den Haag,sc Heerenveen,0,0,3,1,1,0,0,3.0,11.0
15775,2011-2012,24,RKC Waalwijk,SBV Excelsior,1,0,1,3,0,1,1,10.0,4.0
15776,2011-2012,24,VVV-Venlo,NAC Breda,2,1,1,3,0,3,1,12.0,3.0
15777,2011-2012,24,AZ Alkmaar,Heracles Almelo,3,1,1,3,0,4,2,10.0,7.0
15778,2011-2012,24,Vitesse,De Graafschap,2,0,1,3,0,2,2,6.0,3.0
15779,2011-2012,24,Feyenoord,FC Groningen,1,0,1,3,0,1,1,10.0,3.0
15780,2011-2012,24,AFC Ajax,Roda JC Kerkrade,4,1,1,3,0,5,3,12.0,3.0
15781,2011-2012,24,FC Utrecht,NEC Nijmegen,0,0,3,1,1,0,0,8.0,4.0
15782,2011-2012,24,PSV,FC Twente,2,6,2,0,3,8,-4,7.0,12.0
15783,2011-2012,25,Roda JC Kerkrade,VVV-Venlo,3,1,1,3,0,4,2,6.0,12.0
15784,2011-2012,25,FC Groningen,Vitesse,1,3,2,0,3,4,-2,3.0,6.0
15785,2011-2012,25,Heracles Almelo,ADO Den Haag,0,2,2,0,3,2,-2,6.0,6.0
15786,2011-2012,25,sc Heerenveen,SBV Excelsior,4,2,1,3,0,6,2,11.0,1.0
15787,2011-2012,25,NAC Breda,PSV,3,1,1,3,0,4,2,6.0,6.0
15788,2011-2012,25,NEC Nijmegen,FC Twente,3,1,1,3,0,4,2,7.0,9.0
15789,2011-2012,25,AFC Ajax,RKC Waalwijk,3,0,1,3,0,3,3,15.0,7.0
15790,2011-2012,25,Feyenoord,FC Utrecht,1,1,3,1,1,2,0,8.0,6.0
15791,2011-2012,25,De Graafschap,AZ Alkmaar,0,2,2,0,3,2,-2,3.0,10.0
15792,2011-2012,26,Vitesse,Heracles Almelo,2,0,1,3,0,2,2,9.0,3.0
15793,2011-2012,26,RKC Waalwijk,De Graafschap,1,0,1,3,0,1,1,10.0,3.0
15794,2011-2012,26,SBV Excelsior,Roda JC Kerkrade,2,1,1,3,0,3,1,4.0,3.0
15795,2011-2012,26,VVV-Venlo,NEC Nijmegen,0,2,2,0,3,2,-2,9.0,10.0
15796,2011-2012,26,ADO Den Haag,AFC Ajax,0,2,2,0,3,2,-2,5.0,15.0
15797,2011-2012,26,PSV,sc Heerenveen,5,1,1,3,0,6,4,6.0,8.0
15798,2011-2012,26,FC Utrecht,FC Groningen,3,1,1,3,0,4,2,8.0,3.0
15799,2011-2012,26,FC Twente,Feyenoord,0,2,2,0,3,2,-2,9.0,8.0
15800,2011-2012,26,AZ Alkmaar,NAC Breda,0,0,3,1,1,0,0,8.0,7.0
15801,2011-2012,27,SBV Excelsior,FC Groningen,0,1,2,0,3,1,-1,3.0,3.0
15802,2011-2012,27,Roda JC Kerkrade,Vitesse,3,1,1,3,0,4,2,6.0,9.0
15803,2011-2012,27,NAC Breda,NEC Nijmegen,1,1,3,1,1,2,0,8.0,11.0
15804,2011-2012,27,sc Heerenveen,VVV-Venlo,4,1,1,3,0,5,3,8.0,6.0
15805,2011-2012,27,ADO Den Haag,FC Twente,1,1,3,1,1,2,0,5.0,7.0
15806,2011-2012,27,AZ Alkmaar,RKC Waalwijk,1,0,1,3,0,1,1,11.0,9.0
15807,2011-2012,27,Heracles Almelo,FC Utrecht,3,1,1,3,0,4,2,3.0,5.0
15808,2011-2012,27,De Graafschap,Feyenoord,0,3,2,0,3,3,-3,3.0,10.0
15809,2011-2012,27,AFC Ajax,PSV,2,0,1,3,0,2,2,15.0,6.0
15810,2011-2012,28,FC Utrecht,SBV Excelsior,3,2,1,3,0,5,1,8.0,3.0
15811,2011-2012,28,FC Groningen,sc Heerenveen,1,3,2,0,3,4,-2,3.0,10.0
15812,2011-2012,28,FC Twente,Roda JC Kerkrade,2,0,1,3,0,2,2,7.0,6.0
15813,2011-2012,28,PSV,VVV-Venlo,2,0,1,3,0,2,2,6.0,3.0
15814,2011-2012,28,Feyenoord,NAC Breda,3,1,1,3,0,4,2,13.0,5.0
15815,2011-2012,28,NEC Nijmegen,De Graafschap,2,0,1,3,0,2,2,11.0,0.0
15816,2011-2012,28,AFC Ajax,Heracles Almelo,6,0,1,3,0,6,6,15.0,3.0
15817,2011-2012,28,RKC Waalwijk,ADO Den Haag,1,0,1,3,0,1,1,9.0,5.0
15818,2011-2012,28,Vitesse,AZ Alkmaar,2,2,3,1,1,4,0,10.0,11.0
15819,2011-2012,29,SBV Excelsior,NEC Nijmegen,0,2,2,0,3,2,-2,3.0,13.0
15820,2011-2012,29,AZ Alkmaar,FC Twente,2,2,3,1,1,4,0,9.0,5.0
15821,2011-2012,29,NAC Breda,Heracles Almelo,1,2,2,0,3,3,-1,5.0,6.0
15822,2011-2012,29,Roda JC Kerkrade,Feyenoord,0,0,3,1,1,0,0,7.0,11.0
15823,2011-2012,29,RKC Waalwijk,PSV,2,1,1,3,0,3,1,9.0,6.0
15824,2011-2012,29,sc Heerenveen,AFC Ajax,0,5,2,0,3,5,-5,9.0,15.0
15825,2011-2012,29,De Graafschap,FC Utrecht,3,0,1,3,0,3,3,3.0,7.0
15826,2011-2012,29,VVV-Venlo,Vitesse,1,3,2,0,3,4,-2,0.0,10.0
15827,2011-2012,29,ADO Den Haag,FC Groningen,3,0,1,3,0,3,3,7.0,3.0
15828,2011-2012,30,PSV,AZ Alkmaar,3,2,1,3,0,5,1,9.0,6.0
15829,2011-2012,30,NEC Nijmegen,sc Heerenveen,2,4,2,0,3,6,-2,10.0,9.0
15830,2011-2012,30,Feyenoord,SBV Excelsior,3,0,1,3,0,3,3,13.0,3.0
15831,2011-2012,30,FC Twente,NAC Breda,2,2,3,1,1,4,0,6.0,3.0
15832,2011-2012,30,FC Groningen,Roda JC Kerkrade,0,1,2,0,3,1,-1,3.0,7.0
15833,2011-2012,30,FC Utrecht,VVV-Venlo,4,2,1,3,0,6,2,9.0,0.0
15834,2011-2012,30,Vitesse,ADO Den Haag,1,0,1,3,0,1,1,10.0,4.0
15835,2011-2012,30,AFC Ajax,De Graafschap,3,1,1,3,0,4,2,15.0,3.0
15836,2011-2012,30,Heracles Almelo,RKC Waalwijk,1,1,3,1,1,2,0,7.0,10.0
15837,2011-2012,31,NAC Breda,Roda JC Kerkrade,0,3,2,0,3,3,-3,2.0,10.0
15838,2011-2012,31,sc Heerenveen,Vitesse,1,1,3,1,1,2,0,10.0,8.0
15839,2011-2012,31,RKC Waalwijk,FC Utrecht,0,2,2,0,3,2,-2,7.0,9.0
15840,2011-2012,31,De Graafschap,Heracles Almelo,2,3,2,0,3,5,-1,3.0,10.0
15841,2011-2012,31,SBV Excelsior,FC Twente,0,1,2,0,3,1,-1,0.0,9.0
15842,2011-2012,31,ADO Den Haag,Feyenoord,1,2,2,0,3,3,-1,4.0,13.0
15843,2011-2012,31,PSV,NEC Nijmegen,2,1,1,3,0,3,1,9.0,7.0
15844,2011-2012,31,AZ Alkmaar,VVV-Venlo,2,1,1,3,0,3,1,8.0,0.0
15845,2011-2012,31,AFC Ajax,FC Groningen,2,0,1,3,0,2,2,15.0,3.0
15846,2011-2012,32,FC Groningen,De Graafschap,1,1,3,1,1,2,0,1.0,4.0
15847,2011-2012,32,Heracles Almelo,sc Heerenveen,2,4,2,0,3,6,-2,7.0,10.0
15848,2011-2012,32,FC Utrecht,NAC Breda,1,3,2,0,3,4,-2,9.0,4.0
15849,2011-2012,32,Vitesse,SBV Excelsior,3,2,1,3,0,5,1,11.0,0.0
15850,2011-2012,32,VVV-Venlo,ADO Den Haag,2,1,1,3,0,3,1,3.0,3.0
15851,2011-2012,32,Roda JC Kerkrade,PSV,1,3,2,0,3,4,-2,7.0,12.0
15852,2011-2012,32,Feyenoord,AZ Alkmaar,1,0,1,3,0,1,1,13.0,5.0
15853,2011-2012,32,FC Twente,AFC Ajax,1,2,2,0,3,3,-1,8.0,15.0
15854,2011-2012,32,NEC Nijmegen,RKC Waalwijk,1,1,3,1,1,2,0,7.0,8.0
15855,2011-2012,33,FC Twente,sc Heerenveen,3,4,2,0,3,7,-1,5.0,10.0
15856,2011-2012,33,FC Utrecht,Vitesse,2,2,3,1,1,4,0,7.0,11.0
15857,2011-2012,33,FC Groningen,NAC Breda,1,1,3,1,1,2,0,2.0,5.0
15858,2011-2012,33,RKC Waalwijk,Roda JC Kerkrade,5,2,1,3,0,7,3,8.0,7.0
15859,2011-2012,33,PSV,ADO Den Haag,5,0,1,3,0,5,5,12.0,3.0
15860,2011-2012,33,De Graafschap,SBV Excelsior,2,2,3,1,1,4,0,5.0,1.0
15861,2011-2012,33,AFC Ajax,VVV-Venlo,2,0,1,3,0,2,2,15.0,3.0
15862,2011-2012,33,Feyenoord,Heracles Almelo,4,1,1,3,0,5,3,13.0,7.0
15863,2011-2012,33,NEC Nijmegen,AZ Alkmaar,1,1,3,1,1,2,0,5.0,5.0
15864,2011-2012,34,NAC Breda,RKC Waalwijk,3,2,1,3,0,5,1,8.0,5.0
15865,2011-2012,34,Vitesse,AFC Ajax,1,3,2,0,3,4,-2,8.0,15.0
15866,2011-2012,34,AZ Alkmaar,FC Groningen,1,0,1,3,0,1,1,7.0,2.0
15867,2011-2012,34,Roda JC Kerkrade,FC Utrecht,1,3,2,0,3,4,-2,6.0,10.0
15868,2011-2012,34,VVV-Venlo,FC Twente,4,2,1,3,0,6,2,6.0,4.0
15869,2011-2012,34,SBV Excelsior,PSV,1,3,2,0,3,4,-2,1.0,15.0
15870,2011-2012,34,ADO Den Haag,De Graafschap,3,5,2,0,3,8,-2,0.0,5.0
15871,2011-2012,34,Heracles Almelo,NEC Nijmegen,1,2,2,0,3,3,-1,4.0,5.0
15872,2011-2012,34,sc Heerenveen,Feyenoord,2,3,2,0,3,5,-1,10.0,15.0
15873,2012-2013,1,Willem II,NAC Breda,1,1,3,1,1,2,0,4.0,8.0
15874,2012-2013,1,RKC Waalwijk,PSV,3,2,1,3,0,5,1,7.0,12.0
15875,2012-2013,1,Roda JC Kerkrade,PEC Zwolle,1,1,3,1,1,2,0,4.0,7.0
15876,2012-2013,1,Heracles Almelo,VVV-Venlo,1,1,3,1,1,2,0,4.0,7.0
15877,2012-2013,1,FC Utrecht,Feyenoord,0,1,2,0,3,1,-1,7.0,15.0
15878,2012-2013,1,FC Twente,FC Groningen,4,1,1,3,0,5,3,6.0,2.0
15879,2012-2013,1,Vitesse,ADO Den Haag,2,2,3,1,1,4,0,6.0,1.0
15880,2012-2013,1,sc Heerenveen,NEC Nijmegen,0,2,2,0,3,2,-2,7.0,8.0
15881,2012-2013,1,AFC Ajax,AZ Alkmaar,2,2,3,1,1,4,0,13.0,8.0
15882,2012-2013,2,PSV,Roda JC Kerkrade,5,0,1,3,0,5,5,12.0,1.0
15883,2012-2013,2,NAC Breda,FC Twente,0,1,2,0,3,1,-1,8.0,6.0
15884,2012-2013,2,PEC Zwolle,Vitesse,0,1,2,0,3,1,-1,7.0,8.0
15885,2012-2013,2,VVV-Venlo,FC Utrecht,1,3,2,0,3,4,-2,7.0,7.0
15886,2012-2013,2,Feyenoord,sc Heerenveen,1,1,3,1,1,2,0,13.0,7.0
15887,2012-2013,2,FC Groningen,Willem II,1,1,3,1,1,2,0,3.0,5.0
15888,2012-2013,2,ADO Den Haag,RKC Waalwijk,2,2,3,1,1,4,0,2.0,8.0
15889,2012-2013,2,AZ Alkmaar,Heracles Almelo,3,1,1,3,0,4,2,8.0,1.0
15890,2012-2013,2,NEC Nijmegen,AFC Ajax,1,6,2,0,3,7,-5,8.0,13.0
15891,2012-2013,3,RKC Waalwijk,Roda JC Kerkrade,1,0,1,3,0,1,1,10.0,1.0
15892,2012-2013,3,FC Utrecht,PEC Zwolle,1,1,3,1,1,2,0,8.0,5.0
15893,2012-2013,3,VVV-Venlo,ADO Den Haag,2,4,2,0,3,6,-2,4.0,5.0
15894,2012-2013,3,AFC Ajax,NAC Breda,5,0,1,3,0,5,5,13.0,5.0
15895,2012-2013,3,AZ Alkmaar,sc Heerenveen,0,0,3,1,1,0,0,9.0,5.0
15896,2012-2013,3,Heracles Almelo,Feyenoord,1,2,2,0,3,3,-1,1.0,13.0
15897,2012-2013,3,Willem II,Vitesse,0,2,2,0,3,2,-2,2.0,8.0
15898,2012-2013,3,NEC Nijmegen,FC Twente,1,3,2,0,3,4,-2,7.0,9.0
15899,2012-2013,3,FC Groningen,PSV,1,3,2,0,3,4,-2,2.0,12.0
15900,2012-2013,4,ADO Den Haag,FC Groningen,0,1,2,0,3,1,-1,5.0,4.0
15901,2012-2013,4,Roda JC Kerkrade,Willem II,3,0,1,3,0,3,3,4.0,2.0
15902,2012-2013,4,PEC Zwolle,NEC Nijmegen,0,4,2,0,3,4,-4,2.0,9.0
15903,2012-2013,4,RKC Waalwijk,Heracles Almelo,1,1,3,1,1,2,0,8.0,2.0
15904,2012-2013,4,NAC Breda,FC Utrecht,1,1,3,1,1,2,0,5.0,8.0
15905,2012-2013,4,Vitesse,Feyenoord,1,0,1,3,0,1,1,10.0,10.0
15906,2012-2013,4,FC Twente,VVV-Venlo,1,0,1,3,0,1,1,12.0,4.0
15907,2012-2013,4,PSV,AZ Alkmaar,5,1,1,3,0,6,4,12.0,8.0
15908,2012-2013,4,sc Heerenveen,AFC Ajax,2,2,3,1,1,4,0,3.0,11.0
15909,2012-2013,5,AFC Ajax,RKC Waalwijk,2,0,1,3,0,2,2,11.0,8.0
15910,2012-2013,5,Willem II,FC Twente,2,6,2,0,3,8,-4,2.0,15.0
15911,2012-2013,5,sc Heerenveen,ADO Den Haag,1,3,2,0,3,4,-2,3.0,8.0
15912,2012-2013,5,VVV-Venlo,NEC Nijmegen,2,2,3,1,1,4,0,2.0,7.0
15913,2012-2013,5,Feyenoord,PEC Zwolle,2,0,1,3,0,2,2,10.0,2.0
15914,2012-2013,5,Heracles Almelo,NAC Breda,2,1,1,3,0,3,1,5.0,2.0
15915,2012-2013,5,AZ Alkmaar,Roda JC Kerkrade,4,0,1,3,0,4,4,8.0,4.0
15916,2012-2013,5,FC Utrecht,PSV,1,0,1,3,0,1,1,8.0,9.0
15917,2012-2013,5,FC Groningen,Vitesse,0,3,2,0,3,3,-3,4.0,13.0
15918,2012-2013,6,Roda JC Kerkrade,FC Utrecht,0,1,2,0,3,1,-1,3.0,11.0
15919,2012-2013,6,PEC Zwolle,FC Groningen,1,2,2,0,3,3,-1,1.0,7.0
15920,2012-2013,6,RKC Waalwijk,VVV-Venlo,1,1,3,1,1,2,0,6.0,2.0
15921,2012-2013,6,Vitesse,Heracles Almelo,1,1,3,1,1,2,0,13.0,5.0
15922,2012-2013,6,NEC Nijmegen,Willem II,0,0,3,1,1,0,0,5.0,2.0
15923,2012-2013,6,ADO Den Haag,AFC Ajax,1,1,3,1,1,2,0,8.0,11.0
15924,2012-2013,6,FC Twente,sc Heerenveen,1,0,1,3,0,1,1,15.0,3.0
15925,2012-2013,6,NAC Breda,AZ Alkmaar,2,1,1,3,0,3,1,4.0,7.0
15926,2012-2013,6,PSV,Feyenoord,3,0,1,3,0,3,3,12.0,7.0
15927,2012-2013,7,sc Heerenveen,NAC Breda,2,0,1,3,0,2,2,5.0,4.0
15928,2012-2013,7,Feyenoord,NEC Nijmegen,5,1,1,3,0,6,4,9.0,5.0
15929,2012-2013,7,FC Utrecht,Vitesse,1,2,2,0,3,3,-1,8.0,13.0
15930,2012-2013,7,Heracles Almelo,ADO Den Haag,3,3,3,1,1,6,0,6.0,8.0
15931,2012-2013,7,AFC Ajax,FC Twente,1,0,1,3,0,1,1,11.0,12.0
15932,2012-2013,7,AZ Alkmaar,RKC Waalwijk,3,3,3,1,1,6,0,5.0,6.0
15933,2012-2013,7,Willem II,PEC Zwolle,0,1,2,0,3,1,-1,1.0,4.0
15934,2012-2013,7,FC Groningen,Roda JC Kerkrade,3,2,1,3,0,5,1,9.0,3.0
15935,2012-2013,7,VVV-Venlo,PSV,0,6,2,0,3,6,-6,2.0,12.0
15936,2012-2013,8,NEC Nijmegen,ADO Den Haag,1,1,3,1,1,2,0,6.0,6.0
15937,2012-2013,8,Willem II,RKC Waalwijk,1,0,1,3,0,1,1,4.0,3.0
15938,2012-2013,8,PEC Zwolle,Heracles Almelo,0,3,2,0,3,3,-3,3.0,9.0
15939,2012-2013,8,Vitesse,sc Heerenveen,3,3,3,1,1,6,0,11.0,5.0
15940,2012-2013,8,Roda JC Kerkrade,VVV-Venlo,3,0,1,3,0,3,3,6.0,2.0
15941,2012-2013,8,AFC Ajax,FC Utrecht,1,1,3,1,1,2,0,9.0,8.0
15942,2012-2013,8,PSV,NAC Breda,4,0,1,3,0,4,4,12.0,4.0
15943,2012-2013,8,FC Groningen,Feyenoord,2,2,3,1,1,4,0,10.0,7.0
15944,2012-2013,8,FC Twente,AZ Alkmaar,3,0,1,3,0,3,3,12.0,4.0
15945,2012-2013,9,Heracles Almelo,AFC Ajax,3,3,3,1,1,6,0,9.0,9.0
15946,2012-2013,9,Roda JC Kerkrade,FC Twente,1,1,3,1,1,2,0,4.0,10.0
15947,2012-2013,9,NAC Breda,Vitesse,0,3,2,0,3,3,-3,3.0,11.0
15948,2012-2013,9,PSV,Willem II,3,2,1,3,0,5,1,12.0,4.0
15949,2012-2013,9,AZ Alkmaar,NEC Nijmegen,0,2,2,0,3,2,-2,4.0,6.0
15950,2012-2013,9,ADO Den Haag,FC Utrecht,1,2,2,0,3,3,-1,6.0,10.0
15951,2012-2013,9,VVV-Venlo,Feyenoord,2,3,2,0,3,5,-1,2.0,10.0
15952,2012-2013,9,sc Heerenveen,FC Groningen,3,0,1,3,0,3,3,7.0,7.0
15953,2012-2013,9,RKC Waalwijk,PEC Zwolle,1,2,2,0,3,3,-1,2.0,6.0
15954,2012-2013,10,FC Utrecht,FC Groningen,1,0,1,3,0,1,1,10.0,7.0
15955,2012-2013,10,ADO Den Haag,Willem II,2,0,1,3,0,2,2,6.0,4.0
15956,2012-2013,10,NEC Nijmegen,Roda JC Kerkrade,0,0,3,1,1,0,0,6.0,5.0
15957,2012-2013,10,VVV-Venlo,NAC Breda,1,4,2,0,3,5,-3,1.0,6.0
15958,2012-2013,10,Feyenoord,AFC Ajax,2,2,3,1,1,4,0,8.0,7.0
15959,2012-2013,10,PEC Zwolle,PSV,1,2,2,0,3,3,-1,6.0,15.0
15960,2012-2013,10,Heracles Almelo,sc Heerenveen,6,3,1,3,0,9,3,9.0,7.0
15961,2012-2013,10,RKC Waalwijk,FC Twente,0,1,2,0,3,1,-1,2.0,10.0
15962,2012-2013,10,Vitesse,AZ Alkmaar,1,2,2,0,3,3,-1,8.0,4.0
15963,2012-2013,11,Roda JC Kerkrade,ADO Den Haag,0,0,3,1,1,0,0,6.0,6.0
15964,2012-2013,11,AFC Ajax,Vitesse,0,2,2,0,3,2,-2,6.0,10.0
15965,2012-2013,11,Willem II,FC Utrecht,1,5,2,0,3,6,-4,3.0,10.0
15966,2012-2013,11,PSV,Heracles Almelo,4,0,1,3,0,4,4,15.0,8.0
15967,2012-2013,11,FC Groningen,NEC Nijmegen,1,2,2,0,3,3,-1,4.0,8.0
15968,2012-2013,11,AZ Alkmaar,VVV-Venlo,1,2,2,0,3,3,-1,4.0,3.0
15969,2012-2013,11,sc Heerenveen,PEC Zwolle,2,1,1,3,0,3,1,10.0,6.0
15970,2012-2013,11,FC Twente,Feyenoord,3,0,1,3,0,3,3,10.0,8.0
15971,2012-2013,11,NAC Breda,RKC Waalwijk,2,1,1,3,0,3,1,6.0,1.0
15972,2012-2013,12,NAC Breda,FC Groningen,0,1,2,0,3,1,-1,6.0,4.0
15973,2012-2013,12,RKC Waalwijk,FC Utrecht,4,0,1,3,0,4,4,3.0,10.0
15974,2012-2013,12,VVV-Venlo,Willem II,4,1,1,3,0,5,3,6.0,3.0
15975,2012-2013,12,ADO Den Haag,AZ Alkmaar,2,2,3,1,1,4,0,6.0,4.0
15976,2012-2013,12,NEC Nijmegen,Heracles Almelo,3,2,1,3,0,5,1,11.0,7.0
15977,2012-2013,12,Vitesse,FC Twente,0,0,3,1,1,0,0,8.0,11.0
15978,2012-2013,12,Feyenoord,Roda JC Kerkrade,5,2,1,3,0,7,3,8.0,6.0
15979,2012-2013,12,PEC Zwolle,AFC Ajax,2,4,2,0,3,6,-2,3.0,6.0
15980,2012-2013,12,PSV,sc Heerenveen,5,1,1,3,0,6,4,15.0,7.0
15981,2012-2013,13,ADO Den Haag,PSV,1,6,2,0,3,7,-5,5.0,15.0
15982,2012-2013,13,sc Heerenveen,RKC Waalwijk,0,2,2,0,3,2,-2,6.0,6.0
15983,2012-2013,13,PEC Zwolle,NAC Breda,2,0,1,3,0,2,2,6.0,6.0
15984,2012-2013,13,AFC Ajax,VVV-Venlo,2,0,1,3,0,2,2,8.0,6.0
15985,2012-2013,13,FC Groningen,AZ Alkmaar,1,1,3,1,1,2,0,4.0,5.0
15986,2012-2013,13,Vitesse,NEC Nijmegen,4,1,1,3,0,5,3,10.0,10.0
15987,2012-2013,13,Feyenoord,Willem II,3,0,1,3,0,3,3,10.0,0.0
15988,2012-2013,13,FC Utrecht,FC Twente,1,1,3,1,1,2,0,10.0,9.0
15989,2012-2013,13,Heracles Almelo,Roda JC Kerkrade,5,1,1,3,0,6,4,7.0,3.0
15990,2012-2013,14,NAC Breda,ADO Den Haag,0,3,2,0,3,3,-3,6.0,8.0
15991,2012-2013,14,NEC Nijmegen,FC Utrecht,2,0,1,3,0,2,2,10.0,7.0
15992,2012-2013,14,RKC Waalwijk,FC Groningen,1,1,3,1,1,2,0,7.0,5.0
15993,2012-2013,14,VVV-Venlo,sc Heerenveen,1,1,3,1,1,2,0,7.0,4.0
15994,2012-2013,14,Willem II,Heracles Almelo,2,2,3,1,1,4,0,1.0,7.0
15995,2012-2013,14,Roda JC Kerkrade,AFC Ajax,1,2,2,0,3,3,-1,2.0,10.0
15996,2012-2013,14,PSV,Vitesse,1,2,2,0,3,3,-1,12.0,10.0
15997,2012-2013,14,AZ Alkmaar,Feyenoord,0,2,2,0,3,2,-2,5.0,10.0
15998,2012-2013,14,FC Twente,PEC Zwolle,2,2,3,1,1,4,0,9.0,4.0
15999,2012-2013,15,PEC Zwolle,VVV-Venlo,0,0,3,1,1,0,0,5.0,8.0
16000,2012-2013,15,FC Twente,ADO Den Haag,2,0,1,3,0,2,2,9.0,5.0
16001,2012-2013,15,Feyenoord,RKC Waalwijk,2,0,1,3,0,2,2,12.0,7.0
16002,2012-2013,15,Willem II,sc Heerenveen,3,1,1,3,0,4,2,4.0,4.0
16003,2012-2013,15,AFC Ajax,PSV,3,1,1,3,0,4,2,12.0,9.0
16004,2012-2013,15,NEC Nijmegen,NAC Breda,1,1,3,1,1,2,0,10.0,4.0
16005,2012-2013,15,FC Groningen,Heracles Almelo,2,0,1,3,0,2,2,8.0,4.0
16006,2012-2013,15,FC Utrecht,AZ Alkmaar,2,1,1,3,0,3,1,7.0,2.0
16007,2012-2013,15,Vitesse,Roda JC Kerkrade,3,0,1,3,0,3,3,13.0,1.0
16008,2012-2013,16,Heracles Almelo,FC Utrecht,1,1,3,1,1,2,0,5.0,5.0
16009,2012-2013,16,RKC Waalwijk,NEC Nijmegen,2,0,1,3,0,2,2,10.0,7.0
16010,2012-2013,16,ADO Den Haag,PEC Zwolle,1,1,3,1,1,2,0,5.0,6.0
16011,2012-2013,16,AZ Alkmaar,Willem II,0,0,3,1,1,0,0,3.0,5.0
16012,2012-2013,16,AFC Ajax,FC Groningen,2,0,1,3,0,2,2,15.0,8.0
16013,2012-2013,16,sc Heerenveen,Roda JC Kerkrade,4,4,3,1,1,8,0,2.0,1.0
16014,2012-2013,16,NAC Breda,Feyenoord,2,2,3,1,1,4,0,2.0,13.0
16015,2012-2013,16,VVV-Venlo,Vitesse,3,1,1,3,0,4,2,8.0,10.0
16016,2012-2013,16,PSV,FC Twente,3,0,1,3,0,3,3,9.0,6.0
16017,2012-2013,17,FC Twente,Heracles Almelo,3,2,1,3,0,5,1,8.0,5.0
16018,2012-2013,17,PEC Zwolle,AZ Alkmaar,1,2,2,0,3,3,-1,6.0,5.0
16019,2012-2013,17,FC Groningen,VVV-Venlo,0,0,3,1,1,0,0,6.0,6.0
16020,2012-2013,17,Roda JC Kerkrade,NAC Breda,0,0,3,1,1,0,0,2.0,3.0
16021,2012-2013,17,NEC Nijmegen,PSV,1,1,3,1,1,2,0,5.0,7.0
16022,2012-2013,17,FC Utrecht,sc Heerenveen,3,1,1,3,0,4,2,8.0,2.0
16023,2012-2013,17,Vitesse,RKC Waalwijk,2,2,3,1,1,4,0,10.0,8.0
16024,2012-2013,17,Feyenoord,ADO Den Haag,3,2,1,3,0,5,1,13.0,4.0
16025,2012-2013,17,Willem II,AFC Ajax,2,4,2,0,3,6,-2,5.0,15.0
16026,2012-2013,18,AZ Alkmaar,FC Twente,0,3,2,0,3,3,-3,4.0,10.0
16027,2012-2013,18,sc Heerenveen,Vitesse,2,1,1,3,0,3,1,5.0,7.0
16028,2012-2013,18,Heracles Almelo,PEC Zwolle,1,1,3,1,1,2,0,3.0,4.0
16029,2012-2013,18,ADO Den Haag,NEC Nijmegen,2,0,1,3,0,2,2,7.0,5.0
16030,2012-2013,18,NAC Breda,PSV,1,6,2,0,3,7,-5,3.0,7.0
16031,2012-2013,18,RKC Waalwijk,Willem II,0,0,3,1,1,0,0,6.0,6.0
16032,2012-2013,18,FC Utrecht,AFC Ajax,0,0,3,1,1,0,0,8.0,13.0
16033,2012-2013,18,Feyenoord,FC Groningen,2,1,1,3,0,3,1,13.0,5.0
16034,2012-2013,18,VVV-Venlo,Roda JC Kerkrade,2,4,2,0,3,6,-2,6.0,5.0
16035,2012-2013,19,PSV,PEC Zwolle,1,3,2,0,3,4,-2,7.0,6.0
16036,2012-2013,19,sc Heerenveen,Heracles Almelo,0,1,2,0,3,1,-1,4.0,5.0
16037,2012-2013,19,FC Twente,RKC Waalwijk,0,0,3,1,1,0,0,10.0,6.0
16038,2012-2013,19,NAC Breda,VVV-Venlo,1,0,1,3,0,1,1,6.0,5.0
16039,2012-2013,19,AZ Alkmaar,Vitesse,4,1,1,3,0,5,3,7.0,4.0
16040,2012-2013,19,FC Groningen,FC Utrecht,0,2,2,0,3,2,-2,4.0,11.0
16041,2012-2013,19,Willem II,ADO Den Haag,1,1,3,1,1,2,0,6.0,5.0
16042,2012-2013,19,AFC Ajax,Feyenoord,3,0,1,3,0,3,3,13.0,10.0
16043,2012-2013,19,Roda JC Kerkrade,NEC Nijmegen,2,0,1,3,0,2,2,8.0,2.0
16044,2012-2013,20,VVV-Venlo,AZ Alkmaar,1,4,2,0,3,5,-3,4.0,10.0
16045,2012-2013,20,PEC Zwolle,sc Heerenveen,1,1,3,1,1,2,0,6.0,5.0
16046,2012-2013,20,ADO Den Haag,Roda JC Kerkrade,2,2,3,1,1,4,0,6.0,9.0
16047,2012-2013,20,RKC Waalwijk,NAC Breda,0,4,2,0,3,4,-4,6.0,8.0
16048,2012-2013,20,Heracles Almelo,PSV,1,5,2,0,3,6,-4,5.0,10.0
16049,2012-2013,20,Vitesse,AFC Ajax,3,2,1,3,0,5,1,4.0,10.0
16050,2012-2013,20,Feyenoord,FC Twente,0,0,3,1,1,0,0,8.0,8.0
16051,2012-2013,20,FC Utrecht,Willem II,3,1,1,3,0,4,2,11.0,3.0
16052,2012-2013,20,NEC Nijmegen,FC Groningen,2,1,1,3,0,3,1,4.0,1.0
16053,2012-2013,21,RKC Waalwijk,sc Heerenveen,0,1,2,0,3,1,-1,3.0,7.0
16054,2012-2013,21,AZ Alkmaar,FC Groningen,0,1,2,0,3,1,-1,9.0,4.0
16055,2012-2013,21,Roda JC Kerkrade,Heracles Almelo,3,3,3,1,1,6,0,9.0,5.0
16056,2012-2013,21,NAC Breda,PEC Zwolle,3,0,1,3,0,3,3,10.0,5.0
16057,2012-2013,21,PSV,ADO Den Haag,7,0,1,3,0,7,7,10.0,5.0
16058,2012-2013,21,NEC Nijmegen,Vitesse,2,1,1,3,0,3,1,7.0,4.0
16059,2012-2013,21,VVV-Venlo,AFC Ajax,0,3,2,0,3,3,-3,1.0,10.0
16060,2012-2013,21,FC Twente,FC Utrecht,2,4,2,0,3,6,-2,8.0,13.0
16061,2012-2013,21,Willem II,Feyenoord,1,3,2,0,3,4,-2,2.0,10.0
16062,2012-2013,22,ADO Den Haag,NAC Breda,2,1,1,3,0,3,1,8.0,9.0
16063,2012-2013,22,FC Groningen,RKC Waalwijk,2,1,1,3,0,3,1,6.0,2.0
16064,2012-2013,22,Heracles Almelo,Willem II,4,1,1,3,0,5,3,8.0,2.0
16065,2012-2013,22,sc Heerenveen,VVV-Venlo,2,2,3,1,1,4,0,8.0,1.0
16066,2012-2013,22,Vitesse,PSV,2,2,3,1,1,4,0,4.0,10.0
16067,2012-2013,22,FC Utrecht,NEC Nijmegen,0,3,2,0,3,3,-3,10.0,9.0
16068,2012-2013,22,AFC Ajax,Roda JC Kerkrade,1,1,3,1,1,2,0,8.0,9.0
16069,2012-2013,22,Feyenoord,AZ Alkmaar,3,1,1,3,0,4,2,10.0,6.0
16070,2012-2013,22,PEC Zwolle,FC Twente,1,1,3,1,1,2,0,6.0,6.0
16071,2012-2013,23,NEC Nijmegen,VVV-Venlo,1,2,2,0,3,3,-1,9.0,4.0
16072,2012-2013,23,FC Twente,Willem II,1,1,3,1,1,2,0,4.0,2.0
16073,2012-2013,23,NAC Breda,Heracles Almelo,1,1,3,1,1,2,0,10.0,8.0
16074,2012-2013,23,Roda JC Kerkrade,AZ Alkmaar,2,2,3,1,1,4,0,7.0,7.0
16075,2012-2013,23,PSV,FC Utrecht,2,1,1,3,0,3,1,10.0,9.0
16076,2012-2013,23,Vitesse,FC Groningen,2,0,1,3,0,2,2,7.0,6.0
16077,2012-2013,23,PEC Zwolle,Feyenoord,3,2,1,3,0,5,1,8.0,7.0
16078,2012-2013,23,ADO Den Haag,sc Heerenveen,2,1,1,3,0,3,1,8.0,5.0
16079,2012-2013,23,RKC Waalwijk,AFC Ajax,0,2,2,0,3,2,-2,1.0,10.0
16080,2012-2013,24,Willem II,NEC Nijmegen,2,3,2,0,3,5,-1,1.0,12.0
16081,2012-2013,24,Heracles Almelo,Vitesse,3,5,2,0,3,8,-2,5.0,10.0
16082,2012-2013,24,FC Groningen,PEC Zwolle,1,0,1,3,0,1,1,9.0,5.0
16083,2012-2013,24,VVV-Venlo,RKC Waalwijk,1,0,1,3,0,1,1,7.0,0.0
16084,2012-2013,24,sc Heerenveen,FC Twente,2,1,1,3,0,3,1,8.0,3.0
16085,2012-2013,24,Feyenoord,PSV,2,1,1,3,0,3,1,10.0,10.0
16086,2012-2013,24,FC Utrecht,Roda JC Kerkrade,4,0,1,3,0,4,4,9.0,4.0
16087,2012-2013,24,AFC Ajax,ADO Den Haag,1,1,3,1,1,2,0,8.0,8.0
16088,2012-2013,24,AZ Alkmaar,NAC Breda,0,1,2,0,3,1,-1,4.0,10.0
16089,2012-2013,25,Vitesse,FC Utrecht,2,0,1,3,0,2,2,10.0,6.0
16090,2012-2013,25,NAC Breda,sc Heerenveen,1,2,2,0,3,3,-1,7.0,10.0
16091,2012-2013,25,PEC Zwolle,Willem II,2,0,1,3,0,2,2,7.0,1.0
16092,2012-2013,25,PSV,VVV-Venlo,2,0,1,3,0,2,2,10.0,7.0
16093,2012-2013,25,FC Twente,AFC Ajax,0,2,2,0,3,2,-2,2.0,11.0
16094,2012-2013,25,NEC Nijmegen,Feyenoord,0,3,2,0,3,3,-3,9.0,12.0
16095,2012-2013,25,RKC Waalwijk,AZ Alkmaar,2,1,1,3,0,3,1,3.0,1.0
16096,2012-2013,25,Roda JC Kerkrade,FC Groningen,4,1,1,3,0,5,3,6.0,9.0
16097,2012-2013,25,ADO Den Haag,Heracles Almelo,3,1,1,3,0,4,2,10.0,5.0
16098,2012-2013,26,FC Groningen,NAC Breda,1,1,3,1,1,2,0,7.0,5.0
16099,2012-2013,26,sc Heerenveen,PSV,2,1,1,3,0,3,1,10.0,7.0
16100,2012-2013,26,Heracles Almelo,NEC Nijmegen,1,0,1,3,0,1,1,7.0,6.0
16101,2012-2013,26,Willem II,VVV-Venlo,1,0,1,3,0,1,1,4.0,7.0
16102,2012-2013,26,AZ Alkmaar,ADO Den Haag,1,1,3,1,1,2,0,2.0,11.0
16103,2012-2013,26,Roda JC Kerkrade,Feyenoord,0,1,2,0,3,1,-1,5.0,12.0
16104,2012-2013,26,FC Utrecht,RKC Waalwijk,1,0,1,3,0,1,1,6.0,3.0
16105,2012-2013,26,AFC Ajax,PEC Zwolle,3,0,1,3,0,3,3,11.0,7.0
16106,2012-2013,26,FC Twente,Vitesse,0,1,2,0,3,1,-1,2.0,13.0
16107,2012-2013,27,PEC Zwolle,Roda JC Kerkrade,3,2,1,3,0,5,1,9.0,4.0
16108,2012-2013,27,NEC Nijmegen,sc Heerenveen,1,3,2,0,3,4,-2,3.0,12.0
16109,2012-2013,27,PSV,RKC Waalwijk,2,0,1,3,0,2,2,9.0,3.0
16110,2012-2013,27,VVV-Venlo,Heracles Almelo,0,2,2,0,3,2,-2,6.0,7.0
16111,2012-2013,27,ADO Den Haag,Vitesse,0,4,2,0,3,4,-4,8.0,15.0
16112,2012-2013,27,NAC Breda,Willem II,4,0,1,3,0,4,4,8.0,4.0
16113,2012-2013,27,Feyenoord,FC Utrecht,2,1,1,3,0,3,1,12.0,6.0
16114,2012-2013,27,AZ Alkmaar,AFC Ajax,2,3,2,0,3,5,-1,2.0,13.0
16115,2012-2013,27,FC Groningen,FC Twente,0,3,2,0,3,3,-3,4.0,4.0
16116,2012-2013,28,FC Twente,NAC Breda,1,1,3,1,1,2,0,4.0,8.0
16117,2012-2013,28,Willem II,FC Groningen,1,2,2,0,3,3,-1,3.0,7.0
16118,2012-2013,28,FC Utrecht,VVV-Venlo,2,1,1,3,0,3,1,9.0,3.0
16119,2012-2013,28,sc Heerenveen,Feyenoord,2,0,1,3,0,2,2,15.0,12.0
16120,2012-2013,28,Roda JC Kerkrade,PSV,2,2,3,1,1,4,0,4.0,7.0
16121,2012-2013,28,Vitesse,PEC Zwolle,2,1,1,3,0,3,1,15.0,6.0
16122,2012-2013,28,RKC Waalwijk,ADO Den Haag,4,0,1,3,0,4,4,6.0,5.0
16123,2012-2013,28,Heracles Almelo,AZ Alkmaar,1,2,2,0,3,3,-1,6.0,4.0
16124,2012-2013,28,AFC Ajax,NEC Nijmegen,4,1,1,3,0,5,3,13.0,3.0
16125,2012-2013,29,Feyenoord,VVV-Venlo,1,0,1,3,0,1,1,12.0,0.0
16126,2012-2013,29,Vitesse,NAC Breda,3,0,1,3,0,3,3,15.0,5.0
16127,2012-2013,29,PEC Zwolle,RKC Waalwijk,1,1,3,1,1,2,0,7.0,7.0
16128,2012-2013,29,FC Twente,Roda JC Kerkrade,2,0,1,3,0,2,2,7.0,4.0
16129,2012-2013,29,Willem II,PSV,1,3,2,0,3,4,-2,3.0,10.0
16130,2012-2013,29,FC Utrecht,ADO Den Haag,1,0,1,3,0,1,1,9.0,4.0
16131,2012-2013,29,FC Groningen,sc Heerenveen,3,1,1,3,0,4,2,7.0,12.0
16132,2012-2013,29,NEC Nijmegen,AZ Alkmaar,1,1,3,1,1,2,0,1.0,5.0
16133,2012-2013,29,AFC Ajax,Heracles Almelo,4,0,1,3,0,4,4,15.0,6.0
16134,2012-2013,30,VVV-Venlo,PEC Zwolle,0,2,2,0,3,2,-2,0.0,7.0
16135,2012-2013,30,Roda JC Kerkrade,Vitesse,3,3,3,1,1,6,0,2.0,13.0
16136,2012-2013,30,NAC Breda,NEC Nijmegen,2,0,1,3,0,2,2,8.0,1.0
16137,2012-2013,30,Heracles Almelo,FC Groningen,0,2,2,0,3,2,-2,6.0,10.0
16138,2012-2013,30,ADO Den Haag,FC Twente,1,3,2,0,3,4,-2,1.0,10.0
16139,2012-2013,30,sc Heerenveen,Willem II,3,2,1,3,0,5,1,12.0,3.0
16140,2012-2013,30,AZ Alkmaar,FC Utrecht,6,0,1,3,0,6,6,8.0,9.0
16141,2012-2013,30,RKC Waalwijk,Feyenoord,1,1,3,1,1,2,0,5.0,10.0
16142,2012-2013,30,PSV,AFC Ajax,2,3,2,0,3,5,-1,7.0,15.0
16143,2012-2013,31,AFC Ajax,sc Heerenveen,1,1,3,1,1,2,0,13.0,10.0
16144,2012-2013,31,FC Groningen,ADO Den Haag,2,1,1,3,0,3,1,12.0,0.0
16145,2012-2013,31,Heracles Almelo,RKC Waalwijk,4,0,1,3,0,4,4,6.0,5.0
16146,2012-2013,31,Willem II,Roda JC Kerkrade,2,1,1,3,0,3,1,3.0,2.0
16147,2012-2013,31,AZ Alkmaar,PSV,1,3,2,0,3,4,-2,7.0,10.0
16148,2012-2013,31,VVV-Venlo,FC Twente,2,2,3,1,1,4,0,1.0,11.0
16149,2012-2013,31,FC Utrecht,NAC Breda,3,0,1,3,0,3,3,9.0,7.0
16150,2012-2013,31,NEC Nijmegen,PEC Zwolle,1,3,2,0,3,4,-2,1.0,10.0
16151,2012-2013,31,Feyenoord,Vitesse,2,0,1,3,0,2,2,10.0,10.0
16152,2012-2013,32,sc Heerenveen,AZ Alkmaar,0,4,2,0,3,4,-4,7.0,10.0
16153,2012-2013,32,PSV,FC Groningen,5,2,1,3,0,7,3,10.0,12.0
16154,2012-2013,32,ADO Den Haag,VVV-Venlo,1,1,3,1,1,2,0,1.0,2.0
16155,2012-2013,32,Roda JC Kerkrade,RKC Waalwijk,3,1,1,3,0,4,2,5.0,5.0
16156,2012-2013,32,NAC Breda,AFC Ajax,0,2,2,0,3,2,-2,4.0,13.0
16157,2012-2013,32,FC Twente,NEC Nijmegen,5,2,1,3,0,7,3,11.0,1.0
16158,2012-2013,32,Feyenoord,Heracles Almelo,6,0,1,3,0,6,6,10.0,3.0
16159,2012-2013,32,PEC Zwolle,FC Utrecht,1,2,2,0,3,3,-1,7.0,12.0
16160,2012-2013,32,Vitesse,Willem II,3,1,1,3,0,4,2,10.0,3.0
16161,2012-2013,33,AFC Ajax,Willem II,5,0,1,3,0,5,5,13.0,3.0
16162,2012-2013,33,ADO Den Haag,Feyenoord,2,0,1,3,0,2,2,4.0,10.0
16163,2012-2013,33,PSV,NEC Nijmegen,4,2,1,3,0,6,2,12.0,1.0
16164,2012-2013,33,RKC Waalwijk,Vitesse,3,2,1,3,0,5,1,5.0,7.0
16165,2012-2013,33,AZ Alkmaar,PEC Zwolle,4,0,1,3,0,4,4,10.0,7.0
16166,2012-2013,33,VVV-Venlo,FC Groningen,0,0,3,1,1,0,0,3.0,10.0
16167,2012-2013,33,sc Heerenveen,FC Utrecht,2,4,2,0,3,6,-2,4.0,12.0
16168,2012-2013,33,Heracles Almelo,FC Twente,1,1,3,1,1,2,0,4.0,11.0
16169,2012-2013,33,NAC Breda,Roda JC Kerkrade,5,3,1,3,0,8,2,6.0,4.0
16170,2012-2013,34,Roda JC Kerkrade,sc Heerenveen,1,0,1,3,0,1,1,7.0,4.0
16171,2012-2013,34,Vitesse,VVV-Venlo,0,1,2,0,3,1,-1,4.0,6.0
16172,2012-2013,34,Willem II,AZ Alkmaar,2,0,1,3,0,2,2,6.0,9.0
16173,2012-2013,34,PEC Zwolle,ADO Den Haag,4,2,1,3,0,6,2,9.0,4.0
16174,2012-2013,34,Feyenoord,NAC Breda,1,0,1,3,0,1,1,10.0,6.0
16175,2012-2013,34,FC Groningen,AFC Ajax,0,2,2,0,3,2,-2,7.0,13.0
16176,2012-2013,34,FC Twente,PSV,3,1,1,3,0,4,2,11.0,9.0
16177,2012-2013,34,FC Utrecht,Heracles Almelo,3,0,1,3,0,3,3,12.0,4.0
16178,2012-2013,34,NEC Nijmegen,RKC Waalwijk,1,2,2,0,3,3,-1,0.0,7.0
16179,2013-2014,1,AFC Ajax,Roda JC Kerkrade,3,0,1,3,0,3,3,13.0,6.0
16180,2013-2014,1,ADO Den Haag,PSV,2,3,2,0,3,5,-1,4.0,12.0
16181,2013-2014,1,NEC Nijmegen,FC Groningen,1,4,2,0,3,5,-3,0.0,7.0
16182,2013-2014,1,FC Twente,RKC Waalwijk,0,0,3,1,1,0,0,9.0,7.0
16183,2013-2014,1,sc Heerenveen,AZ Alkmaar,4,2,1,3,0,6,2,4.0,6.0
16184,2013-2014,1,SC Cambuur,NAC Breda,0,0,3,1,1,0,0,10.0,4.0
16185,2013-2014,1,FC Utrecht,Go Ahead Eagles,1,1,3,1,1,2,0,13.0,1.0
16186,2013-2014,1,Vitesse,Heracles Almelo,3,1,1,3,0,4,2,6.0,4.0
16187,2013-2014,1,PEC Zwolle,Feyenoord,2,1,1,3,0,3,1,9.0,9.0
16188,2013-2014,2,Roda JC Kerkrade,SC Cambuur,2,0,1,3,0,2,2,9.0,7.0
16189,2013-2014,2,Heracles Almelo,PEC Zwolle,1,3,2,0,3,4,-2,1.0,9.0
16190,2013-2014,2,NAC Breda,sc Heerenveen,0,2,2,0,3,2,-2,4.0,6.0
16191,2013-2014,2,Go Ahead Eagles,ADO Den Haag,2,1,1,3,0,3,1,4.0,4.0
16192,2013-2014,2,PSV,NEC Nijmegen,5,0,1,3,0,5,5,12.0,0.0
16193,2013-2014,2,Feyenoord,FC Twente,1,4,2,0,3,5,-3,6.0,11.0
16194,2013-2014,2,AZ Alkmaar,AFC Ajax,3,2,1,3,0,5,1,9.0,12.0
16195,2013-2014,2,FC Groningen,FC Utrecht,2,0,1,3,0,2,2,7.0,10.0
16196,2013-2014,2,RKC Waalwijk,Vitesse,4,2,1,3,0,6,2,10.0,6.0
16197,2013-2014,3,PSV,Go Ahead Eagles,3,0,1,3,0,3,3,12.0,4.0
16198,2013-2014,3,SC Cambuur,FC Groningen,4,1,1,3,0,5,3,10.0,7.0
16199,2013-2014,3,RKC Waalwijk,AZ Alkmaar,1,2,2,0,3,3,-1,10.0,9.0
16200,2013-2014,3,NEC Nijmegen,PEC Zwolle,1,5,2,0,3,6,-4,0.0,12.0
16201,2013-2014,3,Roda JC Kerkrade,Vitesse,1,1,3,1,1,2,0,7.0,4.0
16202,2013-2014,3,AFC Ajax,Feyenoord,2,1,1,3,0,3,1,12.0,3.0
16203,2013-2014,3,sc Heerenveen,Heracles Almelo,2,4,2,0,3,6,-2,6.0,4.0
16204,2013-2014,3,NAC Breda,ADO Den Haag,1,2,2,0,3,3,-1,4.0,6.0
16205,2013-2014,3,FC Twente,FC Utrecht,6,0,1,3,0,6,6,11.0,7.0
16206,2013-2014,4,sc Heerenveen,AFC Ajax,3,3,3,1,1,6,0,7.0,10.0
16207,2013-2014,4,NEC Nijmegen,RKC Waalwijk,2,2,3,1,1,4,0,1.0,8.0
16208,2013-2014,4,Heracles Almelo,PSV,1,1,3,1,1,2,0,4.0,10.0
16209,2013-2014,4,ADO Den Haag,Roda JC Kerkrade,0,4,2,0,3,4,-4,3.0,10.0
16210,2013-2014,4,PEC Zwolle,SC Cambuur,2,0,1,3,0,2,2,15.0,7.0
16211,2013-2014,4,Go Ahead Eagles,FC Groningen,3,3,3,1,1,6,0,5.0,7.0
16212,2013-2014,4,Feyenoord,NAC Breda,3,1,1,3,0,4,2,6.0,1.0
16213,2013-2014,4,Vitesse,FC Twente,1,0,1,3,0,1,1,7.0,10.0
16214,2013-2014,4,FC Utrecht,AZ Alkmaar,2,0,1,3,0,2,2,7.0,6.0
16215,2013-2014,5,NAC Breda,NEC Nijmegen,1,1,3,1,1,2,0,2.0,2.0
16216,2013-2014,5,FC Twente,sc Heerenveen,1,1,3,1,1,2,0,8.0,8.0
16217,2013-2014,5,Heracles Almelo,ADO Den Haag,1,0,1,3,0,1,1,7.0,3.0
16218,2013-2014,5,RKC Waalwijk,Go Ahead Eagles,1,4,2,0,3,5,-3,5.0,8.0
16219,2013-2014,5,PSV,SC Cambuur,0,0,3,1,1,0,0,11.0,5.0
16220,2013-2014,5,FC Groningen,AFC Ajax,1,1,3,1,1,2,0,8.0,8.0
16221,2013-2014,5,PEC Zwolle,FC Utrecht,1,1,3,1,1,2,0,13.0,5.0
16222,2013-2014,5,AZ Alkmaar,Vitesse,1,1,3,1,1,2,0,7.0,8.0
16223,2013-2014,5,Feyenoord,Roda JC Kerkrade,4,0,1,3,0,4,4,6.0,7.0
16224,2013-2014,6,AFC Ajax,PEC Zwolle,2,1,1,3,0,3,1,8.0,10.0
16225,2013-2014,6,SC Cambuur,Heracles Almelo,2,0,1,3,0,2,2,7.0,7.0
16226,2013-2014,6,FC Twente,PSV,2,2,3,1,1,4,0,8.0,9.0
16227,2013-2014,6,NEC Nijmegen,Feyenoord,3,3,3,1,1,6,0,3.0,7.0
16228,2013-2014,6,Roda JC Kerkrade,NAC Breda,1,5,2,0,3,6,-4,7.0,4.0
16229,2013-2014,6,AZ Alkmaar,Go Ahead Eagles,3,0,1,3,0,3,3,10.0,7.0
16230,2013-2014,6,sc Heerenveen,FC Groningen,4,2,1,3,0,6,2,8.0,5.0
16231,2013-2014,6,FC Utrecht,RKC Waalwijk,2,1,1,3,0,3,1,7.0,4.0
16232,2013-2014,6,ADO Den Haag,Vitesse,2,1,1,3,0,3,1,6.0,5.0
16233,2013-2014,7,Go Ahead Eagles,SC Cambuur,0,0,3,1,1,0,0,5.0,8.0
16234,2013-2014,7,Heracles Almelo,FC Twente,0,3,2,0,3,3,-3,7.0,8.0
16235,2013-2014,7,FC Groningen,RKC Waalwijk,4,1,1,3,0,5,3,5.0,1.0
16236,2013-2014,7,ADO Den Haag,NEC Nijmegen,1,1,3,1,1,2,0,7.0,4.0
16237,2013-2014,7,Roda JC Kerkrade,sc Heerenveen,3,3,3,1,1,6,0,5.0,6.0
16238,2013-2014,7,Vitesse,PEC Zwolle,3,0,1,3,0,3,3,8.0,7.0
16239,2013-2014,7,Feyenoord,FC Utrecht,1,0,1,3,0,1,1,10.0,7.0
16240,2013-2014,7,NAC Breda,AZ Alkmaar,3,0,1,3,0,3,3,7.0,7.0
16241,2013-2014,7,PSV,AFC Ajax,4,0,1,3,0,4,4,9.0,8.0
16242,2013-2014,8,AZ Alkmaar,PSV,2,1,1,3,0,3,1,7.0,6.0
16243,2013-2014,8,RKC Waalwijk,Heracles Almelo,1,4,2,0,3,5,-3,1.0,7.0
16244,2013-2014,8,FC Utrecht,Roda JC Kerkrade,3,3,3,1,1,6,0,8.0,5.0
16245,2013-2014,8,PEC Zwolle,NAC Breda,0,0,3,1,1,0,0,5.0,8.0
16246,2013-2014,8,AFC Ajax,Go Ahead Eagles,6,0,1,3,0,6,6,8.0,5.0
16247,2013-2014,8,NEC Nijmegen,Vitesse,2,3,2,0,3,5,-1,4.0,10.0
16248,2013-2014,8,sc Heerenveen,SC Cambuur,2,1,1,3,0,3,1,9.0,5.0
16249,2013-2014,8,Feyenoord,ADO Den Haag,4,2,1,3,0,6,2,13.0,4.0
16250,2013-2014,8,FC Twente,FC Groningen,5,0,1,3,0,5,5,8.0,5.0
16251,2013-2014,9,SC Cambuur,FC Twente,0,1,2,0,3,1,-1,5.0,11.0
16252,2013-2014,9,Roda JC Kerkrade,PEC Zwolle,0,0,3,1,1,0,0,3.0,3.0
16253,2013-2014,9,Go Ahead Eagles,NEC Nijmegen,4,3,1,3,0,7,1,7.0,3.0
16254,2013-2014,9,NAC Breda,Heracles Almelo,2,1,1,3,0,3,1,11.0,6.0
16255,2013-2014,9,AFC Ajax,FC Utrecht,3,0,1,3,0,3,3,10.0,5.0
16256,2013-2014,9,Vitesse,Feyenoord,1,2,2,0,3,3,-1,7.0,13.0
16257,2013-2014,9,FC Groningen,AZ Alkmaar,2,1,1,3,0,3,1,7.0,7.0
16258,2013-2014,9,PSV,RKC Waalwijk,2,1,1,3,0,3,1,8.0,0.0
16259,2013-2014,9,ADO Den Haag,sc Heerenveen,1,1,3,1,1,2,0,5.0,9.0
16260,2013-2014,10,Go Ahead Eagles,Feyenoord,2,2,3,1,1,4,0,5.0,11.0
16261,2013-2014,10,RKC Waalwijk,Roda JC Kerkrade,1,2,2,0,3,3,-1,0.0,6.0
16262,2013-2014,10,FC Utrecht,NAC Breda,4,2,1,3,0,6,2,7.0,10.0
16263,2013-2014,10,FC Twente,AFC Ajax,1,1,3,1,1,2,0,11.0,10.0
16264,2013-2014,10,sc Heerenveen,Vitesse,2,3,2,0,3,5,-1,8.0,9.0
16265,2013-2014,10,Heracles Almelo,NEC Nijmegen,1,1,3,1,1,2,0,4.0,3.0
16266,2013-2014,10,FC Groningen,PSV,1,0,1,3,0,1,1,9.0,7.0
16267,2013-2014,10,PEC Zwolle,ADO Den Haag,6,1,1,3,0,7,5,5.0,5.0
16268,2013-2014,10,AZ Alkmaar,SC Cambuur,3,1,1,3,0,4,2,9.0,4.0
16269,2013-2014,11,NEC Nijmegen,sc Heerenveen,2,1,1,3,0,3,1,5.0,5.0
16270,2013-2014,11,ADO Den Haag,FC Twente,3,2,1,3,0,5,1,5.0,10.0
16271,2013-2014,11,SC Cambuur,FC Utrecht,3,1,1,3,0,4,2,4.0,4.0
16272,2013-2014,11,NAC Breda,Go Ahead Eagles,5,0,1,3,0,5,5,10.0,5.0
16273,2013-2014,11,AFC Ajax,RKC Waalwijk,0,0,3,1,1,0,0,8.0,1.0
16274,2013-2014,11,Roda JC Kerkrade,PSV,2,1,1,3,0,3,1,9.0,6.0
16275,2013-2014,11,Feyenoord,Heracles Almelo,1,2,2,0,3,3,-1,10.0,7.0
16276,2013-2014,11,PEC Zwolle,AZ Alkmaar,0,2,2,0,3,2,-2,5.0,9.0
16277,2013-2014,11,Vitesse,FC Groningen,2,2,3,1,1,4,0,10.0,10.0
16278,2013-2014,12,RKC Waalwijk,NAC Breda,3,0,1,3,0,3,3,4.0,7.0
16279,2013-2014,12,AFC Ajax,Vitesse,0,1,2,0,3,1,-1,8.0,10.0
16280,2013-2014,12,AZ Alkmaar,ADO Den Haag,2,0,1,3,0,2,2,12.0,4.0
16281,2013-2014,12,FC Twente,NEC Nijmegen,2,2,3,1,1,4,0,8.0,5.0
16282,2013-2014,12,PSV,PEC Zwolle,1,1,3,1,1,2,0,4.0,6.0
16283,2013-2014,12,FC Groningen,Roda JC Kerkrade,3,3,3,1,1,6,0,8.0,9.0
16284,2013-2014,12,SC Cambuur,Feyenoord,0,2,2,0,3,2,-2,3.0,10.0
16285,2013-2014,12,FC Utrecht,sc Heerenveen,2,0,1,3,0,2,2,7.0,4.0
16286,2013-2014,12,Go Ahead Eagles,Heracles Almelo,1,1,3,1,1,2,0,5.0,8.0
16287,2013-2014,13,sc Heerenveen,RKC Waalwijk,5,2,1,3,0,7,3,4.0,4.0
16288,2013-2014,13,Roda JC Kerkrade,Go Ahead Eagles,1,4,2,0,3,5,-3,8.0,8.0
16289,2013-2014,13,Heracles Almelo,FC Groningen,0,3,2,0,3,3,-3,5.0,11.0
16290,2013-2014,13,Vitesse,FC Utrecht,3,1,1,3,0,4,2,10.0,6.0
16291,2013-2014,13,ADO Den Haag,SC Cambuur,3,0,1,3,0,3,3,7.0,3.0
16292,2013-2014,13,PEC Zwolle,FC Twente,1,1,3,1,1,2,0,6.0,6.0
16293,2013-2014,13,NAC Breda,PSV,2,1,1,3,0,3,1,9.0,4.0
16294,2013-2014,13,NEC Nijmegen,AFC Ajax,0,3,2,0,3,3,-3,5.0,8.0
16295,2013-2014,13,Feyenoord,AZ Alkmaar,2,2,3,1,1,4,0,8.0,10.0
16296,2013-2014,14,PSV,sc Heerenveen,1,1,3,1,1,2,0,2.0,4.0
16297,2013-2014,14,SC Cambuur,NEC Nijmegen,2,1,1,3,0,3,1,6.0,5.0
16298,2013-2014,14,AZ Alkmaar,Roda JC Kerkrade,2,2,3,1,1,4,0,11.0,8.0
16299,2013-2014,14,AFC Ajax,Heracles Almelo,3,0,1,3,0,3,3,8.0,5.0
16300,2013-2014,14,RKC Waalwijk,Feyenoord,1,0,1,3,0,1,1,7.0,5.0
16301,2013-2014,14,FC Utrecht,ADO Den Haag,3,0,1,3,0,3,3,9.0,6.0
16302,2013-2014,14,Go Ahead Eagles,Vitesse,0,3,2,0,3,3,-3,5.0,13.0
16303,2013-2014,14,FC Groningen,PEC Zwolle,0,0,3,1,1,0,0,9.0,6.0
16304,2013-2014,14,FC Twente,NAC Breda,5,2,1,3,0,7,3,6.0,6.0
16305,2013-2014,15,Roda JC Kerkrade,FC Twente,1,2,2,0,3,3,-1,5.0,8.0
16306,2013-2014,15,PEC Zwolle,RKC Waalwijk,1,1,3,1,1,2,0,4.0,8.0
16307,2013-2014,15,sc Heerenveen,Go Ahead Eagles,3,1,1,3,0,4,2,7.0,4.0
16308,2013-2014,15,NAC Breda,FC Groningen,2,2,3,1,1,4,0,7.0,7.0
16309,2013-2014,15,Heracles Almelo,FC Utrecht,1,2,2,0,3,3,-1,4.0,9.0
16310,2013-2014,15,ADO Den Haag,AFC Ajax,0,4,2,0,3,4,-4,6.0,10.0
16311,2013-2014,15,Feyenoord,PSV,3,1,1,3,0,4,2,7.0,2.0
16312,2013-2014,15,Vitesse,SC Cambuur,3,0,1,3,0,3,3,13.0,6.0
16313,2013-2014,15,NEC Nijmegen,AZ Alkmaar,3,2,1,3,0,5,1,7.0,8.0
16314,2013-2014,16,FC Utrecht,NEC Nijmegen,2,0,1,3,0,2,2,12.0,4.0
16315,2013-2014,16,AFC Ajax,NAC Breda,4,0,1,3,0,4,4,12.0,4.0
16316,2013-2014,16,AZ Alkmaar,FC Twente,1,2,2,0,3,3,-1,5.0,11.0
16317,2013-2014,16,RKC Waalwijk,SC Cambuur,2,2,3,1,1,4,0,8.0,4.0
16318,2013-2014,16,PSV,Vitesse,2,6,2,0,3,8,-4,2.0,15.0
16319,2013-2014,16,sc Heerenveen,Feyenoord,1,2,2,0,3,3,-1,7.0,10.0
16320,2013-2014,16,Go Ahead Eagles,PEC Zwolle,4,1,1,3,0,5,3,7.0,4.0
16321,2013-2014,16,FC Groningen,ADO Den Haag,1,2,2,0,3,3,-1,6.0,6.0
16322,2013-2014,16,Roda JC Kerkrade,Heracles Almelo,1,3,2,0,3,4,-2,2.0,4.0
16323,2013-2014,17,PEC Zwolle,sc Heerenveen,1,2,2,0,3,3,-1,3.0,10.0
16324,2013-2014,17,NEC Nijmegen,Roda JC Kerkrade,4,3,1,3,0,7,1,6.0,1.0
16325,2013-2014,17,ADO Den Haag,RKC Waalwijk,1,2,2,0,3,3,-1,6.0,8.0
16326,2013-2014,17,FC Twente,Go Ahead Eagles,3,1,1,3,0,4,2,13.0,6.0
16327,2013-2014,17,SC Cambuur,AFC Ajax,1,2,2,0,3,3,-1,4.0,15.0
16328,2013-2014,17,Vitesse,NAC Breda,3,2,1,3,0,5,1,15.0,4.0
16329,2013-2014,17,Feyenoord,FC Groningen,1,0,1,3,0,1,1,10.0,5.0
16330,2013-2014,17,Heracles Almelo,AZ Alkmaar,2,0,1,3,0,2,2,6.0,2.0
16331,2013-2014,17,FC Utrecht,PSV,1,5,2,0,3,6,-4,9.0,4.0
16332,2013-2014,18,RKC Waalwijk,FC Twente,1,1,3,1,1,2,0,9.0,13.0
16333,2013-2014,18,AZ Alkmaar,sc Heerenveen,1,5,2,0,3,6,-4,1.0,10.0
16334,2013-2014,18,Heracles Almelo,Vitesse,2,2,3,1,1,4,0,7.0,13.0
16335,2013-2014,18,NAC Breda,SC Cambuur,1,0,1,3,0,1,1,4.0,4.0
16336,2013-2014,18,Feyenoord,PEC Zwolle,3,0,1,3,0,3,3,12.0,2.0
16337,2013-2014,18,Roda JC Kerkrade,AFC Ajax,1,2,2,0,3,3,-1,1.0,15.0
16338,2013-2014,18,FC Groningen,NEC Nijmegen,5,2,1,3,0,7,3,5.0,6.0
16339,2013-2014,18,Go Ahead Eagles,FC Utrecht,2,1,1,3,0,3,1,6.0,9.0
16340,2013-2014,18,PSV,ADO Den Haag,2,0,1,3,0,2,2,7.0,3.0
16341,2013-2014,19,FC Twente,Heracles Almelo,3,1,1,3,0,4,2,13.0,7.0
16342,2013-2014,19,AZ Alkmaar,NAC Breda,3,0,1,3,0,3,3,3.0,4.0
16343,2013-2014,19,RKC Waalwijk,FC Groningen,1,1,3,1,1,2,0,7.0,5.0
16344,2013-2014,19,PEC Zwolle,Vitesse,1,2,2,0,3,3,-1,1.0,13.0
16345,2013-2014,19,sc Heerenveen,Roda JC Kerkrade,2,2,3,1,1,4,0,10.0,1.0
16346,2013-2014,19,NEC Nijmegen,ADO Den Haag,3,1,1,3,0,4,2,9.0,3.0
16347,2013-2014,19,SC Cambuur,Go Ahead Eagles,2,0,1,3,0,2,2,4.0,6.0
16348,2013-2014,19,FC Utrecht,Feyenoord,2,5,2,0,3,7,-3,6.0,15.0
16349,2013-2014,19,AFC Ajax,PSV,1,0,1,3,0,1,1,15.0,6.0
16350,2013-2014,20,Heracles Almelo,RKC Waalwijk,2,1,1,3,0,3,1,10.0,6.0
16351,2013-2014,20,ADO Den Haag,Feyenoord,3,2,1,3,0,5,1,6.0,12.0
16352,2013-2014,20,NAC Breda,PEC Zwolle,1,2,2,0,3,3,-1,3.0,3.0
16353,2013-2014,20,Roda JC Kerkrade,FC Utrecht,1,0,1,3,0,1,1,4.0,3.0
16354,2013-2014,20,PSV,AZ Alkmaar,1,0,1,3,0,1,1,9.0,3.0
16355,2013-2014,20,SC Cambuur,sc Heerenveen,3,1,1,3,0,4,2,7.0,7.0
16356,2013-2014,20,Vitesse,NEC Nijmegen,1,1,3,1,1,2,0,11.0,7.0
16357,2013-2014,20,Go Ahead Eagles,AFC Ajax,0,1,2,0,3,1,-1,6.0,15.0
16358,2013-2014,20,FC Groningen,FC Twente,1,1,3,1,1,2,0,5.0,11.0
16359,2013-2014,21,Feyenoord,Vitesse,1,1,3,1,1,2,0,10.0,9.0
16360,2013-2014,21,sc Heerenveen,ADO Den Haag,3,0,1,3,0,3,3,10.0,3.0
16361,2013-2014,21,PEC Zwolle,Roda JC Kerkrade,3,1,1,3,0,4,2,6.0,4.0
16362,2013-2014,21,Heracles Almelo,NAC Breda,1,2,2,0,3,3,-1,7.0,6.0
16363,2013-2014,21,AZ Alkmaar,FC Groningen,2,0,1,3,0,2,2,6.0,5.0
16364,2013-2014,21,FC Utrecht,AFC Ajax,1,1,3,1,1,2,0,1.0,13.0
16365,2013-2014,21,FC Twente,SC Cambuur,3,1,1,3,0,4,2,11.0,6.0
16366,2013-2014,21,NEC Nijmegen,Go Ahead Eagles,1,1,3,1,1,2,0,8.0,4.0
16367,2013-2014,21,RKC Waalwijk,PSV,2,0,1,3,0,2,2,8.0,9.0
16368,2013-2014,22,Roda JC Kerkrade,Feyenoord,1,2,2,0,3,3,-1,4.0,10.0
16369,2013-2014,22,ADO Den Haag,Heracles Almelo,0,3,2,0,3,3,-3,3.0,7.0
16370,2013-2014,22,Vitesse,AZ Alkmaar,0,2,2,0,3,2,-2,6.0,9.0
16371,2013-2014,22,SC Cambuur,PSV,1,2,2,0,3,3,-1,6.0,9.0
16372,2013-2014,22,Go Ahead Eagles,RKC Waalwijk,2,2,3,1,1,4,0,5.0,6.0
16373,2013-2014,22,NEC Nijmegen,NAC Breda,1,1,3,1,1,2,0,6.0,7.0
16374,2013-2014,22,sc Heerenveen,FC Twente,0,2,2,0,3,2,-2,7.0,11.0
16375,2013-2014,22,FC Utrecht,PEC Zwolle,1,2,2,0,3,3,-1,1.0,9.0
16376,2013-2014,22,AFC Ajax,FC Groningen,2,1,1,3,0,3,1,13.0,5.0
16377,2013-2014,23,Vitesse,ADO Den Haag,0,0,3,1,1,0,0,6.0,4.0
16378,2013-2014,23,PSV,FC Twente,3,2,1,3,0,5,1,9.0,10.0
16379,2013-2014,23,NAC Breda,Roda JC Kerkrade,2,0,1,3,0,2,2,7.0,4.0
16380,2013-2014,23,Go Ahead Eagles,AZ Alkmaar,2,1,1,3,0,3,1,5.0,9.0
16381,2013-2014,23,Feyenoord,NEC Nijmegen,5,1,1,3,0,6,4,10.0,6.0
16382,2013-2014,23,Heracles Almelo,SC Cambuur,1,1,3,1,1,2,0,7.0,7.0
16383,2013-2014,23,PEC Zwolle,AFC Ajax,1,1,3,1,1,2,0,10.0,11.0
16384,2013-2014,23,RKC Waalwijk,FC Utrecht,5,2,1,3,0,7,3,8.0,1.0
16385,2013-2014,23,FC Groningen,sc Heerenveen,1,3,2,0,3,4,-2,2.0,7.0
16386,2013-2014,24,PSV,Heracles Almelo,2,1,1,3,0,3,1,12.0,7.0
16387,2013-2014,24,FC Twente,Vitesse,2,0,1,3,0,2,2,10.0,3.0
16388,2013-2014,24,RKC Waalwijk,NEC Nijmegen,1,3,2,0,3,4,-2,7.0,6.0
16389,2013-2014,24,Roda JC Kerkrade,ADO Den Haag,0,1,2,0,3,1,-1,3.0,7.0
16390,2013-2014,24,AZ Alkmaar,FC Utrecht,1,1,3,1,1,2,0,7.0,2.0
16391,2013-2014,24,SC Cambuur,PEC Zwolle,3,1,1,3,0,4,2,7.0,10.0
16392,2013-2014,24,NAC Breda,Feyenoord,1,1,3,1,1,2,0,8.0,8.0
16393,2013-2014,24,FC Groningen,Go Ahead Eagles,1,0,1,3,0,1,1,4.0,5.0
16394,2013-2014,24,AFC Ajax,sc Heerenveen,3,0,1,3,0,3,3,11.0,6.0
16395,2013-2014,25,ADO Den Haag,Go Ahead Eagles,3,2,1,3,0,5,1,7.0,5.0
16396,2013-2014,25,sc Heerenveen,NAC Breda,0,0,3,1,1,0,0,7.0,9.0
16397,2013-2014,25,SC Cambuur,Roda JC Kerkrade,1,0,1,3,0,1,1,7.0,0.0
16398,2013-2014,25,PEC Zwolle,Heracles Almelo,1,1,3,1,1,2,0,8.0,5.0
16399,2013-2014,25,NEC Nijmegen,PSV,0,2,2,0,3,2,-2,5.0,12.0
16400,2013-2014,25,FC Utrecht,FC Groningen,1,0,1,3,0,1,1,5.0,3.0
16401,2013-2014,25,AFC Ajax,AZ Alkmaar,4,0,1,3,0,4,4,11.0,7.0
16402,2013-2014,25,Vitesse,RKC Waalwijk,3,1,1,3,0,4,2,5.0,7.0
16403,2013-2014,25,FC Twente,Feyenoord,2,2,3,1,1,4,0,10.0,9.0
16404,2013-2014,26,Heracles Almelo,sc Heerenveen,1,2,2,0,3,3,-1,5.0,7.0
16405,2013-2014,26,PEC Zwolle,NEC Nijmegen,3,3,3,1,1,6,0,6.0,5.0
16406,2013-2014,26,ADO Den Haag,NAC Breda,1,1,3,1,1,2,0,8.0,7.0
16407,2013-2014,26,Go Ahead Eagles,PSV,2,3,2,0,3,5,-1,4.0,15.0
16408,2013-2014,26,Vitesse,Roda JC Kerkrade,3,0,1,3,0,3,3,7.0,0.0
16409,2013-2014,26,FC Utrecht,FC Twente,1,1,3,1,1,2,0,5.0,8.0
16410,2013-2014,26,Feyenoord,AFC Ajax,1,2,2,0,3,3,-1,8.0,13.0
16411,2013-2014,26,FC Groningen,SC Cambuur,1,1,3,1,1,2,0,4.0,8.0
16412,2013-2014,26,AZ Alkmaar,RKC Waalwijk,4,0,1,3,0,4,4,7.0,4.0
16413,2013-2014,27,AZ Alkmaar,Heracles Almelo,4,0,1,3,0,4,4,7.0,2.0
16414,2013-2014,27,Roda JC Kerkrade,NEC Nijmegen,3,1,1,3,0,4,2,3.0,4.0
16415,2013-2014,27,sc Heerenveen,PEC Zwolle,3,0,1,3,0,3,3,10.0,3.0
16416,2013-2014,27,NAC Breda,Vitesse,1,2,2,0,3,3,-1,6.0,10.0
16417,2013-2014,27,PSV,FC Utrecht,1,0,1,3,0,1,1,15.0,5.0
16418,2013-2014,27,RKC Waalwijk,ADO Den Haag,1,1,3,1,1,2,0,4.0,9.0
16419,2013-2014,27,Go Ahead Eagles,FC Twente,1,0,1,3,0,1,1,6.0,5.0
16420,2013-2014,27,FC Groningen,Feyenoord,0,2,2,0,3,2,-2,4.0,8.0
16421,2013-2014,27,AFC Ajax,SC Cambuur,1,1,3,1,1,2,0,11.0,9.0
16422,2013-2014,28,SC Cambuur,RKC Waalwijk,3,2,1,3,0,5,1,11.0,1.0
16423,2013-2014,28,Vitesse,PSV,1,2,2,0,3,3,-1,9.0,15.0
16424,2013-2014,28,Heracles Almelo,Roda JC Kerkrade,2,1,1,3,0,3,1,4.0,3.0
16425,2013-2014,28,ADO Den Haag,FC Groningen,2,1,1,3,0,3,1,11.0,4.0
16426,2013-2014,28,FC Twente,AZ Alkmaar,2,1,1,3,0,3,1,8.0,7.0
16427,2013-2014,28,PEC Zwolle,Go Ahead Eagles,2,0,1,3,0,2,2,5.0,3.0
16428,2013-2014,28,NEC Nijmegen,FC Utrecht,2,2,3,1,1,4,0,5.0,6.0
16429,2013-2014,28,Feyenoord,sc Heerenveen,2,0,1,3,0,2,2,8.0,7.0
16430,2013-2014,28,NAC Breda,AFC Ajax,0,0,3,1,1,0,0,4.0,11.0
16431,2013-2014,29,FC Groningen,Vitesse,3,1,1,3,0,4,2,4.0,9.0
16432,2013-2014,29,sc Heerenveen,NEC Nijmegen,2,2,3,1,1,4,0,8.0,3.0
16433,2013-2014,29,PSV,Roda JC Kerkrade,3,1,1,3,0,4,2,15.0,3.0
16434,2013-2014,29,AZ Alkmaar,PEC Zwolle,2,1,1,3,0,3,1,9.0,5.0
16435,2013-2014,29,RKC Waalwijk,AFC Ajax,0,2,2,0,3,2,-2,1.0,11.0
16436,2013-2014,29,FC Twente,ADO Den Haag,1,1,3,1,1,2,0,6.0,9.0
16437,2013-2014,29,Go Ahead Eagles,NAC Breda,2,1,1,3,0,3,1,6.0,3.0
16438,2013-2014,29,FC Utrecht,SC Cambuur,1,0,1,3,0,1,1,8.0,8.0
16439,2013-2014,29,Heracles Almelo,Feyenoord,1,2,2,0,3,3,-1,4.0,10.0
16440,2013-2014,30,NAC Breda,FC Utrecht,2,2,3,1,1,4,0,3.0,6.0
16441,2013-2014,30,Vitesse,sc Heerenveen,2,2,3,1,1,4,0,7.0,8.0
16442,2013-2014,30,NEC Nijmegen,Heracles Almelo,1,2,2,0,3,3,-1,3.0,6.0
16443,2013-2014,30,PSV,FC Groningen,2,3,2,0,3,5,-1,12.0,7.0
16444,2013-2014,30,Feyenoord,Go Ahead Eagles,5,0,1,3,0,5,5,12.0,6.0
16445,2013-2014,30,SC Cambuur,AZ Alkmaar,0,0,3,1,1,0,0,6.0,10.0
16446,2013-2014,30,AFC Ajax,FC Twente,3,0,1,3,0,3,3,11.0,5.0
16447,2013-2014,30,Roda JC Kerkrade,RKC Waalwijk,0,1,2,0,3,1,-1,3.0,4.0
16448,2013-2014,30,ADO Den Haag,PEC Zwolle,1,1,3,1,1,2,0,7.0,5.0
16449,2013-2014,31,PEC Zwolle,FC Groningen,0,1,2,0,3,1,-1,4.0,9.0
16450,2013-2014,31,sc Heerenveen,PSV,3,0,1,3,0,3,3,8.0,9.0
16451,2013-2014,31,NAC Breda,FC Twente,0,2,2,0,3,2,-2,2.0,7.0
16452,2013-2014,31,NEC Nijmegen,SC Cambuur,1,1,3,1,1,2,0,3.0,6.0
16453,2013-2014,31,Heracles Almelo,Go Ahead Eagles,1,2,2,0,3,3,-1,6.0,9.0
16454,2013-2014,31,ADO Den Haag,FC Utrecht,4,1,1,3,0,5,3,9.0,5.0
16455,2013-2014,31,Feyenoord,RKC Waalwijk,2,0,1,3,0,2,2,15.0,4.0
16456,2013-2014,31,Vitesse,AFC Ajax,1,1,3,1,1,2,0,5.0,9.0
16457,2013-2014,31,Roda JC Kerkrade,AZ Alkmaar,2,2,3,1,1,4,0,4.0,8.0
16458,2013-2014,32,FC Groningen,NAC Breda,2,1,1,3,0,3,1,12.0,2.0
16459,2013-2014,32,Go Ahead Eagles,sc Heerenveen,0,2,2,0,3,2,-2,6.0,8.0
16460,2013-2014,32,SC Cambuur,Vitesse,4,3,1,3,0,7,1,8.0,2.0
16461,2013-2014,32,FC Twente,Roda JC Kerkrade,3,0,1,3,0,3,3,10.0,1.0
16462,2013-2014,32,AZ Alkmaar,NEC Nijmegen,1,1,3,1,1,2,0,6.0,4.0
16463,2013-2014,32,FC Utrecht,Heracles Almelo,2,1,1,3,0,3,1,8.0,6.0
16464,2013-2014,32,RKC Waalwijk,PEC Zwolle,1,1,3,1,1,2,0,4.0,5.0
16465,2013-2014,32,AFC Ajax,ADO Den Haag,3,2,1,3,0,5,1,11.0,8.0
16466,2013-2014,32,PSV,Feyenoord,0,2,2,0,3,2,-2,6.0,15.0
16467,2013-2014,33,sc Heerenveen,FC Utrecht,4,1,1,3,0,5,3,11.0,7.0
16468,2013-2014,33,Feyenoord,SC Cambuur,5,1,1,3,0,6,4,15.0,5.0
16469,2013-2014,33,NAC Breda,RKC Waalwijk,1,1,3,1,1,2,0,2.0,5.0
16470,2013-2014,33,PEC Zwolle,PSV,1,2,2,0,3,3,-1,2.0,6.0
16471,2013-2014,33,Heracles Almelo,AFC Ajax,1,1,3,1,1,2,0,4.0,11.0
16472,2013-2014,33,Vitesse,Go Ahead Eagles,2,2,3,1,1,4,0,3.0,7.0
16473,2013-2014,33,NEC Nijmegen,FC Twente,2,5,2,0,3,7,-3,3.0,10.0
16474,2013-2014,33,Roda JC Kerkrade,FC Groningen,1,2,2,0,3,3,-1,1.0,15.0
16475,2013-2014,33,ADO Den Haag,AZ Alkmaar,2,1,1,3,0,3,1,8.0,6.0
16476,2013-2014,34,SC Cambuur,ADO Den Haag,1,2,2,0,3,3,-1,5.0,10.0
16477,2013-2014,34,FC Utrecht,Vitesse,2,1,1,3,0,3,1,7.0,3.0
16478,2013-2014,34,AZ Alkmaar,Feyenoord,1,1,3,1,1,2,0,4.0,13.0
16479,2013-2014,34,RKC Waalwijk,sc Heerenveen,0,3,2,0,3,3,-3,5.0,13.0
16480,2013-2014,34,Go Ahead Eagles,Roda JC Kerkrade,0,1,2,0,3,1,-1,4.0,4.0
16481,2013-2014,34,AFC Ajax,NEC Nijmegen,2,2,3,1,1,4,0,9.0,3.0
16482,2013-2014,34,PSV,NAC Breda,2,0,1,3,0,2,2,6.0,2.0
16483,2013-2014,34,FC Groningen,Heracles Almelo,3,1,1,3,0,4,2,15.0,4.0
16484,2013-2014,34,FC Twente,PEC Zwolle,2,2,3,1,1,4,0,10.0,3.0
16485,2014-2015,1,PEC Zwolle,FC Utrecht,2,0,1,3,0,2,2,5.0,6.0
16486,2014-2015,1,sc Heerenveen,FC Dordrecht,1,2,2,0,3,3,-1,12.0,
16487,2014-2015,1,SC Cambuur,FC Twente,1,1,3,1,1,2,0,5.0,11.0
16488,2014-2015,1,NAC Breda,SBV Excelsior,1,1,3,1,1,2,0,2.0,2.0
16489,2014-2015,1,Heracles Almelo,AZ Alkmaar,0,3,2,0,3,3,-3,1.0,6.0
16490,2014-2015,1,ADO Den Haag,Feyenoord,0,1,2,0,3,1,-1,9.0,13.0
16491,2014-2015,1,Go Ahead Eagles,FC Groningen,2,3,2,0,3,5,-1,4.0,15.0
16492,2014-2015,1,AFC Ajax,Vitesse,4,1,1,3,0,5,3,9.0,2.0
16493,2014-2015,1,Willem II,PSV,1,3,2,0,3,4,-2,6.0,9.0
16494,2014-2015,2,Feyenoord,sc Heerenveen,1,1,3,1,1,2,0,11.0,10.0
16495,2014-2015,2,PSV,NAC Breda,6,1,1,3,0,7,5,12.0,2.0
16496,2014-2015,2,FC Dordrecht,PEC Zwolle,1,2,2,0,3,3,-1,,8.0
16497,2014-2015,2,FC Twente,ADO Den Haag,2,2,3,1,1,4,0,9.0,7.0
16498,2014-2015,2,Vitesse,SC Cambuur,2,2,3,1,1,4,0,2.0,5.0
16499,2014-2015,2,AZ Alkmaar,AFC Ajax,1,3,2,0,3,4,-2,5.0,11.0
16500,2014-2015,2,FC Utrecht,Willem II,2,1,1,3,0,3,1,9.0,3.0
16501,2014-2015,2,SBV Excelsior,Go Ahead Eagles,3,2,1,3,0,5,1,5.0,1.0
16502,2014-2015,2,FC Groningen,Heracles Almelo,3,1,1,3,0,4,2,15.0,1.0
16503,2014-2015,3,Heracles Almelo,SC Cambuur,0,1,2,0,3,1,-1,1.0,5.0
16504,2014-2015,3,Willem II,AZ Alkmaar,3,0,1,3,0,3,3,6.0,4.0
16505,2014-2015,3,sc Heerenveen,SBV Excelsior,2,0,1,3,0,2,2,10.0,5.0
16506,2014-2015,3,Go Ahead Eagles,FC Dordrecht,0,0,3,1,1,0,0,2.0,
16507,2014-2015,3,PEC Zwolle,Vitesse,2,1,1,3,0,3,1,10.0,2.0
16508,2014-2015,3,Feyenoord,FC Utrecht,1,2,2,0,3,3,-1,8.0,9.0
16509,2014-2015,3,NAC Breda,FC Twente,1,1,3,1,1,2,0,3.0,7.0
16510,2014-2015,3,ADO Den Haag,FC Groningen,3,0,1,3,0,3,3,10.0,12.0
16511,2014-2015,3,AFC Ajax,PSV,1,3,2,0,3,4,-2,8.0,15.0
16512,2014-2015,4,Go Ahead Eagles,Willem II,1,0,1,3,0,1,1,4.0,6.0
16513,2014-2015,4,SC Cambuur,ADO Den Haag,3,2,1,3,0,5,1,8.0,7.0
16514,2014-2015,4,FC Dordrecht,AZ Alkmaar,1,3,2,0,3,4,-2,,7.0
16515,2014-2015,4,SBV Excelsior,Heracles Almelo,3,1,1,3,0,4,2,7.0,0.0
16516,2014-2015,4,sc Heerenveen,FC Utrecht,3,1,1,3,0,4,2,10.0,9.0
16517,2014-2015,4,PSV,Vitesse,2,0,1,3,0,2,2,15.0,1.0
16518,2014-2015,4,NAC Breda,PEC Zwolle,3,1,1,3,0,4,2,5.0,10.0
16519,2014-2015,4,FC Groningen,AFC Ajax,2,0,1,3,0,2,2,12.0,7.0
16520,2014-2015,4,FC Twente,Feyenoord,0,0,3,1,1,0,0,5.0,6.0
16521,2014-2015,5,AFC Ajax,Heracles Almelo,2,1,1,3,0,3,1,9.0,0.0
16522,2014-2015,5,FC Twente,Go Ahead Eagles,2,1,1,3,0,3,1,7.0,4.0
16523,2014-2015,5,AZ Alkmaar,sc Heerenveen,0,1,2,0,3,1,-1,6.0,10.0
16524,2014-2015,5,Feyenoord,Willem II,1,2,2,0,3,3,-1,5.0,6.0
16525,2014-2015,5,PEC Zwolle,PSV,3,1,1,3,0,4,2,12.0,12.0
16526,2014-2015,5,FC Utrecht,ADO Den Haag,0,0,3,1,1,0,0,7.0,5.0
16527,2014-2015,5,SC Cambuur,FC Groningen,3,0,1,3,0,3,3,11.0,9.0
16528,2014-2015,5,Vitesse,SBV Excelsior,3,1,1,3,0,4,2,4.0,7.0
16529,2014-2015,5,FC Dordrecht,NAC Breda,0,1,2,0,3,1,-1,4.0,8.0
16530,2014-2015,6,Willem II,NAC Breda,2,1,1,3,0,3,1,9.0,7.0
16531,2014-2015,6,SBV Excelsior,FC Dordrecht,1,1,3,1,1,2,0,7.0,2.0
16532,2014-2015,6,ADO Den Haag,Go Ahead Eagles,1,1,3,1,1,2,0,6.0,5.0
16533,2014-2015,6,Vitesse,sc Heerenveen,1,1,3,1,1,2,0,5.0,11.0
16534,2014-2015,6,Heracles Almelo,FC Twente,1,4,2,0,3,5,-3,0.0,9.0
16535,2014-2015,6,Feyenoord,AFC Ajax,0,1,2,0,3,1,-1,2.0,9.0
16536,2014-2015,6,PSV,SC Cambuur,4,0,1,3,0,4,4,12.0,10.0
16537,2014-2015,6,AZ Alkmaar,PEC Zwolle,1,0,1,3,0,1,1,6.0,9.0
16538,2014-2015,6,FC Utrecht,FC Groningen,1,0,1,3,0,1,1,10.0,6.0
16539,2014-2015,7,FC Dordrecht,Vitesse,2,6,2,0,3,8,-4,2.0,7.0
16540,2014-2015,7,NAC Breda,AFC Ajax,2,5,2,0,3,7,-3,7.0,9.0
16541,2014-2015,7,PEC Zwolle,Heracles Almelo,4,2,1,3,0,6,2,9.0,0.0
16542,2014-2015,7,Go Ahead Eagles,Feyenoord,0,4,2,0,3,4,-4,5.0,4.0
16543,2014-2015,7,ADO Den Haag,AZ Alkmaar,2,3,2,0,3,5,-1,5.0,9.0
16544,2014-2015,7,SBV Excelsior,SC Cambuur,1,1,3,1,1,2,0,5.0,10.0
16545,2014-2015,7,FC Groningen,Willem II,1,0,1,3,0,1,1,6.0,9.0
16546,2014-2015,7,FC Twente,FC Utrecht,3,1,1,3,0,4,2,11.0,7.0
16547,2014-2015,7,sc Heerenveen,PSV,1,0,1,3,0,1,1,13.0,9.0
16548,2014-2015,8,Vitesse,ADO Den Haag,6,1,1,3,0,7,5,10.0,2.0
16549,2014-2015,8,Heracles Almelo,NAC Breda,6,1,1,3,0,7,5,3.0,6.0
16550,2014-2015,8,SC Cambuur,FC Dordrecht,4,1,1,3,0,5,3,10.0,1.0
16551,2014-2015,8,Willem II,sc Heerenveen,2,1,1,3,0,3,1,9.0,10.0
16552,2014-2015,8,FC Utrecht,Go Ahead Eagles,2,3,2,0,3,5,-1,4.0,7.0
16553,2014-2015,8,PSV,SBV Excelsior,3,0,1,3,0,3,3,9.0,5.0
16554,2014-2015,8,AZ Alkmaar,FC Twente,2,2,3,1,1,4,0,10.0,11.0
16555,2014-2015,8,Feyenoord,FC Groningen,4,0,1,3,0,4,4,7.0,6.0
16556,2014-2015,8,AFC Ajax,PEC Zwolle,0,0,3,1,1,0,0,10.0,7.0
16557,2014-2015,9,Willem II,Vitesse,1,4,2,0,3,5,-3,9.0,13.0
16558,2014-2015,9,PSV,AZ Alkmaar,3,0,1,3,0,3,3,9.0,7.0
16559,2014-2015,9,Feyenoord,Heracles Almelo,2,1,1,3,0,3,1,9.0,3.0
16560,2014-2015,9,NAC Breda,ADO Den Haag,1,1,3,1,1,2,0,4.0,3.0
16561,2014-2015,9,FC Twente,AFC Ajax,1,1,3,1,1,2,0,11.0,11.0
16562,2014-2015,9,sc Heerenveen,SC Cambuur,2,2,3,1,1,4,0,8.0,8.0
16563,2014-2015,9,FC Dordrecht,FC Utrecht,1,3,2,0,3,4,-2,1.0,7.0
16564,2014-2015,9,Go Ahead Eagles,PEC Zwolle,3,2,1,3,0,5,1,7.0,7.0
16565,2014-2015,9,FC Groningen,SBV Excelsior,1,1,3,1,1,2,0,4.0,3.0
16566,2014-2015,10,ADO Den Haag,FC Dordrecht,2,0,1,3,0,2,2,5.0,1.0
16567,2014-2015,10,Vitesse,NAC Breda,2,2,3,1,1,4,0,11.0,2.0
16568,2014-2015,10,Heracles Almelo,Willem II,1,3,2,0,3,4,-2,3.0,9.0
16569,2014-2015,10,AZ Alkmaar,FC Groningen,2,2,3,1,1,4,0,8.0,5.0
16570,2014-2015,10,AFC Ajax,Go Ahead Eagles,3,1,1,3,0,4,2,11.0,7.0
16571,2014-2015,10,SC Cambuur,Feyenoord,0,1,2,0,3,1,-1,5.0,12.0
16572,2014-2015,10,FC Utrecht,PSV,1,5,2,0,3,6,-4,6.0,12.0
16573,2014-2015,10,PEC Zwolle,sc Heerenveen,2,2,3,1,1,4,0,5.0,6.0
16574,2014-2015,10,SBV Excelsior,FC Twente,2,1,1,3,0,3,1,6.0,8.0
16575,2014-2015,11,AFC Ajax,FC Dordrecht,4,0,1,3,0,4,4,11.0,0.0
16576,2014-2015,11,Feyenoord,PEC Zwolle,2,0,1,3,0,2,2,15.0,5.0
16577,2014-2015,11,FC Twente,sc Heerenveen,2,0,1,3,0,2,2,8.0,5.0
16578,2014-2015,11,PSV,ADO Den Haag,1,0,1,3,0,1,1,12.0,4.0
16579,2014-2015,11,FC Utrecht,Vitesse,3,1,1,3,0,4,2,6.0,10.0
16580,2014-2015,11,Go Ahead Eagles,Heracles Almelo,1,3,2,0,3,4,-2,6.0,6.0
16581,2014-2015,11,Willem II,SC Cambuur,1,1,3,1,1,2,0,7.0,6.0
16582,2014-2015,11,AZ Alkmaar,SBV Excelsior,3,3,3,1,1,6,0,6.0,6.0
16583,2014-2015,11,FC Groningen,NAC Breda,1,0,1,3,0,1,1,8.0,2.0
16584,2014-2015,12,SBV Excelsior,FC Utrecht,2,2,3,1,1,4,0,6.0,7.0
16585,2014-2015,12,ADO Den Haag,Willem II,3,2,1,3,0,5,1,7.0,7.0
16586,2014-2015,12,sc Heerenveen,Go Ahead Eagles,2,2,3,1,1,4,0,3.0,7.0
16587,2014-2015,12,PEC Zwolle,FC Groningen,2,0,1,3,0,2,2,5.0,5.0
16588,2014-2015,12,NAC Breda,AZ Alkmaar,0,1,2,0,3,1,-1,2.0,6.0
16589,2014-2015,12,SC Cambuur,AFC Ajax,2,4,2,0,3,6,-2,5.0,11.0
16590,2014-2015,12,FC Dordrecht,FC Twente,0,4,2,0,3,4,-4,0.0,8.0
16591,2014-2015,12,Vitesse,Feyenoord,0,0,3,1,1,0,0,8.0,13.0
16592,2014-2015,12,Heracles Almelo,PSV,1,2,2,0,3,3,-1,6.0,15.0
16593,2014-2015,13,AZ Alkmaar,Vitesse,1,0,1,3,0,1,1,8.0,5.0
16594,2014-2015,13,Go Ahead Eagles,NAC Breda,2,0,1,3,0,2,2,7.0,2.0
16595,2014-2015,13,Feyenoord,FC Dordrecht,2,0,1,3,0,2,2,13.0,0.0
16596,2014-2015,13,Willem II,SBV Excelsior,1,1,3,1,1,2,0,5.0,7.0
16597,2014-2015,13,AFC Ajax,sc Heerenveen,4,1,1,3,0,5,3,13.0,3.0
16598,2014-2015,13,FC Groningen,PSV,1,1,3,1,1,2,0,6.0,13.0
16599,2014-2015,13,PEC Zwolle,FC Twente,1,2,2,0,3,3,-1,4.0,10.0
16600,2014-2015,13,Heracles Almelo,ADO Den Haag,3,1,1,3,0,4,2,6.0,7.0
16601,2014-2015,13,FC Utrecht,SC Cambuur,1,3,2,0,3,4,-2,7.0,5.0
16602,2014-2015,14,FC Dordrecht,Willem II,0,4,2,0,3,4,-4,0.0,8.0
16603,2014-2015,14,sc Heerenveen,Heracles Almelo,0,1,2,0,3,1,-1,2.0,9.0
16604,2014-2015,14,NAC Breda,FC Utrecht,1,5,2,0,3,6,-4,1.0,7.0
16605,2014-2015,14,Vitesse,Go Ahead Eagles,2,2,3,1,1,4,0,3.0,5.0
16606,2014-2015,14,SC Cambuur,AZ Alkmaar,0,2,2,0,3,2,-2,4.0,11.0
16607,2014-2015,14,ADO Den Haag,AFC Ajax,1,1,3,1,1,2,0,7.0,13.0
16608,2014-2015,14,SBV Excelsior,PEC Zwolle,0,5,2,0,3,5,-5,6.0,7.0
16609,2014-2015,14,FC Twente,FC Groningen,1,2,2,0,3,3,-1,9.0,8.0
16610,2014-2015,14,PSV,Feyenoord,4,3,1,3,0,7,1,13.0,10.0
16611,2014-2015,15,AZ Alkmaar,Go Ahead Eagles,2,0,1,3,0,2,2,13.0,5.0
16612,2014-2015,15,SBV Excelsior,Feyenoord,2,5,2,0,3,7,-3,3.0,10.0
16613,2014-2015,15,SC Cambuur,NAC Breda,0,1,2,0,3,1,-1,4.0,3.0
16614,2014-2015,15,FC Dordrecht,PSV,1,3,2,0,3,4,-2,0.0,13.0
16615,2014-2015,15,AFC Ajax,Willem II,5,0,1,3,0,5,5,13.0,5.0
16616,2014-2015,15,PEC Zwolle,ADO Den Haag,3,1,1,3,0,4,2,9.0,4.0
16617,2014-2015,15,FC Utrecht,Heracles Almelo,2,4,2,0,3,6,-2,7.0,12.0
16618,2014-2015,15,FC Groningen,sc Heerenveen,1,1,3,1,1,2,0,8.0,2.0
16619,2014-2015,15,Vitesse,FC Twente,2,2,3,1,1,4,0,3.0,10.0
16620,2014-2015,16,Heracles Almelo,FC Dordrecht,1,1,3,1,1,2,0,10.0,1.0
16621,2014-2015,16,NAC Breda,sc Heerenveen,0,2,2,0,3,2,-2,3.0,5.0
16622,2014-2015,16,ADO Den Haag,SBV Excelsior,2,2,3,1,1,4,0,5.0,3.0
16623,2014-2015,16,Willem II,PEC Zwolle,0,1,2,0,3,1,-1,4.0,12.0
16624,2014-2015,16,Go Ahead Eagles,SC Cambuur,1,2,2,0,3,3,-1,5.0,6.0
16625,2014-2015,16,AFC Ajax,FC Utrecht,3,1,1,3,0,4,2,13.0,4.0
16626,2014-2015,16,PSV,FC Twente,2,0,1,3,0,2,2,13.0,7.0
16627,2014-2015,16,FC Groningen,Vitesse,1,1,3,1,1,2,0,6.0,4.0
16628,2014-2015,16,Feyenoord,AZ Alkmaar,2,2,3,1,1,4,0,8.0,13.0
16629,2014-2015,17,sc Heerenveen,ADO Den Haag,0,0,3,1,1,0,0,5.0,3.0
16630,2014-2015,17,SC Cambuur,PEC Zwolle,2,1,1,3,0,3,1,9.0,9.0
16631,2014-2015,17,FC Dordrecht,FC Groningen,1,1,3,1,1,2,0,2.0,7.0
16632,2014-2015,17,PSV,Go Ahead Eagles,5,0,1,3,0,5,5,13.0,4.0
16633,2014-2015,17,AZ Alkmaar,FC Utrecht,0,3,2,0,3,3,-3,10.0,6.0
16634,2014-2015,17,Vitesse,Heracles Almelo,3,0,1,3,0,3,3,6.0,10.0
16635,2014-2015,17,NAC Breda,Feyenoord,0,1,2,0,3,1,-1,3.0,10.0
16636,2014-2015,17,SBV Excelsior,AFC Ajax,0,2,2,0,3,2,-2,2.0,13.0
16637,2014-2015,17,FC Twente,Willem II,3,2,1,3,0,5,1,7.0,4.0
16638,2014-2015,18,AFC Ajax,FC Groningen,2,0,1,3,0,2,2,13.0,6.0
16639,2014-2015,18,PEC Zwolle,NAC Breda,4,1,1,3,0,5,3,12.0,3.0
16640,2014-2015,18,ADO Den Haag,SC Cambuur,2,2,3,1,1,4,0,4.0,7.0
16641,2014-2015,18,AZ Alkmaar,FC Dordrecht,2,0,1,3,0,2,2,10.0,2.0
16642,2014-2015,18,Vitesse,PSV,0,1,2,0,3,1,-1,6.0,15.0
16643,2014-2015,18,Willem II,Go Ahead Eagles,1,0,1,3,0,1,1,6.0,1.0
16644,2014-2015,18,FC Utrecht,sc Heerenveen,1,2,2,0,3,3,-1,6.0,8.0
16645,2014-2015,18,Feyenoord,FC Twente,3,1,1,3,0,4,2,10.0,4.0
16646,2014-2015,18,Heracles Almelo,SBV Excelsior,0,3,2,0,3,3,-3,7.0,4.0
16647,2014-2015,19,FC Twente,Heracles Almelo,2,0,1,3,0,2,2,7.0,4.0
16648,2014-2015,19,SC Cambuur,PSV,1,2,2,0,3,3,-1,7.0,15.0
16649,2014-2015,19,FC Dordrecht,SBV Excelsior,1,0,1,3,0,1,1,5.0,4.0
16650,2014-2015,19,PEC Zwolle,AZ Alkmaar,1,1,3,1,1,2,0,10.0,8.0
16651,2014-2015,19,sc Heerenveen,Vitesse,4,1,1,3,0,5,3,11.0,5.0
16652,2014-2015,19,AFC Ajax,Feyenoord,0,0,3,1,1,0,0,13.0,11.0
16653,2014-2015,19,NAC Breda,Willem II,0,0,3,1,1,0,0,4.0,4.0
16654,2014-2015,19,FC Groningen,FC Utrecht,2,2,3,1,1,4,0,4.0,4.0
16655,2014-2015,19,Go Ahead Eagles,ADO Den Haag,1,0,1,3,0,1,1,3.0,3.0
16656,2014-2015,20,FC Dordrecht,sc Heerenveen,0,0,3,1,1,0,0,6.0,11.0
16657,2014-2015,20,PSV,Willem II,2,1,1,3,0,3,1,15.0,4.0
16658,2014-2015,20,SBV Excelsior,NAC Breda,0,0,3,1,1,0,0,5.0,2.0
16659,2014-2015,20,FC Groningen,Go Ahead Eagles,2,0,1,3,0,2,2,6.0,3.0
16660,2014-2015,20,FC Twente,SC Cambuur,2,1,1,3,0,3,1,9.0,7.0
16661,2014-2015,20,Feyenoord,ADO Den Haag,2,1,1,3,0,3,1,11.0,3.0
16662,2014-2015,20,FC Utrecht,PEC Zwolle,0,2,2,0,3,2,-2,4.0,10.0
16663,2014-2015,20,Vitesse,AFC Ajax,1,0,1,3,0,1,1,7.0,10.0
16664,2014-2015,20,AZ Alkmaar,Heracles Almelo,3,1,1,3,0,4,2,8.0,1.0
16665,2014-2015,21,Go Ahead Eagles,SBV Excelsior,0,0,3,1,1,0,0,4.0,5.0
16666,2014-2015,21,NAC Breda,PSV,0,2,2,0,3,2,-2,2.0,15.0
16667,2014-2015,21,sc Heerenveen,Feyenoord,3,1,1,3,0,4,2,11.0,10.0
16668,2014-2015,21,ADO Den Haag,FC Twente,2,0,1,3,0,2,2,5.0,9.0
16669,2014-2015,21,PEC Zwolle,FC Dordrecht,4,0,1,3,0,4,4,10.0,5.0
16670,2014-2015,21,SC Cambuur,Vitesse,0,2,2,0,3,2,-2,4.0,9.0
16671,2014-2015,21,Willem II,FC Utrecht,1,0,1,3,0,1,1,7.0,4.0
16672,2014-2015,21,Heracles Almelo,FC Groningen,2,2,3,1,1,4,0,1.0,6.0
16673,2014-2015,21,AFC Ajax,AZ Alkmaar,0,1,2,0,3,1,-1,7.0,10.0
16674,2014-2015,22,FC Dordrecht,ADO Den Haag,0,0,3,1,1,0,0,5.0,5.0
16675,2014-2015,22,FC Twente,SBV Excelsior,1,3,2,0,3,4,-2,6.0,8.0
16676,2014-2015,22,sc Heerenveen,PEC Zwolle,4,0,1,3,0,4,4,13.0,10.0
16677,2014-2015,22,NAC Breda,Vitesse,0,1,2,0,3,1,-1,2.0,9.0
16678,2014-2015,22,PSV,FC Utrecht,3,1,1,3,0,4,2,15.0,1.0
16679,2014-2015,22,Feyenoord,SC Cambuur,2,1,1,3,0,3,1,10.0,1.0
16680,2014-2015,22,Willem II,Heracles Almelo,3,0,1,3,0,3,3,10.0,1.0
16681,2014-2015,22,Go Ahead Eagles,AFC Ajax,1,2,2,0,3,3,-1,4.0,7.0
16682,2014-2015,22,FC Groningen,AZ Alkmaar,2,4,2,0,3,6,-2,5.0,13.0
16683,2014-2015,23,AZ Alkmaar,PSV,2,4,2,0,3,6,-2,10.0,15.0
16684,2014-2015,23,Heracles Almelo,Feyenoord,2,0,1,3,0,2,2,4.0,7.0
16685,2014-2015,23,Vitesse,Willem II,2,0,1,3,0,2,2,12.0,7.0
16686,2014-2015,23,SBV Excelsior,FC Groningen,1,1,3,1,1,2,0,6.0,6.0
16687,2014-2015,23,ADO Den Haag,NAC Breda,3,2,1,3,0,5,1,7.0,2.0
16688,2014-2015,23,SC Cambuur,sc Heerenveen,2,1,1,3,0,3,1,3.0,10.0
16689,2014-2015,23,FC Utrecht,FC Dordrecht,6,1,1,3,0,7,5,4.0,5.0
16690,2014-2015,23,PEC Zwolle,Go Ahead Eagles,0,1,2,0,3,1,-1,7.0,7.0
16691,2014-2015,23,AFC Ajax,FC Twente,4,2,1,3,0,6,2,7.0,6.0
16692,2014-2015,24,NAC Breda,SC Cambuur,2,1,1,3,0,3,1,4.0,3.0
16693,2014-2015,24,ADO Den Haag,PEC Zwolle,3,2,1,3,0,5,1,10.0,6.0
16694,2014-2015,24,Go Ahead Eagles,AZ Alkmaar,0,2,2,0,3,2,-2,4.0,12.0
16695,2014-2015,24,Heracles Almelo,FC Utrecht,1,1,3,1,1,2,0,5.0,4.0
16696,2014-2015,24,sc Heerenveen,FC Groningen,3,1,1,3,0,4,2,10.0,5.0
16697,2014-2015,24,PSV,FC Dordrecht,3,0,1,3,0,3,3,15.0,2.0
16698,2014-2015,24,Willem II,AFC Ajax,1,1,3,1,1,2,0,7.0,7.0
16699,2014-2015,24,FC Twente,Vitesse,1,2,2,0,3,3,-1,3.0,15.0
16700,2014-2015,24,Feyenoord,SBV Excelsior,3,2,1,3,0,5,1,9.0,6.0
16701,2014-2015,25,FC Dordrecht,Go Ahead Eagles,2,1,1,3,0,3,1,4.0,4.0
16702,2014-2015,25,Vitesse,PEC Zwolle,2,1,1,3,0,3,1,15.0,3.0
16703,2014-2015,25,AZ Alkmaar,Willem II,2,0,1,3,0,2,2,12.0,7.0
16704,2014-2015,25,FC Twente,NAC Breda,1,1,3,1,1,2,0,1.0,4.0
16705,2014-2015,25,SC Cambuur,Heracles Almelo,1,0,1,3,0,1,1,6.0,5.0
16706,2014-2015,25,SBV Excelsior,sc Heerenveen,3,0,1,3,0,3,3,8.0,9.0
16707,2014-2015,25,FC Utrecht,Feyenoord,0,0,3,1,1,0,0,5.0,7.0
16708,2014-2015,25,FC Groningen,ADO Den Haag,1,1,3,1,1,2,0,3.0,11.0
16709,2014-2015,25,PSV,AFC Ajax,1,3,2,0,3,4,-2,12.0,10.0
16710,2014-2015,26,Willem II,FC Twente,2,2,3,1,1,4,0,5.0,2.0
16711,2014-2015,26,Go Ahead Eagles,PSV,0,3,2,0,3,3,-3,3.0,12.0
16712,2014-2015,26,ADO Den Haag,sc Heerenveen,0,1,2,0,3,1,-1,8.0,9.0
16713,2014-2015,26,Heracles Almelo,Vitesse,1,1,3,1,1,2,0,5.0,13.0
16714,2014-2015,26,PEC Zwolle,SC Cambuur,6,1,1,3,0,7,5,3.0,6.0
16715,2014-2015,26,FC Groningen,FC Dordrecht,2,0,1,3,0,2,2,5.0,4.0
16716,2014-2015,26,Feyenoord,NAC Breda,3,0,1,3,0,3,3,10.0,4.0
16717,2014-2015,26,AFC Ajax,SBV Excelsior,1,0,1,3,0,1,1,13.0,7.0
16718,2014-2015,26,FC Utrecht,AZ Alkmaar,6,2,1,3,0,8,4,8.0,9.0
16719,2014-2015,27,Vitesse,AZ Alkmaar,3,1,1,3,0,4,2,13.0,6.0
16720,2014-2015,27,FC Twente,PEC Zwolle,2,0,1,3,0,2,2,5.0,3.0
16721,2014-2015,27,NAC Breda,Go Ahead Eagles,1,0,1,3,0,1,1,7.0,3.0
16722,2014-2015,27,SC Cambuur,FC Utrecht,3,1,1,3,0,4,2,9.0,8.0
16723,2014-2015,27,SBV Excelsior,Willem II,2,3,2,0,3,5,-1,4.0,5.0
16724,2014-2015,27,ADO Den Haag,Heracles Almelo,1,3,2,0,3,4,-2,7.0,8.0
16725,2014-2015,27,sc Heerenveen,AFC Ajax,1,4,2,0,3,5,-3,6.0,13.0
16726,2014-2015,27,PSV,FC Groningen,2,1,1,3,0,3,1,12.0,5.0
16727,2014-2015,27,FC Dordrecht,Feyenoord,1,2,2,0,3,3,-1,3.0,10.0
16728,2014-2015,28,FC Utrecht,NAC Breda,3,4,2,0,3,7,-1,5.0,10.0
16729,2014-2015,28,Go Ahead Eagles,Vitesse,0,2,2,0,3,2,-2,0.0,13.0
16730,2014-2015,28,Willem II,FC Dordrecht,2,1,1,3,0,3,1,8.0,3.0
16731,2014-2015,28,Heracles Almelo,sc Heerenveen,1,4,2,0,3,5,-3,5.0,9.0
16732,2014-2015,28,AZ Alkmaar,SC Cambuur,2,1,1,3,0,3,1,9.0,6.0
16733,2014-2015,28,PEC Zwolle,SBV Excelsior,1,1,3,1,1,2,0,4.0,4.0
16734,2014-2015,28,FC Groningen,FC Twente,2,2,3,1,1,4,0,5.0,6.0
16735,2014-2015,28,Feyenoord,PSV,2,1,1,3,0,3,1,13.0,9.0
16736,2014-2015,28,AFC Ajax,ADO Den Haag,1,0,1,3,0,1,1,13.0,4.0
16737,2014-2015,29,Vitesse,FC Groningen,1,1,3,1,1,2,0,11.0,6.0
16738,2014-2015,29,PEC Zwolle,Willem II,1,0,1,3,0,1,1,7.0,7.0
16739,2014-2015,29,sc Heerenveen,NAC Breda,0,0,3,1,1,0,0,7.0,8.0
16740,2014-2015,29,FC Dordrecht,Heracles Almelo,2,3,2,0,3,5,-1,3.0,7.0
16741,2014-2015,29,FC Twente,PSV,0,5,2,0,3,5,-5,6.0,9.0
16742,2014-2015,29,AZ Alkmaar,Feyenoord,1,4,2,0,3,5,-3,6.0,13.0
16743,2014-2015,29,FC Utrecht,AFC Ajax,1,1,3,1,1,2,0,5.0,13.0
16744,2014-2015,29,SBV Excelsior,ADO Den Haag,2,3,2,0,3,5,-1,4.0,4.0
16745,2014-2015,29,SC Cambuur,Go Ahead Eagles,1,0,1,3,0,1,1,9.0,0.0
16746,2014-2015,30,PSV,PEC Zwolle,3,1,1,3,0,4,2,12.0,7.0
16747,2014-2015,30,SBV Excelsior,Vitesse,1,3,2,0,3,4,-2,1.0,11.0
16748,2014-2015,30,sc Heerenveen,AZ Alkmaar,5,2,1,3,0,7,3,10.0,3.0
16749,2014-2015,30,NAC Breda,FC Dordrecht,2,2,3,1,1,4,0,8.0,1.0
16750,2014-2015,30,Heracles Almelo,AFC Ajax,0,2,2,0,3,2,-2,7.0,13.0
16751,2014-2015,30,Willem II,Feyenoord,2,2,3,1,1,4,0,8.0,13.0
16752,2014-2015,30,Go Ahead Eagles,FC Twente,1,3,2,0,3,4,-2,0.0,8.0
16753,2014-2015,30,FC Groningen,SC Cambuur,3,2,1,3,0,5,1,8.0,6.0
16754,2014-2015,30,ADO Den Haag,FC Utrecht,2,0,1,3,0,2,2,6.0,4.0
16755,2014-2015,31,SC Cambuur,SBV Excelsior,1,1,3,1,1,2,0,7.0,2.0
16756,2014-2015,31,AZ Alkmaar,ADO Den Haag,3,1,1,3,0,4,2,6.0,6.0
16757,2014-2015,31,Vitesse,FC Dordrecht,3,0,1,3,0,3,3,13.0,1.0
16758,2014-2015,31,PSV,sc Heerenveen,4,1,1,3,0,5,3,12.0,7.0
16759,2014-2015,31,Willem II,FC Groningen,1,4,2,0,3,5,-3,7.0,8.0
16760,2014-2015,31,Feyenoord,Go Ahead Eagles,0,1,2,0,3,1,-1,10.0,3.0
16761,2014-2015,31,AFC Ajax,NAC Breda,0,0,3,1,1,0,0,11.0,9.0
16762,2014-2015,31,Heracles Almelo,PEC Zwolle,2,0,1,3,0,2,2,9.0,4.0
16763,2014-2015,31,FC Utrecht,FC Twente,1,0,1,3,0,1,1,4.0,7.0
16764,2014-2015,32,ADO Den Haag,Vitesse,1,0,1,3,0,1,1,9.0,10.0
16765,2014-2015,32,sc Heerenveen,Willem II,1,1,3,1,1,2,0,8.0,5.0
16766,2014-2015,32,NAC Breda,Heracles Almelo,1,3,2,0,3,4,-2,6.0,9.0
16767,2014-2015,32,Go Ahead Eagles,FC Utrecht,0,2,2,0,3,2,-2,3.0,7.0
16768,2014-2015,32,SBV Excelsior,PSV,2,3,2,0,3,5,-1,2.0,12.0
16769,2014-2015,32,FC Dordrecht,SC Cambuur,0,0,3,1,1,0,0,2.0,5.0
16770,2014-2015,32,FC Groningen,Feyenoord,1,1,3,1,1,2,0,9.0,8.0
16771,2014-2015,32,PEC Zwolle,AFC Ajax,1,1,3,1,1,2,0,5.0,9.0
16772,2014-2015,32,FC Twente,AZ Alkmaar,0,2,2,0,3,2,-2,4.0,9.0
16773,2014-2015,33,FC Utrecht,SBV Excelsior,2,2,3,1,1,4,0,8.0,2.0
16774,2014-2015,33,Willem II,ADO Den Haag,1,0,1,3,0,1,1,5.0,9.0
16775,2014-2015,33,Go Ahead Eagles,sc Heerenveen,1,1,3,1,1,2,0,4.0,6.0
16776,2014-2015,33,AZ Alkmaar,NAC Breda,3,2,1,3,0,5,1,9.0,3.0
16777,2014-2015,33,AFC Ajax,SC Cambuur,3,0,1,3,0,3,3,9.0,5.0
16778,2014-2015,33,FC Twente,FC Dordrecht,3,0,1,3,0,3,3,6.0,2.0
16779,2014-2015,33,FC Groningen,PEC Zwolle,0,1,2,0,3,1,-1,8.0,7.0
16780,2014-2015,33,PSV,Heracles Almelo,2,0,1,3,0,2,2,15.0,9.0
16781,2014-2015,33,Feyenoord,Vitesse,1,4,2,0,3,5,-3,5.0,10.0
16782,2014-2015,34,Heracles Almelo,Go Ahead Eagles,1,0,1,3,0,1,1,9.0,4.0
16783,2014-2015,34,FC Dordrecht,AFC Ajax,2,1,1,3,0,3,1,5.0,8.0
16784,2014-2015,34,PEC Zwolle,Feyenoord,3,0,1,3,0,3,3,7.0,2.0
16785,2014-2015,34,sc Heerenveen,FC Twente,1,3,2,0,3,4,-2,5.0,9.0
16786,2014-2015,34,ADO Den Haag,PSV,2,3,2,0,3,5,-1,6.0,15.0
16787,2014-2015,34,Vitesse,FC Utrecht,3,3,3,1,1,6,0,10.0,8.0
16788,2014-2015,34,SC Cambuur,Willem II,1,2,2,0,3,3,-1,2.0,8.0
16789,2014-2015,34,SBV Excelsior,AZ Alkmaar,1,4,2,0,3,5,-3,2.0,12.0
16790,2014-2015,34,NAC Breda,FC Groningen,4,5,2,0,3,9,-1,2.0,10.0
16791,2015-2016,1,Roda JC Kerkrade,Heracles Almelo,3,1,1,3,0,4,2,7.0,9.0
16792,2015-2016,1,Feyenoord,FC Utrecht,3,2,1,3,0,5,1,4.0,8.0
16793,2015-2016,1,AZ Alkmaar,AFC Ajax,0,3,2,0,3,3,-3,12.0,8.0
16794,2015-2016,1,Willem II,Vitesse,1,1,3,1,1,2,0,8.0,8.0
16795,2015-2016,1,ADO Den Haag,PSV,2,2,3,1,1,4,0,4.0,13.0
16796,2015-2016,1,sc Heerenveen,De Graafschap,3,1,1,3,0,4,2,5.0,5.0
16797,2015-2016,1,FC Groningen,FC Twente,1,1,3,1,1,2,0,8.0,7.0
16798,2015-2016,1,PEC Zwolle,SC Cambuur,2,2,3,1,1,4,0,8.0,3.0
16799,2015-2016,1,NEC Nijmegen,SBV Excelsior,1,0,1,3,0,1,1,6.0,2.0
16800,2015-2016,2,Vitesse,Roda JC Kerkrade,3,0,1,3,0,3,3,8.0,6.0
16801,2015-2016,2,De Graafschap,PEC Zwolle,0,3,2,0,3,3,-3,5.0,11.0
16802,2015-2016,2,AFC Ajax,Willem II,3,0,1,3,0,3,3,10.0,8.0
16803,2015-2016,2,FC Twente,ADO Den Haag,1,4,2,0,3,5,-3,7.0,7.0
16804,2015-2016,2,SBV Excelsior,AZ Alkmaar,2,2,3,1,1,4,0,2.0,10.0
16805,2015-2016,2,PSV,FC Groningen,2,0,1,3,0,2,2,13.0,5.0
16806,2015-2016,2,SC Cambuur,Feyenoord,0,2,2,0,3,2,-2,2.0,7.0
16807,2015-2016,2,FC Utrecht,sc Heerenveen,1,1,3,1,1,2,0,6.0,6.0
16808,2015-2016,2,Heracles Almelo,NEC Nijmegen,3,0,1,3,0,3,3,9.0,5.0
16809,2015-2016,3,FC Groningen,SBV Excelsior,2,0,1,3,0,2,2,7.0,2.0
16810,2015-2016,3,Roda JC Kerkrade,De Graafschap,1,0,1,3,0,1,1,9.0,4.0
16811,2015-2016,3,sc Heerenveen,PSV,1,1,3,1,1,2,0,6.0,11.0
16812,2015-2016,3,SC Cambuur,Heracles Almelo,1,6,2,0,3,7,-5,1.0,9.0
16813,2015-2016,3,PEC Zwolle,FC Twente,2,1,1,3,0,3,1,13.0,7.0
16814,2015-2016,3,NEC Nijmegen,AFC Ajax,0,2,2,0,3,2,-2,4.0,12.0
16815,2015-2016,3,AZ Alkmaar,Willem II,0,0,3,1,1,0,0,8.0,8.0
16816,2015-2016,3,ADO Den Haag,FC Utrecht,1,1,3,1,1,2,0,5.0,4.0
16817,2015-2016,3,Feyenoord,Vitesse,2,0,1,3,0,2,2,9.0,8.0
16818,2015-2016,4,Willem II,NEC Nijmegen,0,1,2,0,3,1,-1,5.0,7.0
16819,2015-2016,4,FC Utrecht,FC Groningen,2,0,1,3,0,2,2,6.0,7.0
16820,2015-2016,4,sc Heerenveen,PEC Zwolle,1,1,3,1,1,2,0,6.0,11.0
16821,2015-2016,4,SBV Excelsior,De Graafschap,3,0,1,3,0,3,3,4.0,3.0
16822,2015-2016,4,Heracles Almelo,FC Twente,2,0,1,3,0,2,2,12.0,4.0
16823,2015-2016,4,AFC Ajax,ADO Den Haag,4,0,1,3,0,4,4,12.0,5.0
16824,2015-2016,4,AZ Alkmaar,Roda JC Kerkrade,0,1,2,0,3,1,-1,5.0,12.0
16825,2015-2016,4,Vitesse,SC Cambuur,4,1,1,3,0,5,3,8.0,1.0
16826,2015-2016,4,PSV,Feyenoord,3,1,1,3,0,4,2,11.0,9.0
16827,2015-2016,5,De Graafschap,AZ Alkmaar,1,3,2,0,3,4,-2,0.0,5.0
16828,2015-2016,5,Roda JC Kerkrade,NEC Nijmegen,0,0,3,1,1,0,0,10.0,7.0
16829,2015-2016,5,FC Twente,AFC Ajax,2,2,3,1,1,4,0,2.0,13.0
16830,2015-2016,5,SC Cambuur,PSV,0,6,2,0,3,6,-6,1.0,11.0
16831,2015-2016,5,PEC Zwolle,SBV Excelsior,3,0,1,3,0,3,3,11.0,4.0
16832,2015-2016,5,FC Groningen,sc Heerenveen,3,1,1,3,0,4,2,7.0,6.0
16833,2015-2016,5,Feyenoord,Willem II,1,0,1,3,0,1,1,12.0,2.0
16834,2015-2016,5,ADO Den Haag,Heracles Almelo,0,1,2,0,3,1,-1,5.0,12.0
16835,2015-2016,5,FC Utrecht,Vitesse,2,1,1,3,0,3,1,8.0,7.0
16836,2015-2016,6,NEC Nijmegen,sc Heerenveen,2,0,1,3,0,2,2,7.0,3.0
16837,2015-2016,6,SC Cambuur,FC Twente,0,0,3,1,1,0,0,1.0,2.0
16838,2015-2016,6,PEC Zwolle,ADO Den Haag,2,1,1,3,0,3,1,13.0,4.0
16839,2015-2016,6,Heracles Almelo,PSV,2,1,1,3,0,3,1,15.0,10.0
16840,2015-2016,6,Willem II,FC Utrecht,3,1,1,3,0,4,2,4.0,8.0
16841,2015-2016,6,Roda JC Kerkrade,Feyenoord,1,1,3,1,1,2,0,8.0,10.0
16842,2015-2016,6,SBV Excelsior,AFC Ajax,0,2,2,0,3,2,-2,4.0,13.0
16843,2015-2016,6,Vitesse,De Graafschap,3,0,1,3,0,3,3,9.0,0.0
16844,2015-2016,6,FC Groningen,AZ Alkmaar,2,0,1,3,0,2,2,9.0,5.0
16845,2015-2016,7,sc Heerenveen,Vitesse,0,0,3,1,1,0,0,3.0,7.0
16846,2015-2016,7,FC Utrecht,SC Cambuur,3,3,3,1,1,6,0,8.0,2.0
16847,2015-2016,7,AFC Ajax,FC Groningen,2,0,1,3,0,2,2,13.0,9.0
16848,2015-2016,7,AZ Alkmaar,Heracles Almelo,3,1,1,3,0,4,2,7.0,12.0
16849,2015-2016,7,PSV,NEC Nijmegen,2,1,1,3,0,3,1,10.0,7.0
16850,2015-2016,7,De Graafschap,Willem II,2,2,3,1,1,4,0,1.0,5.0
16851,2015-2016,7,Feyenoord,PEC Zwolle,2,0,1,3,0,2,2,10.0,10.0
16852,2015-2016,7,ADO Den Haag,SBV Excelsior,3,3,3,1,1,6,0,2.0,4.0
16853,2015-2016,7,FC Twente,Roda JC Kerkrade,2,1,1,3,0,3,1,5.0,8.0
16854,2015-2016,8,Heracles Almelo,sc Heerenveen,2,0,1,3,0,2,2,12.0,2.0
16855,2015-2016,8,NEC Nijmegen,ADO Den Haag,4,1,1,3,0,5,3,10.0,1.0
16856,2015-2016,8,Roda JC Kerkrade,SC Cambuur,1,1,3,1,1,2,0,6.0,3.0
16857,2015-2016,8,Willem II,PEC Zwolle,0,1,2,0,3,1,-1,4.0,10.0
16858,2015-2016,8,SBV Excelsior,FC Utrecht,1,0,1,3,0,1,1,7.0,7.0
16859,2015-2016,8,De Graafschap,Feyenoord,1,2,2,0,3,3,-1,1.0,10.0
16860,2015-2016,8,AFC Ajax,PSV,1,2,2,0,3,3,-1,10.0,12.0
16861,2015-2016,8,Vitesse,FC Groningen,5,0,1,3,0,5,5,10.0,6.0
16862,2015-2016,8,AZ Alkmaar,FC Twente,3,1,1,3,0,4,2,9.0,5.0
16863,2015-2016,9,SC Cambuur,AZ Alkmaar,1,1,3,1,1,2,0,4.0,10.0
16864,2015-2016,9,FC Groningen,Willem II,2,1,1,3,0,3,1,9.0,4.0
16865,2015-2016,9,Heracles Almelo,AFC Ajax,0,2,2,0,3,2,-2,9.0,10.0
16866,2015-2016,9,FC Utrecht,Roda JC Kerkrade,1,1,3,1,1,2,0,5.0,4.0
16867,2015-2016,9,PSV,SBV Excelsior,1,1,3,1,1,2,0,10.0,5.0
16868,2015-2016,9,FC Twente,NEC Nijmegen,1,0,1,3,0,1,1,8.0,7.0
16869,2015-2016,9,sc Heerenveen,Feyenoord,2,5,2,0,3,7,-3,1.0,13.0
16870,2015-2016,9,ADO Den Haag,De Graafschap,1,1,3,1,1,2,0,2.0,2.0
16871,2015-2016,9,PEC Zwolle,Vitesse,1,5,2,0,3,6,-4,9.0,10.0
16872,2015-2016,10,PEC Zwolle,FC Utrecht,1,2,2,0,3,3,-1,6.0,5.0
16873,2015-2016,10,Willem II,sc Heerenveen,2,2,3,1,1,4,0,5.0,2.0
16874,2015-2016,10,De Graafschap,Heracles Almelo,0,1,2,0,3,1,-1,2.0,9.0
16875,2015-2016,10,FC Twente,PSV,1,3,2,0,3,4,-2,7.0,10.0
16876,2015-2016,10,Roda JC Kerkrade,SBV Excelsior,1,2,2,0,3,3,-1,3.0,8.0
16877,2015-2016,10,SC Cambuur,ADO Den Haag,1,1,3,1,1,2,0,5.0,3.0
16878,2015-2016,10,Vitesse,AFC Ajax,1,3,2,0,3,4,-2,10.0,12.0
16879,2015-2016,10,NEC Nijmegen,FC Groningen,1,1,3,1,1,2,0,7.0,7.0
16880,2015-2016,10,Feyenoord,AZ Alkmaar,3,1,1,3,0,4,2,13.0,7.0
16881,2015-2016,11,Heracles Almelo,Willem II,2,1,1,3,0,3,1,9.0,2.0
16882,2015-2016,11,FC Groningen,PEC Zwolle,2,0,1,3,0,2,2,7.0,3.0
16883,2015-2016,11,AFC Ajax,Roda JC Kerkrade,6,0,1,3,0,6,6,12.0,2.0
16884,2015-2016,11,SBV Excelsior,Vitesse,0,3,2,0,3,3,-3,8.0,10.0
16885,2015-2016,11,De Graafschap,PSV,3,6,2,0,3,9,-3,2.0,13.0
16886,2015-2016,11,ADO Den Haag,Feyenoord,1,0,1,3,0,1,1,6.0,12.0
16887,2015-2016,11,sc Heerenveen,SC Cambuur,2,0,1,3,0,2,2,5.0,4.0
16888,2015-2016,11,FC Utrecht,FC Twente,4,2,1,3,0,6,2,8.0,6.0
16889,2015-2016,11,AZ Alkmaar,NEC Nijmegen,2,4,2,0,3,6,-2,7.0,7.0
16890,2015-2016,12,Roda JC Kerkrade,ADO Den Haag,1,1,3,1,1,2,0,3.0,6.0
16891,2015-2016,12,FC Twente,sc Heerenveen,1,4,2,0,3,5,-3,3.0,7.0
16892,2015-2016,12,NEC Nijmegen,De Graafschap,2,0,1,3,0,2,2,10.0,1.0
16893,2015-2016,12,Willem II,SBV Excelsior,2,3,2,0,3,5,-1,1.0,10.0
16894,2015-2016,12,PEC Zwolle,Heracles Almelo,1,1,3,1,1,2,0,4.0,10.0
16895,2015-2016,12,PSV,FC Utrecht,3,1,1,3,0,4,2,13.0,7.0
16896,2015-2016,12,SC Cambuur,FC Groningen,2,2,3,1,1,4,0,4.0,8.0
16897,2015-2016,12,Feyenoord,AFC Ajax,1,1,3,1,1,2,0,10.0,10.0
16898,2015-2016,12,Vitesse,AZ Alkmaar,0,2,2,0,3,2,-2,9.0,7.0
16899,2015-2016,13,AZ Alkmaar,sc Heerenveen,3,1,1,3,0,4,2,7.0,7.0
16900,2015-2016,13,Roda JC Kerkrade,PEC Zwolle,0,5,2,0,3,5,-5,2.0,4.0
16901,2015-2016,13,AFC Ajax,SC Cambuur,5,1,1,3,0,6,4,13.0,3.0
16902,2015-2016,13,Willem II,PSV,2,2,3,1,1,4,0,2.0,11.0
16903,2015-2016,13,De Graafschap,FC Groningen,1,2,2,0,3,3,-1,1.0,11.0
16904,2015-2016,13,Heracles Almelo,SBV Excelsior,0,0,3,1,1,0,0,8.0,8.0
16905,2015-2016,13,Feyenoord,FC Twente,5,0,1,3,0,5,5,10.0,3.0
16906,2015-2016,13,NEC Nijmegen,FC Utrecht,1,0,1,3,0,1,1,10.0,7.0
16907,2015-2016,13,ADO Den Haag,Vitesse,2,2,3,1,1,4,0,7.0,7.0
16908,2015-2016,14,SC Cambuur,De Graafschap,2,3,2,0,3,5,-1,2.0,3.0
16909,2015-2016,14,sc Heerenveen,Roda JC Kerkrade,3,0,1,3,0,3,3,10.0,1.0
16910,2015-2016,14,SBV Excelsior,Feyenoord,2,4,2,0,3,6,-2,7.0,10.0
16911,2015-2016,14,FC Twente,Willem II,1,3,2,0,3,4,-2,0.0,5.0
16912,2015-2016,14,Vitesse,NEC Nijmegen,1,0,1,3,0,1,1,7.0,10.0
16913,2015-2016,14,PEC Zwolle,AFC Ajax,0,2,2,0,3,2,-2,4.0,13.0
16914,2015-2016,14,FC Groningen,ADO Den Haag,2,1,1,3,0,3,1,11.0,6.0
16915,2015-2016,14,FC Utrecht,Heracles Almelo,4,2,1,3,0,6,2,9.0,8.0
16916,2015-2016,14,PSV,AZ Alkmaar,3,0,1,3,0,3,3,13.0,6.0
16917,2015-2016,15,AZ Alkmaar,ADO Den Haag,0,1,2,0,3,1,-1,6.0,8.0
16918,2015-2016,15,SBV Excelsior,FC Twente,1,1,3,1,1,2,0,5.0,1.0
16919,2015-2016,15,De Graafschap,FC Utrecht,0,1,2,0,3,1,-1,3.0,9.0
16920,2015-2016,15,Vitesse,PSV,0,1,2,0,3,1,-1,7.0,13.0
16921,2015-2016,15,AFC Ajax,sc Heerenveen,5,2,1,3,0,7,3,13.0,9.0
16922,2015-2016,15,Willem II,SC Cambuur,3,0,1,3,0,3,3,7.0,1.0
16923,2015-2016,15,Feyenoord,Heracles Almelo,3,0,1,3,0,3,3,10.0,5.0
16924,2015-2016,15,NEC Nijmegen,PEC Zwolle,2,2,3,1,1,4,0,10.0,5.0
16925,2015-2016,15,Roda JC Kerkrade,FC Groningen,0,0,3,1,1,0,0,2.0,11.0
16926,2015-2016,16,sc Heerenveen,SBV Excelsior,2,1,1,3,0,3,1,9.0,5.0
16927,2015-2016,16,ADO Den Haag,Willem II,1,1,3,1,1,2,0,6.0,8.0
16928,2015-2016,16,SC Cambuur,NEC Nijmegen,3,1,1,3,0,4,2,4.0,7.0
16929,2015-2016,16,PSV,Roda JC Kerkrade,1,1,3,1,1,2,0,11.0,3.0
16930,2015-2016,16,FC Twente,De Graafschap,2,1,1,3,0,3,1,4.0,3.0
16931,2015-2016,16,FC Utrecht,AFC Ajax,1,0,1,3,0,1,1,9.0,10.0
16932,2015-2016,16,PEC Zwolle,AZ Alkmaar,2,1,1,3,0,3,1,8.0,6.0
16933,2015-2016,16,FC Groningen,Feyenoord,1,1,3,1,1,2,0,9.0,11.0
16934,2015-2016,16,Heracles Almelo,Vitesse,1,1,3,1,1,2,0,3.0,5.0
16935,2015-2016,17,Vitesse,FC Twente,5,1,1,3,0,6,4,8.0,4.0
16936,2015-2016,17,AZ Alkmaar,FC Utrecht,2,2,3,1,1,4,0,4.0,10.0
16937,2015-2016,17,PSV,PEC Zwolle,3,2,1,3,0,5,1,11.0,7.0
16938,2015-2016,17,Heracles Almelo,FC Groningen,2,1,1,3,0,3,1,5.0,8.0
16939,2015-2016,17,SBV Excelsior,SC Cambuur,1,4,2,0,3,5,-3,2.0,6.0
16940,2015-2016,17,Willem II,Roda JC Kerkrade,3,2,1,3,0,5,1,11.0,2.0
16941,2015-2016,17,sc Heerenveen,ADO Den Haag,0,4,2,0,3,4,-4,6.0,8.0
16942,2015-2016,17,NEC Nijmegen,Feyenoord,3,1,1,3,0,4,2,7.0,10.0
16943,2015-2016,17,AFC Ajax,De Graafschap,2,1,1,3,0,3,1,12.0,3.0
16944,2015-2016,18,FC Twente,Heracles Almelo,4,0,1,3,0,4,4,7.0,4.0
16945,2015-2016,18,SC Cambuur,Vitesse,0,2,2,0,3,2,-2,6.0,10.0
16946,2015-2016,18,PEC Zwolle,sc Heerenveen,5,2,1,3,0,7,3,7.0,6.0
16947,2015-2016,18,Roda JC Kerkrade,AZ Alkmaar,0,1,2,0,3,1,-1,2.0,4.0
16948,2015-2016,18,De Graafschap,SBV Excelsior,2,0,1,3,0,2,2,6.0,1.0
16949,2015-2016,18,ADO Den Haag,AFC Ajax,0,1,2,0,3,1,-1,7.0,12.0
16950,2015-2016,18,Feyenoord,PSV,0,2,2,0,3,2,-2,7.0,13.0
16951,2015-2016,18,FC Groningen,FC Utrecht,1,4,2,0,3,5,-3,5.0,13.0
16952,2015-2016,18,NEC Nijmegen,Willem II,1,0,1,3,0,1,1,7.0,10.0
16953,2015-2016,19,FC Groningen,NEC Nijmegen,0,0,3,1,1,0,0,3.0,8.0
16954,2015-2016,19,Heracles Almelo,De Graafschap,2,1,1,3,0,3,1,7.0,3.0
16955,2015-2016,19,AFC Ajax,Vitesse,1,0,1,3,0,1,1,12.0,7.0
16956,2015-2016,19,SBV Excelsior,Roda JC Kerkrade,0,1,2,0,3,1,-1,1.0,5.0
16957,2015-2016,19,sc Heerenveen,Willem II,3,1,1,3,0,4,2,6.0,7.0
16958,2015-2016,19,AZ Alkmaar,Feyenoord,4,2,1,3,0,6,2,7.0,4.0
16959,2015-2016,19,FC Utrecht,PEC Zwolle,1,0,1,3,0,1,1,13.0,7.0
16960,2015-2016,19,PSV,FC Twente,4,2,1,3,0,6,2,13.0,7.0
16961,2015-2016,19,ADO Den Haag,SC Cambuur,2,1,1,3,0,3,1,10.0,6.0
16962,2015-2016,20,Willem II,FC Groningen,1,1,3,1,1,2,0,5.0,3.0
16963,2015-2016,20,AFC Ajax,Heracles Almelo,0,0,3,1,1,0,0,10.0,8.0
16964,2015-2016,20,AZ Alkmaar,SC Cambuur,3,1,1,3,0,4,2,10.0,6.0
16965,2015-2016,20,NEC Nijmegen,FC Twente,2,0,1,3,0,2,2,10.0,6.0
16966,2015-2016,20,De Graafschap,ADO Den Haag,3,1,1,3,0,4,2,6.0,7.0
16967,2015-2016,20,SBV Excelsior,PSV,1,3,2,0,3,4,-2,0.0,13.0
16968,2015-2016,20,Vitesse,PEC Zwolle,1,1,3,1,1,2,0,8.0,7.0
16969,2015-2016,20,Roda JC Kerkrade,FC Utrecht,1,0,1,3,0,1,1,7.0,10.0
16970,2015-2016,20,Feyenoord,sc Heerenveen,1,2,2,0,3,3,-1,1.0,9.0
16971,2015-2016,21,Willem II,Heracles Almelo,0,0,3,1,1,0,0,5.0,8.0
16972,2015-2016,21,Vitesse,SBV Excelsior,0,0,3,1,1,0,0,8.0,1.0
16973,2015-2016,21,PEC Zwolle,FC Groningen,1,3,2,0,3,4,-2,4.0,5.0
16974,2015-2016,21,PSV,De Graafschap,4,2,1,3,0,6,2,15.0,6.0
16975,2015-2016,21,NEC Nijmegen,AZ Alkmaar,0,3,2,0,3,3,-3,10.0,13.0
16976,2015-2016,21,Roda JC Kerkrade,AFC Ajax,2,2,3,1,1,4,0,7.0,11.0
16977,2015-2016,21,SC Cambuur,sc Heerenveen,0,1,2,0,3,1,-1,3.0,9.0
16978,2015-2016,21,Feyenoord,ADO Den Haag,0,2,2,0,3,2,-2,0.0,9.0
16979,2015-2016,21,FC Twente,FC Utrecht,3,1,1,3,0,4,2,6.0,7.0
16980,2015-2016,22,SBV Excelsior,Willem II,0,0,3,1,1,0,0,2.0,3.0
16981,2015-2016,22,ADO Den Haag,Roda JC Kerkrade,2,2,3,1,1,4,0,7.0,8.0
16982,2015-2016,22,sc Heerenveen,FC Twente,1,3,2,0,3,4,-2,9.0,9.0
16983,2015-2016,22,AZ Alkmaar,Vitesse,1,0,1,3,0,1,1,15.0,5.0
16984,2015-2016,22,Heracles Almelo,PEC Zwolle,2,0,1,3,0,2,2,8.0,4.0
16985,2015-2016,22,AFC Ajax,Feyenoord,2,1,1,3,0,3,1,11.0,0.0
16986,2015-2016,22,De Graafschap,NEC Nijmegen,1,1,3,1,1,2,0,7.0,8.0
16987,2015-2016,22,FC Groningen,SC Cambuur,2,0,1,3,0,2,2,8.0,0.0
16988,2015-2016,22,FC Utrecht,PSV,0,2,2,0,3,2,-2,6.0,15.0
16989,2015-2016,23,SC Cambuur,FC Utrecht,0,2,2,0,3,2,-2,0.0,6.0
16990,2015-2016,23,Heracles Almelo,AZ Alkmaar,3,6,2,0,3,9,-3,8.0,15.0
16991,2015-2016,23,Willem II,De Graafschap,0,0,3,1,1,0,0,4.0,5.0
16992,2015-2016,23,Roda JC Kerkrade,FC Twente,0,1,2,0,3,1,-1,8.0,9.0
16993,2015-2016,23,Vitesse,sc Heerenveen,3,0,1,3,0,3,3,5.0,9.0
16994,2015-2016,23,FC Groningen,AFC Ajax,1,2,2,0,3,3,-1,8.0,11.0
16995,2015-2016,23,PEC Zwolle,Feyenoord,3,1,1,3,0,4,2,4.0,0.0
16996,2015-2016,23,SBV Excelsior,ADO Den Haag,2,4,2,0,3,6,-2,2.0,10.0
16997,2015-2016,23,NEC Nijmegen,PSV,0,3,2,0,3,3,-3,5.0,15.0
16998,2015-2016,24,ADO Den Haag,PEC Zwolle,0,2,2,0,3,2,-2,7.0,7.0
16999,2015-2016,24,AZ Alkmaar,FC Groningen,4,1,1,3,0,5,3,15.0,7.0
17000,2015-2016,24,sc Heerenveen,NEC Nijmegen,1,1,3,1,1,2,0,7.0,5.0
17001,2015-2016,24,PSV,Heracles Almelo,2,0,1,3,0,2,2,15.0,5.0
17002,2015-2016,24,FC Twente,SC Cambuur,3,0,1,3,0,3,3,12.0,0.0
17003,2015-2016,24,De Graafschap,Vitesse,2,2,3,1,1,4,0,6.0,6.0
17004,2015-2016,24,FC Utrecht,Willem II,2,1,1,3,0,3,1,6.0,4.0
17005,2015-2016,24,AFC Ajax,SBV Excelsior,3,0,1,3,0,3,3,11.0,2.0
17006,2015-2016,24,Feyenoord,Roda JC Kerkrade,1,1,3,1,1,2,0,1.0,6.0
17007,2015-2016,25,SBV Excelsior,NEC Nijmegen,2,0,1,3,0,2,2,5.0,2.0
17008,2015-2016,25,FC Twente,FC Groningen,2,0,1,3,0,2,2,15.0,6.0
17009,2015-2016,25,SC Cambuur,PEC Zwolle,1,0,1,3,0,1,1,3.0,6.0
17010,2015-2016,25,PSV,ADO Den Haag,2,0,1,3,0,2,2,15.0,7.0
17011,2015-2016,25,Vitesse,Willem II,0,1,2,0,3,1,-1,5.0,6.0
17012,2015-2016,25,Heracles Almelo,Roda JC Kerkrade,0,5,2,0,3,5,-5,4.0,6.0
17013,2015-2016,25,De Graafschap,sc Heerenveen,0,1,2,0,3,1,-1,3.0,7.0
17014,2015-2016,25,FC Utrecht,Feyenoord,1,2,2,0,3,3,-1,6.0,4.0
17015,2015-2016,25,AFC Ajax,AZ Alkmaar,4,1,1,3,0,5,3,13.0,12.0
17016,2015-2016,26,ADO Den Haag,FC Twente,2,1,1,3,0,3,1,7.0,12.0
17017,2015-2016,26,PEC Zwolle,De Graafschap,2,1,1,3,0,3,1,9.0,3.0
17018,2015-2016,26,FC Groningen,PSV,0,3,2,0,3,3,-3,3.0,15.0
17019,2015-2016,26,sc Heerenveen,FC Utrecht,0,4,2,0,3,4,-4,4.0,9.0
17020,2015-2016,26,NEC Nijmegen,Heracles Almelo,1,0,1,3,0,1,1,5.0,3.0
17021,2015-2016,26,AZ Alkmaar,SBV Excelsior,2,0,1,3,0,2,2,12.0,4.0
17022,2015-2016,26,Willem II,AFC Ajax,0,4,2,0,3,4,-4,5.0,15.0
17023,2015-2016,26,Roda JC Kerkrade,Vitesse,1,2,2,0,3,3,-1,5.0,7.0
17024,2015-2016,26,Feyenoord,SC Cambuur,3,1,1,3,0,4,2,7.0,3.0
17025,2015-2016,27,De Graafschap,Roda JC Kerkrade,3,0,1,3,0,3,3,5.0,4.0
17026,2015-2016,27,FC Twente,PEC Zwolle,2,1,1,3,0,3,1,12.0,9.0
17027,2015-2016,27,Willem II,AZ Alkmaar,0,2,2,0,3,2,-2,4.0,12.0
17028,2015-2016,27,PSV,sc Heerenveen,1,1,3,1,1,2,0,13.0,5.0
17029,2015-2016,27,SBV Excelsior,FC Groningen,2,1,1,3,0,3,1,6.0,0.0
17030,2015-2016,27,FC Utrecht,ADO Den Haag,2,2,3,1,1,4,0,10.0,7.0
17031,2015-2016,27,Heracles Almelo,SC Cambuur,3,1,1,3,0,4,2,3.0,3.0
17032,2015-2016,27,Vitesse,Feyenoord,0,2,2,0,3,2,-2,7.0,10.0
17033,2015-2016,27,AFC Ajax,NEC Nijmegen,2,2,3,1,1,4,0,13.0,5.0
17034,2015-2016,28,FC Utrecht,SBV Excelsior,2,1,1,3,0,3,1,10.0,6.0
17035,2015-2016,28,sc Heerenveen,Heracles Almelo,0,1,2,0,3,1,-1,5.0,6.0
17036,2015-2016,28,Feyenoord,De Graafschap,3,1,1,3,0,4,2,13.0,4.0
17037,2015-2016,28,PEC Zwolle,Willem II,4,1,1,3,0,5,3,9.0,3.0
17038,2015-2016,28,SC Cambuur,Roda JC Kerkrade,0,1,2,0,3,1,-1,3.0,7.0
17039,2015-2016,28,FC Twente,AZ Alkmaar,2,2,3,1,1,4,0,10.0,10.0
17040,2015-2016,28,FC Groningen,Vitesse,0,3,2,0,3,3,-3,0.0,7.0
17041,2015-2016,28,ADO Den Haag,NEC Nijmegen,1,0,1,3,0,1,1,7.0,5.0
17042,2015-2016,28,PSV,AFC Ajax,0,2,2,0,3,2,-2,10.0,13.0
17043,2015-2016,29,Heracles Almelo,FC Utrecht,1,1,3,1,1,2,0,7.0,8.0
17044,2015-2016,29,De Graafschap,SC Cambuur,2,2,3,1,1,4,0,4.0,4.0
17045,2015-2016,29,AZ Alkmaar,PSV,2,4,2,0,3,6,-2,7.0,10.0
17046,2015-2016,29,Feyenoord,SBV Excelsior,3,0,1,3,0,3,3,15.0,6.0
17047,2015-2016,29,Willem II,FC Twente,2,3,2,0,3,5,-1,3.0,10.0
17048,2015-2016,29,NEC Nijmegen,Vitesse,2,1,1,3,0,3,1,7.0,6.0
17049,2015-2016,29,Roda JC Kerkrade,sc Heerenveen,1,2,2,0,3,3,-1,6.0,7.0
17050,2015-2016,29,ADO Den Haag,FC Groningen,0,1,2,0,3,1,-1,7.0,3.0
17051,2015-2016,29,AFC Ajax,PEC Zwolle,3,0,1,3,0,3,3,13.0,6.0
17052,2015-2016,30,PEC Zwolle,Roda JC Kerkrade,3,1,1,3,0,4,2,9.0,3.0
17053,2015-2016,30,SBV Excelsior,Heracles Almelo,1,3,2,0,3,4,-2,3.0,10.0
17054,2015-2016,30,SC Cambuur,AFC Ajax,0,1,2,0,3,1,-1,1.0,13.0
17055,2015-2016,30,Vitesse,ADO Den Haag,2,2,3,1,1,4,0,7.0,8.0
17056,2015-2016,30,PSV,Willem II,2,0,1,3,0,2,2,10.0,0.0
17057,2015-2016,30,sc Heerenveen,AZ Alkmaar,4,2,1,3,0,6,2,7.0,7.0
17058,2015-2016,30,FC Utrecht,NEC Nijmegen,3,1,1,3,0,4,2,11.0,7.0
17059,2015-2016,30,FC Groningen,De Graafschap,3,1,1,3,0,4,2,6.0,4.0
17060,2015-2016,30,FC Twente,Feyenoord,0,1,2,0,3,1,-1,7.0,15.0
17061,2015-2016,31,De Graafschap,FC Twente,1,1,3,1,1,2,0,5.0,8.0
17062,2015-2016,31,Vitesse,Heracles Almelo,1,1,3,1,1,2,0,5.0,11.0
17063,2015-2016,31,Feyenoord,FC Groningen,1,1,3,1,1,2,0,13.0,7.0
17064,2015-2016,31,AZ Alkmaar,PEC Zwolle,5,1,1,3,0,6,4,7.0,6.0
17065,2015-2016,31,Roda JC Kerkrade,PSV,0,3,2,0,3,3,-3,3.0,10.0
17066,2015-2016,31,AFC Ajax,FC Utrecht,2,2,3,1,1,4,0,11.0,9.0
17067,2015-2016,31,Willem II,ADO Den Haag,0,2,2,0,3,2,-2,0.0,8.0
17068,2015-2016,31,NEC Nijmegen,SC Cambuur,2,1,1,3,0,3,1,7.0,1.0
17069,2015-2016,31,SBV Excelsior,sc Heerenveen,1,1,3,1,1,2,0,4.0,8.0
17070,2015-2016,32,FC Groningen,Roda JC Kerkrade,1,0,1,3,0,1,1,10.0,3.0
17071,2015-2016,32,PSV,Vitesse,2,0,1,3,0,2,2,12.0,5.0
17072,2015-2016,32,PEC Zwolle,NEC Nijmegen,2,0,1,3,0,2,2,9.0,6.0
17073,2015-2016,32,FC Utrecht,De Graafschap,0,2,2,0,3,2,-2,8.0,5.0
17074,2015-2016,32,Heracles Almelo,Feyenoord,2,2,3,1,1,4,0,9.0,11.0
17075,2015-2016,32,FC Twente,SBV Excelsior,2,0,1,3,0,2,2,8.0,1.0
17076,2015-2016,32,sc Heerenveen,AFC Ajax,0,2,2,0,3,2,-2,7.0,13.0
17077,2015-2016,32,ADO Den Haag,AZ Alkmaar,1,2,2,0,3,3,-1,7.0,7.0
17078,2015-2016,32,SC Cambuur,Willem II,1,1,3,1,1,2,0,2.0,1.0
17079,2015-2016,33,sc Heerenveen,FC Groningen,1,2,2,0,3,3,-1,7.0,13.0
17080,2015-2016,33,AZ Alkmaar,De Graafschap,4,1,1,3,0,5,3,9.0,5.0
17081,2015-2016,33,Willem II,Feyenoord,0,1,2,0,3,1,-1,1.0,11.0
17082,2015-2016,33,AFC Ajax,FC Twente,4,0,1,3,0,4,4,13.0,7.0
17083,2015-2016,33,PSV,SC Cambuur,6,2,1,3,0,8,4,15.0,2.0
17084,2015-2016,33,SBV Excelsior,PEC Zwolle,2,2,3,1,1,4,0,2.0,7.0
17085,2015-2016,33,Heracles Almelo,ADO Den Haag,1,1,3,1,1,2,0,7.0,5.0
17086,2015-2016,33,Vitesse,FC Utrecht,1,3,2,0,3,4,-2,2.0,8.0
17087,2015-2016,33,NEC Nijmegen,Roda JC Kerkrade,1,2,2,0,3,3,-1,6.0,3.0
17088,2015-2016,34,SC Cambuur,SBV Excelsior,0,2,2,0,3,2,-2,1.0,5.0
17089,2015-2016,34,FC Utrecht,AZ Alkmaar,1,3,2,0,3,4,-2,7.0,12.0
17090,2015-2016,34,Feyenoord,NEC Nijmegen,1,0,1,3,0,1,1,11.0,3.0
17091,2015-2016,34,PEC Zwolle,PSV,1,3,2,0,3,4,-2,7.0,15.0
17092,2015-2016,34,De Graafschap,AFC Ajax,1,1,3,1,1,2,0,5.0,11.0
17093,2015-2016,34,Roda JC Kerkrade,Willem II,2,3,2,0,3,5,-1,3.0,4.0
17094,2015-2016,34,FC Groningen,Heracles Almelo,2,1,1,3,0,3,1,13.0,6.0
17095,2015-2016,34,ADO Den Haag,sc Heerenveen,1,1,3,1,1,2,0,6.0,5.0
17096,2015-2016,34,FC Twente,Vitesse,2,2,3,1,1,4,0,5.0,3.0
17097,2016-2017,1,NEC Nijmegen,PEC Zwolle,1,1,3,1,1,2,0,4.0,5.0
17098,2016-2017,1,ADO Den Haag,Go Ahead Eagles,3,0,1,3,0,3,3,8.0,4.0
17099,2016-2017,1,FC Utrecht,PSV,1,2,2,0,3,3,-1,4.0,15.0
17100,2016-2017,1,FC Twente,SBV Excelsior,1,2,2,0,3,3,-1,5.0,8.0
17101,2016-2017,1,Willem II,Vitesse,1,4,2,0,3,5,-3,4.0,5.0
17102,2016-2017,1,FC Groningen,Feyenoord,0,5,2,0,3,5,-5,10.0,11.0
17103,2016-2017,1,AZ Alkmaar,sc Heerenveen,2,2,3,1,1,4,0,13.0,3.0
17104,2016-2017,1,Sparta Rotterdam,AFC Ajax,1,3,2,0,3,4,-2,1.0,11.0
17105,2016-2017,1,Roda JC Kerkrade,Heracles Almelo,1,1,3,1,1,2,0,4.0,4.0
17106,2016-2017,2,sc Heerenveen,FC Utrecht,2,2,3,1,1,4,0,3.0,4.0
17107,2016-2017,2,SBV Excelsior,FC Groningen,2,0,1,3,0,2,2,10.0,9.0
17108,2016-2017,2,AFC Ajax,Roda JC Kerkrade,2,2,3,1,1,4,0,11.0,5.0
17109,2016-2017,2,Vitesse,ADO Den Haag,1,2,2,0,3,3,-1,4.0,8.0
17110,2016-2017,2,PEC Zwolle,Sparta Rotterdam,0,3,2,0,3,3,-3,5.0,3.0
17111,2016-2017,2,Heracles Almelo,Willem II,3,1,1,3,0,4,2,6.0,4.0
17112,2016-2017,2,Go Ahead Eagles,NEC Nijmegen,2,2,3,1,1,4,0,2.0,2.0
17113,2016-2017,2,Feyenoord,FC Twente,2,0,1,3,0,2,2,13.0,4.0
17114,2016-2017,2,PSV,AZ Alkmaar,1,0,1,3,0,1,1,15.0,10.0
17115,2016-2017,3,SBV Excelsior,ADO Den Haag,1,2,2,0,3,3,-1,10.0,11.0
17116,2016-2017,3,Roda JC Kerkrade,Vitesse,0,1,2,0,3,1,-1,5.0,7.0
17117,2016-2017,3,AFC Ajax,Willem II,1,2,2,0,3,3,-1,8.0,6.0
17118,2016-2017,3,PEC Zwolle,PSV,0,4,2,0,3,4,-4,2.0,15.0
17119,2016-2017,3,NEC Nijmegen,sc Heerenveen,2,1,1,3,0,3,1,5.0,3.0
17120,2016-2017,3,FC Groningen,FC Twente,3,4,2,0,3,7,-1,6.0,4.0
17121,2016-2017,3,FC Utrecht,AZ Alkmaar,1,2,2,0,3,3,-1,4.0,10.0
17122,2016-2017,3,Sparta Rotterdam,Go Ahead Eagles,1,0,1,3,0,1,1,6.0,2.0
17123,2016-2017,3,Heracles Almelo,Feyenoord,0,1,2,0,3,1,-1,5.0,15.0
17124,2016-2017,4,Vitesse,FC Utrecht,1,1,3,1,1,2,0,8.0,2.0
17125,2016-2017,4,Willem II,Roda JC Kerkrade,0,0,3,1,1,0,0,7.0,3.0
17126,2016-2017,4,sc Heerenveen,PEC Zwolle,1,0,1,3,0,1,1,6.0,1.0
17127,2016-2017,4,Feyenoord,SBV Excelsior,4,1,1,3,0,5,3,15.0,9.0
17128,2016-2017,4,FC Twente,Sparta Rotterdam,3,1,1,3,0,4,2,7.0,6.0
17129,2016-2017,4,PSV,FC Groningen,0,0,3,1,1,0,0,13.0,4.0
17130,2016-2017,4,ADO Den Haag,Heracles Almelo,1,1,3,1,1,2,0,11.0,5.0
17131,2016-2017,4,Go Ahead Eagles,AFC Ajax,0,3,2,0,3,3,-3,1.0,8.0
17132,2016-2017,4,AZ Alkmaar,NEC Nijmegen,2,0,1,3,0,2,2,10.0,5.0
17133,2016-2017,5,AZ Alkmaar,Willem II,2,0,1,3,0,2,2,10.0,4.0
17134,2016-2017,5,PEC Zwolle,FC Utrecht,1,1,3,1,1,2,0,2.0,3.0
17135,2016-2017,5,NEC Nijmegen,PSV,0,4,2,0,3,4,-4,5.0,13.0
17136,2016-2017,5,sc Heerenveen,FC Twente,3,1,1,3,0,4,2,8.0,6.0
17137,2016-2017,5,SBV Excelsior,Heracles Almelo,3,1,1,3,0,4,2,9.0,5.0
17138,2016-2017,5,Feyenoord,ADO Den Haag,3,1,1,3,0,4,2,15.0,10.0
17139,2016-2017,5,FC Groningen,Sparta Rotterdam,1,1,3,1,1,2,0,2.0,7.0
17140,2016-2017,5,Go Ahead Eagles,Roda JC Kerkrade,2,0,1,3,0,2,2,4.0,3.0
17141,2016-2017,5,AFC Ajax,Vitesse,1,0,1,3,0,1,1,10.0,7.0
17142,2016-2017,6,FC Utrecht,FC Groningen,1,5,2,0,3,6,-4,3.0,5.0
17143,2016-2017,6,FC Twente,ADO Den Haag,4,1,1,3,0,5,3,9.0,7.0
17144,2016-2017,6,Vitesse,Go Ahead Eagles,2,0,1,3,0,2,2,7.0,4.0
17145,2016-2017,6,Roda JC Kerkrade,sc Heerenveen,0,3,2,0,3,3,-3,2.0,10.0
17146,2016-2017,6,Willem II,SBV Excelsior,1,1,3,1,1,2,0,5.0,7.0
17147,2016-2017,6,Sparta Rotterdam,NEC Nijmegen,2,0,1,3,0,2,2,10.0,4.0
17148,2016-2017,6,PEC Zwolle,AZ Alkmaar,0,2,2,0,3,2,-2,1.0,12.0
17149,2016-2017,6,PSV,Feyenoord,0,1,2,0,3,1,-1,10.0,15.0
17150,2016-2017,6,Heracles Almelo,AFC Ajax,0,2,2,0,3,2,-2,4.0,10.0
17151,2016-2017,7,ADO Den Haag,sc Heerenveen,0,3,2,0,3,3,-3,4.0,12.0
17152,2016-2017,7,FC Groningen,Heracles Almelo,0,0,3,1,1,0,0,6.0,2.0
17153,2016-2017,7,AFC Ajax,PEC Zwolle,5,1,1,3,0,6,4,12.0,1.0
17154,2016-2017,7,AZ Alkmaar,Go Ahead Eagles,2,2,3,1,1,4,0,13.0,4.0
17155,2016-2017,7,SBV Excelsior,PSV,1,3,2,0,3,4,-2,4.0,10.0
17156,2016-2017,7,NEC Nijmegen,Willem II,0,0,3,1,1,0,0,4.0,6.0
17157,2016-2017,7,FC Twente,Vitesse,2,1,1,3,0,3,1,12.0,7.0
17158,2016-2017,7,FC Utrecht,Sparta Rotterdam,2,0,1,3,0,2,2,5.0,7.0
17159,2016-2017,7,Feyenoord,Roda JC Kerkrade,5,0,1,3,0,5,5,15.0,1.0
17160,2016-2017,8,PEC Zwolle,ADO Den Haag,2,1,1,3,0,3,1,4.0,1.0
17161,2016-2017,8,Vitesse,FC Groningen,2,1,1,3,0,3,1,7.0,6.0
17162,2016-2017,8,sc Heerenveen,PSV,1,1,3,1,1,2,0,13.0,8.0
17163,2016-2017,8,Roda JC Kerkrade,NEC Nijmegen,0,1,2,0,3,1,-1,1.0,4.0
17164,2016-2017,8,Go Ahead Eagles,SBV Excelsior,3,0,1,3,0,3,3,7.0,4.0
17165,2016-2017,8,AFC Ajax,FC Utrecht,3,2,1,3,0,5,1,15.0,5.0
17166,2016-2017,8,Willem II,Feyenoord,0,2,2,0,3,2,-2,3.0,15.0
17167,2016-2017,8,Heracles Almelo,FC Twente,1,1,3,1,1,2,0,3.0,10.0
17168,2016-2017,8,Sparta Rotterdam,AZ Alkmaar,1,1,3,1,1,2,0,5.0,11.0
17169,2016-2017,9,Sparta Rotterdam,Willem II,2,2,3,1,1,4,0,6.0,3.0
17170,2016-2017,9,FC Utrecht,Go Ahead Eagles,3,0,1,3,0,3,3,7.0,7.0
17171,2016-2017,9,PSV,Heracles Almelo,1,1,3,1,1,2,0,8.0,3.0
17172,2016-2017,9,AZ Alkmaar,Vitesse,2,2,3,1,1,4,0,9.0,7.0
17173,2016-2017,9,FC Groningen,sc Heerenveen,0,3,2,0,3,3,-3,5.0,13.0
17174,2016-2017,9,FC Twente,PEC Zwolle,2,2,3,1,1,4,0,8.0,5.0
17175,2016-2017,9,SBV Excelsior,Roda JC Kerkrade,0,1,2,0,3,1,-1,4.0,3.0
17176,2016-2017,9,NEC Nijmegen,Feyenoord,1,2,2,0,3,3,-1,4.0,15.0
17177,2016-2017,9,ADO Den Haag,AFC Ajax,0,2,2,0,3,2,-2,0.0,15.0
17178,2016-2017,10,SBV Excelsior,PEC Zwolle,0,2,2,0,3,2,-2,1.0,7.0
17179,2016-2017,10,Go Ahead Eagles,FC Twente,0,2,2,0,3,2,-2,4.0,11.0
17180,2016-2017,10,PSV,Sparta Rotterdam,1,0,1,3,0,1,1,8.0,5.0
17181,2016-2017,10,Roda JC Kerkrade,ADO Den Haag,1,1,3,1,1,2,0,4.0,1.0
17182,2016-2017,10,Willem II,FC Utrecht,0,1,2,0,3,1,-1,3.0,9.0
17183,2016-2017,10,NEC Nijmegen,Vitesse,1,1,3,1,1,2,0,5.0,8.0
17184,2016-2017,10,Feyenoord,AFC Ajax,1,1,3,1,1,2,0,13.0,13.0
17185,2016-2017,10,FC Groningen,AZ Alkmaar,2,0,1,3,0,2,2,7.0,6.0
17186,2016-2017,10,sc Heerenveen,Heracles Almelo,3,1,1,3,0,4,2,13.0,3.0
17187,2016-2017,11,FC Twente,Roda JC Kerkrade,0,0,3,1,1,0,0,9.0,5.0
17188,2016-2017,11,Willem II,FC Groningen,2,1,1,3,0,3,1,5.0,4.0
17189,2016-2017,11,Heracles Almelo,Sparta Rotterdam,2,2,3,1,1,4,0,4.0,3.0
17190,2016-2017,11,Vitesse,PSV,0,2,2,0,3,2,-2,5.0,11.0
17191,2016-2017,11,AFC Ajax,SBV Excelsior,1,0,1,3,0,1,1,13.0,0.0
17192,2016-2017,11,PEC Zwolle,Go Ahead Eagles,3,1,1,3,0,4,2,10.0,4.0
17193,2016-2017,11,Feyenoord,sc Heerenveen,2,2,3,1,1,4,0,11.0,11.0
17194,2016-2017,11,FC Utrecht,NEC Nijmegen,1,1,3,1,1,2,0,10.0,6.0
17195,2016-2017,11,ADO Den Haag,AZ Alkmaar,0,1,2,0,3,1,-1,1.0,6.0
17196,2016-2017,12,Sparta Rotterdam,sc Heerenveen,3,1,1,3,0,4,2,6.0,8.0
17197,2016-2017,12,ADO Den Haag,Willem II,1,0,1,3,0,1,1,4.0,4.0
17198,2016-2017,12,PSV,FC Twente,1,1,3,1,1,2,0,9.0,7.0
17199,2016-2017,12,NEC Nijmegen,FC Groningen,1,1,3,1,1,2,0,6.0,4.0
17200,2016-2017,12,PEC Zwolle,Roda JC Kerkrade,0,0,3,1,1,0,0,11.0,6.0
17201,2016-2017,12,FC Utrecht,SBV Excelsior,2,1,1,3,0,3,1,10.0,0.0
17202,2016-2017,12,AZ Alkmaar,AFC Ajax,2,2,3,1,1,4,0,6.0,11.0
17203,2016-2017,12,Vitesse,Heracles Almelo,1,2,2,0,3,3,-1,5.0,6.0
17204,2016-2017,12,Go Ahead Eagles,Feyenoord,1,0,1,3,0,1,1,6.0,8.0
17205,2016-2017,13,sc Heerenveen,Vitesse,1,1,3,1,1,2,0,8.0,3.0
17206,2016-2017,13,Heracles Almelo,Go Ahead Eagles,2,1,1,3,0,3,1,8.0,3.0
17207,2016-2017,13,Willem II,PSV,0,0,3,1,1,0,0,5.0,9.0
17208,2016-2017,13,SBV Excelsior,Sparta Rotterdam,3,2,1,3,0,5,1,3.0,5.0
17209,2016-2017,13,FC Groningen,ADO Den Haag,2,1,1,3,0,3,1,7.0,4.0
17210,2016-2017,13,Roda JC Kerkrade,AZ Alkmaar,1,1,3,1,1,2,0,7.0,6.0
17211,2016-2017,13,AFC Ajax,NEC Nijmegen,5,0,1,3,0,5,5,11.0,3.0
17212,2016-2017,13,FC Twente,FC Utrecht,1,1,3,1,1,2,0,7.0,11.0
17213,2016-2017,13,Feyenoord,PEC Zwolle,3,0,1,3,0,3,3,8.0,8.0
17214,2016-2017,14,Go Ahead Eagles,Willem II,0,1,2,0,3,1,-1,3.0,7.0
17215,2016-2017,14,Vitesse,SBV Excelsior,2,2,3,1,1,4,0,3.0,4.0
17216,2016-2017,14,PSV,ADO Den Haag,3,1,1,3,0,4,2,11.0,4.0
17217,2016-2017,14,PEC Zwolle,FC Groningen,0,4,2,0,3,4,-4,7.0,10.0
17218,2016-2017,14,NEC Nijmegen,FC Twente,3,2,1,3,0,5,1,6.0,6.0
17219,2016-2017,14,Sparta Rotterdam,Roda JC Kerkrade,2,2,3,1,1,4,0,5.0,5.0
17220,2016-2017,14,AZ Alkmaar,Heracles Almelo,5,1,1,3,0,6,4,8.0,7.0
17221,2016-2017,14,sc Heerenveen,AFC Ajax,0,1,2,0,3,1,-1,5.0,11.0
17222,2016-2017,14,FC Utrecht,Feyenoord,3,3,3,1,1,6,0,9.0,6.0
17223,2016-2017,15,Heracles Almelo,NEC Nijmegen,2,0,1,3,0,2,2,10.0,5.0
17224,2016-2017,15,Go Ahead Eagles,sc Heerenveen,1,3,2,0,3,4,-2,3.0,5.0
17225,2016-2017,15,SBV Excelsior,AZ Alkmaar,3,3,3,1,1,6,0,5.0,9.0
17226,2016-2017,15,Roda JC Kerkrade,PSV,0,0,3,1,1,0,0,5.0,9.0
17227,2016-2017,15,Vitesse,PEC Zwolle,3,1,1,3,0,4,2,5.0,4.0
17228,2016-2017,15,ADO Den Haag,FC Utrecht,0,2,2,0,3,2,-2,3.0,9.0
17229,2016-2017,15,Feyenoord,Sparta Rotterdam,6,1,1,3,0,7,5,8.0,5.0
17230,2016-2017,15,Willem II,FC Twente,0,0,3,1,1,0,0,8.0,4.0
17231,2016-2017,15,AFC Ajax,FC Groningen,2,0,1,3,0,2,2,13.0,7.0
17232,2016-2017,16,FC Groningen,Roda JC Kerkrade,2,0,1,3,0,2,2,10.0,4.0
17233,2016-2017,16,NEC Nijmegen,ADO Den Haag,3,0,1,3,0,3,3,7.0,3.0
17234,2016-2017,16,PSV,Go Ahead Eagles,1,0,1,3,0,1,1,9.0,3.0
17235,2016-2017,16,sc Heerenveen,SBV Excelsior,2,1,1,3,0,3,1,7.0,5.0
17236,2016-2017,16,PEC Zwolle,Willem II,0,0,3,1,1,0,0,2.0,6.0
17237,2016-2017,16,Sparta Rotterdam,Vitesse,0,1,2,0,3,1,-1,4.0,8.0
17238,2016-2017,16,AZ Alkmaar,Feyenoord,0,4,2,0,3,4,-4,6.0,10.0
17239,2016-2017,16,FC Utrecht,Heracles Almelo,2,0,1,3,0,2,2,11.0,9.0
17240,2016-2017,16,FC Twente,AFC Ajax,1,0,1,3,0,1,1,6.0,10.0
17241,2016-2017,17,Willem II,sc Heerenveen,2,1,1,3,0,3,1,9.0,7.0
17242,2016-2017,17,Roda JC Kerkrade,FC Utrecht,0,0,3,1,1,0,0,4.0,9.0
17243,2016-2017,17,Feyenoord,Vitesse,3,1,1,3,0,4,2,13.0,8.0
17244,2016-2017,17,FC Twente,AZ Alkmaar,1,2,2,0,3,3,-1,5.0,8.0
17245,2016-2017,17,SBV Excelsior,NEC Nijmegen,2,2,3,1,1,4,0,6.0,7.0
17246,2016-2017,17,ADO Den Haag,Sparta Rotterdam,1,0,1,3,0,1,1,3.0,1.0
17247,2016-2017,17,Heracles Almelo,PEC Zwolle,3,0,1,3,0,3,3,9.0,1.0
17248,2016-2017,17,FC Groningen,Go Ahead Eagles,1,1,3,1,1,2,0,10.0,1.0
17249,2016-2017,17,AFC Ajax,PSV,1,1,3,1,1,2,0,10.0,9.0
17250,2016-2017,18,Go Ahead Eagles,AZ Alkmaar,1,3,2,0,3,4,-2,1.0,10.0
17251,2016-2017,18,sc Heerenveen,ADO Den Haag,2,0,1,3,0,2,2,9.0,3.0
17252,2016-2017,18,Heracles Almelo,FC Groningen,1,4,2,0,3,5,-3,6.0,10.0
17253,2016-2017,18,PSV,SBV Excelsior,2,0,1,3,0,2,2,11.0,3.0
17254,2016-2017,18,Sparta Rotterdam,FC Utrecht,1,2,2,0,3,3,-1,1.0,11.0
17255,2016-2017,18,Roda JC Kerkrade,Feyenoord,0,2,2,0,3,2,-2,3.0,13.0
17256,2016-2017,18,PEC Zwolle,AFC Ajax,1,3,2,0,3,4,-2,1.0,10.0
17257,2016-2017,18,Vitesse,FC Twente,3,1,1,3,0,4,2,10.0,4.0
17258,2016-2017,18,Willem II,NEC Nijmegen,0,1,2,0,3,1,-1,8.0,10.0
17259,2016-2017,19,FC Twente,Heracles Almelo,1,0,1,3,0,1,1,7.0,6.0
17260,2016-2017,19,AZ Alkmaar,Sparta Rotterdam,1,1,3,1,1,2,0,8.0,1.0
17261,2016-2017,19,ADO Den Haag,PEC Zwolle,1,2,2,0,3,3,-1,3.0,4.0
17262,2016-2017,19,Feyenoord,Willem II,1,0,1,3,0,1,1,15.0,5.0
17263,2016-2017,19,FC Groningen,Vitesse,1,1,3,1,1,2,0,8.0,10.0
17264,2016-2017,19,FC Utrecht,AFC Ajax,0,1,2,0,3,1,-1,10.0,10.0
17265,2016-2017,19,SBV Excelsior,Go Ahead Eagles,1,1,3,1,1,2,0,3.0,2.0
17266,2016-2017,19,NEC Nijmegen,Roda JC Kerkrade,2,0,1,3,0,2,2,10.0,2.0
17267,2016-2017,19,PSV,sc Heerenveen,4,3,1,3,0,7,1,11.0,9.0
17268,2016-2017,20,Willem II,Sparta Rotterdam,3,2,1,3,0,5,1,7.0,1.0
17269,2016-2017,20,Go Ahead Eagles,FC Utrecht,0,1,2,0,3,1,-1,2.0,10.0
17270,2016-2017,20,Heracles Almelo,PSV,1,2,2,0,3,3,-1,3.0,13.0
17271,2016-2017,20,Roda JC Kerkrade,SBV Excelsior,4,0,1,3,0,4,4,4.0,2.0
17272,2016-2017,20,sc Heerenveen,FC Groningen,0,0,3,1,1,0,0,7.0,9.0
17273,2016-2017,20,Vitesse,AZ Alkmaar,2,1,1,3,0,3,1,10.0,7.0
17274,2016-2017,20,AFC Ajax,ADO Den Haag,3,0,1,3,0,3,3,10.0,3.0
17275,2016-2017,20,PEC Zwolle,FC Twente,1,2,2,0,3,3,-1,4.0,9.0
17276,2016-2017,20,Feyenoord,NEC Nijmegen,4,0,1,3,0,4,4,15.0,10.0
17277,2016-2017,21,ADO Den Haag,Vitesse,0,2,2,0,3,2,-2,3.0,10.0
17278,2016-2017,21,NEC Nijmegen,Go Ahead Eagles,1,2,2,0,3,3,-1,7.0,5.0
17279,2016-2017,21,AZ Alkmaar,PSV,2,4,2,0,3,6,-2,7.0,13.0
17280,2016-2017,21,Willem II,Heracles Almelo,1,3,2,0,3,4,-2,6.0,6.0
17281,2016-2017,21,FC Groningen,SBV Excelsior,1,1,3,1,1,2,0,7.0,3.0
17282,2016-2017,21,Roda JC Kerkrade,AFC Ajax,0,2,2,0,3,2,-2,4.0,13.0
17283,2016-2017,21,FC Twente,Feyenoord,0,2,2,0,3,2,-2,6.0,15.0
17284,2016-2017,21,Sparta Rotterdam,PEC Zwolle,2,3,2,0,3,5,-1,1.0,6.0
17285,2016-2017,21,FC Utrecht,sc Heerenveen,1,0,1,3,0,1,1,10.0,4.0
17286,2016-2017,22,PEC Zwolle,NEC Nijmegen,2,0,1,3,0,2,2,9.0,6.0
17287,2016-2017,22,Heracles Almelo,Roda JC Kerkrade,2,2,3,1,1,4,0,4.0,4.0
17288,2016-2017,22,Go Ahead Eagles,ADO Den Haag,3,1,1,3,0,4,2,7.0,0.0
17289,2016-2017,22,Feyenoord,FC Groningen,2,0,1,3,0,2,2,15.0,6.0
17290,2016-2017,22,Vitesse,Willem II,0,2,2,0,3,2,-2,10.0,6.0
17291,2016-2017,22,SBV Excelsior,FC Twente,1,1,3,1,1,2,0,3.0,7.0
17292,2016-2017,22,AFC Ajax,Sparta Rotterdam,2,0,1,3,0,2,2,15.0,1.0
17293,2016-2017,22,sc Heerenveen,AZ Alkmaar,1,2,2,0,3,3,-1,4.0,7.0
17294,2016-2017,22,PSV,FC Utrecht,3,0,1,3,0,3,3,15.0,9.0
17295,2016-2017,23,Roda JC Kerkrade,Go Ahead Eagles,1,0,1,3,0,1,1,7.0,7.0
17296,2016-2017,23,FC Twente,sc Heerenveen,1,0,1,3,0,1,1,10.0,1.0
17297,2016-2017,23,PSV,NEC Nijmegen,3,1,1,3,0,4,2,15.0,3.0
17298,2016-2017,23,Heracles Almelo,SBV Excelsior,4,0,1,3,0,4,4,7.0,3.0
17299,2016-2017,23,FC Utrecht,PEC Zwolle,3,1,1,3,0,4,2,9.0,9.0
17300,2016-2017,23,Willem II,AZ Alkmaar,1,1,3,1,1,2,0,7.0,5.0
17301,2016-2017,23,Vitesse,AFC Ajax,0,1,2,0,3,1,-1,7.0,15.0
17302,2016-2017,23,Sparta Rotterdam,FC Groningen,2,2,3,1,1,4,0,2.0,4.0
17303,2016-2017,23,ADO Den Haag,Feyenoord,0,1,2,0,3,1,-1,0.0,15.0
17304,2016-2017,24,ADO Den Haag,FC Twente,1,1,3,1,1,2,0,1.0,8.0
17305,2016-2017,24,FC Groningen,FC Utrecht,2,3,2,0,3,5,-1,3.0,12.0
17306,2016-2017,24,SBV Excelsior,Willem II,0,2,2,0,3,2,-2,2.0,10.0
17307,2016-2017,24,NEC Nijmegen,Sparta Rotterdam,0,1,2,0,3,1,-1,0.0,4.0
17308,2016-2017,24,sc Heerenveen,Roda JC Kerkrade,3,0,1,3,0,3,3,4.0,7.0
17309,2016-2017,24,Go Ahead Eagles,Vitesse,1,3,2,0,3,4,-2,6.0,9.0
17310,2016-2017,24,AZ Alkmaar,PEC Zwolle,1,1,3,1,1,2,0,5.0,7.0
17311,2016-2017,24,Feyenoord,PSV,2,1,1,3,0,3,1,15.0,12.0
17312,2016-2017,24,AFC Ajax,Heracles Almelo,4,1,1,3,0,5,3,15.0,7.0
17313,2016-2017,25,sc Heerenveen,Go Ahead Eagles,2,2,3,1,1,4,0,4.0,7.0
17314,2016-2017,25,FC Twente,Willem II,2,1,1,3,0,3,1,8.0,7.0
17315,2016-2017,25,PSV,Roda JC Kerkrade,4,0,1,3,0,4,4,12.0,4.0
17316,2016-2017,25,PEC Zwolle,Vitesse,3,1,1,3,0,4,2,10.0,6.0
17317,2016-2017,25,AZ Alkmaar,SBV Excelsior,1,1,3,1,1,2,0,6.0,3.0
17318,2016-2017,25,Sparta Rotterdam,Feyenoord,1,0,1,3,0,1,1,7.0,12.0
17319,2016-2017,25,FC Groningen,AFC Ajax,1,1,3,1,1,2,0,3.0,13.0
17320,2016-2017,25,FC Utrecht,ADO Den Haag,1,1,3,1,1,2,0,10.0,2.0
17321,2016-2017,25,NEC Nijmegen,Heracles Almelo,3,1,1,3,0,4,2,3.0,7.0
17322,2016-2017,26,Vitesse,Sparta Rotterdam,5,0,1,3,0,5,5,6.0,7.0
17323,2016-2017,26,ADO Den Haag,NEC Nijmegen,1,0,1,3,0,1,1,5.0,3.0
17324,2016-2017,26,Go Ahead Eagles,PSV,1,3,2,0,3,4,-2,4.0,12.0
17325,2016-2017,26,Heracles Almelo,FC Utrecht,2,1,1,3,0,3,1,7.0,7.0
17326,2016-2017,26,SBV Excelsior,sc Heerenveen,4,1,1,3,0,5,3,5.0,4.0
17327,2016-2017,26,Willem II,PEC Zwolle,2,0,1,3,0,2,2,10.0,7.0
17328,2016-2017,26,Feyenoord,AZ Alkmaar,5,2,1,3,0,7,3,12.0,6.0
17329,2016-2017,26,Roda JC Kerkrade,FC Groningen,3,1,1,3,0,4,2,7.0,2.0
17330,2016-2017,26,AFC Ajax,FC Twente,3,0,1,3,0,3,3,13.0,8.0
17331,2016-2017,27,Roda JC Kerkrade,FC Twente,0,3,2,0,3,3,-3,6.0,10.0
17332,2016-2017,27,FC Groningen,Willem II,1,1,3,1,1,2,0,3.0,8.0
17333,2016-2017,27,NEC Nijmegen,FC Utrecht,0,3,2,0,3,3,-3,3.0,10.0
17334,2016-2017,27,PSV,Vitesse,1,0,1,3,0,1,1,12.0,6.0
17335,2016-2017,27,Sparta Rotterdam,Heracles Almelo,3,1,1,3,0,4,2,10.0,6.0
17336,2016-2017,27,sc Heerenveen,Feyenoord,1,2,2,0,3,3,-1,4.0,12.0
17337,2016-2017,27,Go Ahead Eagles,PEC Zwolle,1,3,2,0,3,4,-2,1.0,7.0
17338,2016-2017,27,SBV Excelsior,AFC Ajax,1,1,3,1,1,2,0,5.0,11.0
17339,2016-2017,27,AZ Alkmaar,ADO Den Haag,4,0,1,3,0,4,4,6.0,5.0
17340,2016-2017,28,AZ Alkmaar,FC Groningen,0,0,3,1,1,0,0,6.0,3.0
17341,2016-2017,28,PEC Zwolle,SBV Excelsior,1,1,3,1,1,2,0,8.0,6.0
17342,2016-2017,28,Sparta Rotterdam,PSV,0,2,2,0,3,2,-2,9.0,12.0
17343,2016-2017,28,Heracles Almelo,sc Heerenveen,4,1,1,3,0,5,3,6.0,4.0
17344,2016-2017,28,FC Utrecht,Willem II,2,0,1,3,0,2,2,10.0,7.0
17345,2016-2017,28,Vitesse,NEC Nijmegen,2,1,1,3,0,3,1,9.0,3.0
17346,2016-2017,28,ADO Den Haag,Roda JC Kerkrade,4,1,1,3,0,5,3,8.0,3.0
17347,2016-2017,28,AFC Ajax,Feyenoord,2,1,1,3,0,3,1,11.0,9.0
17348,2016-2017,28,FC Twente,Go Ahead Eagles,1,2,2,0,3,3,-1,7.0,4.0
17349,2016-2017,29,SBV Excelsior,FC Utrecht,1,3,2,0,3,4,-2,6.0,10.0
17350,2016-2017,29,sc Heerenveen,Sparta Rotterdam,3,0,1,3,0,3,3,4.0,6.0
17351,2016-2017,29,Heracles Almelo,Vitesse,0,1,2,0,3,1,-1,6.0,9.0
17352,2016-2017,29,FC Groningen,NEC Nijmegen,2,0,1,3,0,2,2,6.0,3.0
17353,2016-2017,29,AFC Ajax,AZ Alkmaar,4,1,1,3,0,5,3,11.0,5.0
17354,2016-2017,29,Feyenoord,Go Ahead Eagles,8,0,1,3,0,8,8,9.0,4.0
17355,2016-2017,29,Willem II,ADO Den Haag,1,2,2,0,3,3,-1,4.0,10.0
17356,2016-2017,29,Roda JC Kerkrade,PEC Zwolle,2,1,1,3,0,3,1,6.0,7.0
17357,2016-2017,29,FC Twente,PSV,2,2,3,1,1,4,0,7.0,13.0
17358,2016-2017,30,Sparta Rotterdam,SBV Excelsior,2,3,2,0,3,5,-1,3.0,8.0
17359,2016-2017,30,Vitesse,sc Heerenveen,4,2,1,3,0,6,2,12.0,3.0
17360,2016-2017,30,ADO Den Haag,FC Groningen,4,3,1,3,0,7,1,12.0,5.0
17361,2016-2017,30,NEC Nijmegen,AFC Ajax,1,5,2,0,3,6,-4,0.0,13.0
17362,2016-2017,30,Go Ahead Eagles,Heracles Almelo,1,4,2,0,3,5,-3,3.0,9.0
17363,2016-2017,30,AZ Alkmaar,Roda JC Kerkrade,1,1,3,1,1,2,0,5.0,7.0
17364,2016-2017,30,PEC Zwolle,Feyenoord,2,2,3,1,1,4,0,5.0,10.0
17365,2016-2017,30,FC Utrecht,FC Twente,3,0,1,3,0,3,3,12.0,4.0
17366,2016-2017,30,PSV,Willem II,5,0,1,3,0,5,5,13.0,4.0
17367,2016-2017,31,Heracles Almelo,AZ Alkmaar,1,2,2,0,3,3,-1,6.0,8.0
17368,2016-2017,31,Roda JC Kerkrade,Sparta Rotterdam,3,1,1,3,0,4,2,7.0,3.0
17369,2016-2017,31,ADO Den Haag,PSV,1,1,3,1,1,2,0,10.0,11.0
17370,2016-2017,31,SBV Excelsior,Vitesse,1,0,1,3,0,1,1,8.0,9.0
17371,2016-2017,31,FC Twente,NEC Nijmegen,3,0,1,3,0,3,3,7.0,0.0
17372,2016-2017,31,Willem II,Go Ahead Eagles,2,0,1,3,0,2,2,4.0,3.0
17373,2016-2017,31,Feyenoord,FC Utrecht,2,0,1,3,0,2,2,10.0,12.0
17374,2016-2017,31,FC Groningen,PEC Zwolle,5,1,1,3,0,6,4,8.0,5.0
17375,2016-2017,31,AFC Ajax,sc Heerenveen,5,1,1,3,0,6,4,13.0,3.0
17376,2016-2017,32,sc Heerenveen,Willem II,1,0,1,3,0,1,1,6.0,3.0
17377,2016-2017,32,NEC Nijmegen,SBV Excelsior,0,1,2,0,3,1,-1,0.0,10.0
17378,2016-2017,32,PEC Zwolle,Heracles Almelo,1,2,2,0,3,3,-1,2.0,9.0
17379,2016-2017,32,AZ Alkmaar,FC Twente,2,1,1,3,0,3,1,8.0,4.0
17380,2016-2017,32,Go Ahead Eagles,FC Groningen,2,3,2,0,3,5,-1,3.0,10.0
17381,2016-2017,32,FC Utrecht,Roda JC Kerkrade,1,0,1,3,0,1,1,12.0,7.0
17382,2016-2017,32,Sparta Rotterdam,ADO Den Haag,0,1,2,0,3,1,-1,0.0,13.0
17383,2016-2017,32,Vitesse,Feyenoord,0,2,2,0,3,2,-2,9.0,10.0
17384,2016-2017,32,PSV,AFC Ajax,1,0,1,3,0,1,1,11.0,12.0
17385,2016-2017,33,AFC Ajax,Go Ahead Eagles,4,0,1,3,0,4,4,12.0,0.0
17386,2016-2017,33,SBV Excelsior,Feyenoord,3,0,1,3,0,3,3,12.0,10.0
17387,2016-2017,33,FC Groningen,PSV,1,1,3,1,1,2,0,10.0,9.0
17388,2016-2017,33,Roda JC Kerkrade,Willem II,1,0,1,3,0,1,1,10.0,3.0
17389,2016-2017,33,FC Utrecht,Vitesse,1,0,1,3,0,1,1,12.0,6.0
17390,2016-2017,33,Heracles Almelo,ADO Den Haag,4,0,1,3,0,4,4,9.0,10.0
17391,2016-2017,33,NEC Nijmegen,AZ Alkmaar,2,1,1,3,0,3,1,3.0,7.0
17392,2016-2017,33,Sparta Rotterdam,FC Twente,1,0,1,3,0,1,1,3.0,4.0
17393,2016-2017,33,PEC Zwolle,sc Heerenveen,2,1,1,3,0,3,1,4.0,6.0
17394,2016-2017,34,ADO Den Haag,SBV Excelsior,4,1,1,3,0,5,3,10.0,12.0
17395,2016-2017,34,AZ Alkmaar,FC Utrecht,2,3,2,0,3,5,-1,7.0,12.0
17396,2016-2017,34,Feyenoord,Heracles Almelo,3,1,1,3,0,4,2,10.0,9.0
17397,2016-2017,34,Go Ahead Eagles,Sparta Rotterdam,1,3,2,0,3,4,-2,0.0,6.0
17398,2016-2017,34,FC Twente,FC Groningen,3,5,2,0,3,8,-2,3.0,10.0
17399,2016-2017,34,sc Heerenveen,NEC Nijmegen,0,2,2,0,3,2,-2,3.0,6.0
17400,2016-2017,34,Willem II,AFC Ajax,1,3,2,0,3,4,-2,3.0,12.0
17401,2016-2017,34,PSV,PEC Zwolle,4,1,1,3,0,5,3,11.0,4.0
17402,2016-2017,34,Vitesse,Roda JC Kerkrade,3,0,1,3,0,3,3,6.0,7.0
17403,2017-2018,1,ADO Den Haag,FC Utrecht,0,3,2,0,3,3,-3,7.0,12.0
17404,2017-2018,1,VVV-Venlo,Sparta Rotterdam,3,0,1,3,0,3,3,9.0,6.0
17405,2017-2018,1,PSV,AZ Alkmaar,3,2,1,3,0,5,1,11.0,6.0
17406,2017-2018,1,Heracles Almelo,AFC Ajax,2,1,1,3,0,3,1,9.0,9.0
17407,2017-2018,1,Vitesse,NAC Breda,4,1,1,3,0,5,3,6.0,1.0
17408,2017-2018,1,PEC Zwolle,Roda JC Kerkrade,4,2,1,3,0,6,2,6.0,6.0
17409,2017-2018,1,Feyenoord,FC Twente,2,1,1,3,0,3,1,12.0,3.0
17410,2017-2018,1,Willem II,SBV Excelsior,1,2,2,0,3,3,-1,3.0,12.0
17411,2017-2018,1,FC Groningen,sc Heerenveen,3,3,3,1,1,6,0,11.0,4.0
17412,2017-2018,2,Roda JC Kerkrade,Vitesse,1,3,2,0,3,4,-2,3.0,9.0
17413,2017-2018,2,FC Twente,VVV-Venlo,1,2,2,0,3,3,-1,0.0,11.0
17414,2017-2018,2,AZ Alkmaar,ADO Den Haag,2,0,1,3,0,2,2,6.0,6.0
17415,2017-2018,2,sc Heerenveen,Heracles Almelo,1,1,3,1,1,2,0,5.0,10.0
17416,2017-2018,2,SBV Excelsior,Feyenoord,0,1,2,0,3,1,-1,9.0,12.0
17417,2017-2018,2,AFC Ajax,FC Groningen,3,1,1,3,0,4,2,9.0,8.0
17418,2017-2018,2,FC Utrecht,Willem II,2,0,1,3,0,2,2,15.0,0.0
17419,2017-2018,2,Sparta Rotterdam,PEC Zwolle,1,1,3,1,1,2,0,7.0,7.0
17420,2017-2018,2,NAC Breda,PSV,1,4,2,0,3,5,-3,0.0,13.0
17421,2017-2018,3,NAC Breda,Sparta Rotterdam,2,2,3,1,1,4,0,1.0,8.0
17422,2017-2018,3,Vitesse,AZ Alkmaar,1,2,2,0,3,3,-1,9.0,6.0
17423,2017-2018,3,ADO Den Haag,sc Heerenveen,1,2,2,0,3,3,-1,3.0,5.0
17424,2017-2018,3,PEC Zwolle,FC Twente,2,0,1,3,0,2,2,10.0,0.0
17425,2017-2018,3,Heracles Almelo,SBV Excelsior,2,2,3,1,1,4,0,8.0,7.0
17426,2017-2018,3,Feyenoord,Willem II,5,0,1,3,0,5,5,12.0,0.0
17427,2017-2018,3,VVV-Venlo,AFC Ajax,0,2,2,0,3,2,-2,10.0,12.0
17428,2017-2018,3,FC Groningen,FC Utrecht,2,1,1,3,0,3,1,8.0,12.0
17429,2017-2018,3,PSV,Roda JC Kerkrade,2,0,1,3,0,2,2,13.0,3.0
17430,2017-2018,4,Willem II,ADO Den Haag,1,2,2,0,3,3,-1,0.0,6.0
17431,2017-2018,4,Heracles Almelo,Feyenoord,2,4,2,0,3,6,-2,5.0,15.0
17432,2017-2018,4,AFC Ajax,PEC Zwolle,3,0,1,3,0,3,3,12.0,7.0
17433,2017-2018,4,SBV Excelsior,Vitesse,0,3,2,0,3,3,-3,4.0,12.0
17434,2017-2018,4,sc Heerenveen,PSV,2,0,1,3,0,2,2,8.0,12.0
17435,2017-2018,4,FC Utrecht,Roda JC Kerkrade,2,0,1,3,0,2,2,12.0,0.0
17436,2017-2018,4,Sparta Rotterdam,FC Twente,1,0,1,3,0,1,1,8.0,0.0
17437,2017-2018,4,AZ Alkmaar,NAC Breda,2,1,1,3,0,3,1,9.0,1.0
17438,2017-2018,4,FC Groningen,VVV-Venlo,1,1,3,1,1,2,0,8.0,10.0
17439,2017-2018,5,Sparta Rotterdam,AZ Alkmaar,0,2,2,0,3,2,-2,5.0,12.0
17440,2017-2018,5,SBV Excelsior,sc Heerenveen,1,2,2,0,3,3,-1,4.0,11.0
17441,2017-2018,5,Roda JC Kerkrade,Willem II,1,3,2,0,3,4,-2,0.0,3.0
17442,2017-2018,5,NAC Breda,FC Groningen,2,1,1,3,0,3,1,4.0,5.0
17443,2017-2018,5,PEC Zwolle,Heracles Almelo,2,1,1,3,0,3,1,10.0,5.0
17444,2017-2018,5,ADO Den Haag,AFC Ajax,1,1,3,1,1,2,0,4.0,10.0
17445,2017-2018,5,FC Twente,FC Utrecht,4,0,1,3,0,4,4,3.0,9.0
17446,2017-2018,5,Vitesse,VVV-Venlo,1,1,3,1,1,2,0,10.0,8.0
17447,2017-2018,5,PSV,Feyenoord,1,0,1,3,0,1,1,12.0,12.0
17448,2017-2018,6,Willem II,sc Heerenveen,1,2,2,0,3,3,-1,3.0,13.0
17449,2017-2018,6,Feyenoord,NAC Breda,0,2,2,0,3,2,-2,9.0,7.0
17450,2017-2018,6,Heracles Almelo,Roda JC Kerkrade,2,1,1,3,0,3,1,5.0,0.0
17451,2017-2018,6,ADO Den Haag,Sparta Rotterdam,1,0,1,3,0,1,1,7.0,5.0
17452,2017-2018,6,FC Utrecht,PSV,1,7,2,0,3,8,-6,6.0,12.0
17453,2017-2018,6,AFC Ajax,Vitesse,1,2,2,0,3,3,-1,10.0,10.0
17454,2017-2018,6,VVV-Venlo,PEC Zwolle,1,1,3,1,1,2,0,6.0,8.0
17455,2017-2018,6,FC Groningen,FC Twente,1,0,1,3,0,1,1,7.0,3.0
17456,2017-2018,6,AZ Alkmaar,SBV Excelsior,0,2,2,0,3,2,-2,12.0,4.0
17457,2017-2018,7,FC Twente,Heracles Almelo,2,1,1,3,0,3,1,6.0,4.0
17458,2017-2018,7,NAC Breda,ADO Den Haag,0,1,2,0,3,1,-1,7.0,10.0
17459,2017-2018,7,PEC Zwolle,FC Groningen,3,2,1,3,0,5,1,10.0,7.0
17460,2017-2018,7,PSV,Willem II,4,0,1,3,0,4,4,12.0,3.0
17461,2017-2018,7,SBV Excelsior,VVV-Venlo,0,2,2,0,3,2,-2,4.0,6.0
17462,2017-2018,7,AZ Alkmaar,Feyenoord,0,4,2,0,3,4,-4,9.0,9.0
17463,2017-2018,7,sc Heerenveen,AFC Ajax,0,4,2,0,3,4,-4,12.0,10.0
17464,2017-2018,7,Vitesse,FC Utrecht,1,1,3,1,1,2,0,8.0,4.0
17465,2017-2018,7,Sparta Rotterdam,Roda JC Kerkrade,1,2,2,0,3,3,-1,4.0,3.0
17466,2017-2018,8,Roda JC Kerkrade,NAC Breda,1,0,1,3,0,1,1,6.0,6.0
17467,2017-2018,8,AFC Ajax,Sparta Rotterdam,4,0,1,3,0,4,4,10.0,3.0
17468,2017-2018,8,Feyenoord,PEC Zwolle,0,0,3,1,1,0,0,7.0,8.0
17469,2017-2018,8,FC Utrecht,sc Heerenveen,3,1,1,3,0,4,2,7.0,9.0
17470,2017-2018,8,Heracles Almelo,Vitesse,1,1,3,1,1,2,0,4.0,9.0
17471,2017-2018,8,Willem II,FC Twente,3,1,1,3,0,4,2,6.0,6.0
17472,2017-2018,8,VVV-Venlo,PSV,2,5,2,0,3,7,-3,6.0,12.0
17473,2017-2018,8,FC Groningen,AZ Alkmaar,1,1,3,1,1,2,0,5.0,7.0
17474,2017-2018,8,ADO Den Haag,SBV Excelsior,1,2,2,0,3,3,-1,10.0,6.0
17475,2017-2018,9,FC Groningen,Willem II,0,1,2,0,3,1,-1,4.0,9.0
17476,2017-2018,9,NAC Breda,PEC Zwolle,0,2,2,0,3,2,-2,6.0,11.0
17477,2017-2018,9,SBV Excelsior,Sparta Rotterdam,1,1,3,1,1,2,0,7.0,1.0
17478,2017-2018,9,VVV-Venlo,ADO Den Haag,0,2,2,0,3,2,-2,5.0,10.0
17479,2017-2018,9,FC Twente,Roda JC Kerkrade,3,0,1,3,0,3,3,9.0,6.0
17480,2017-2018,9,PSV,Heracles Almelo,3,0,1,3,0,3,3,15.0,4.0
17481,2017-2018,9,Feyenoord,AFC Ajax,1,4,2,0,3,5,-3,4.0,10.0
17482,2017-2018,9,AZ Alkmaar,FC Utrecht,3,0,1,3,0,3,3,7.0,4.0
17483,2017-2018,9,sc Heerenveen,Vitesse,0,4,2,0,3,4,-4,6.0,9.0
17484,2017-2018,10,FC Twente,SBV Excelsior,1,3,2,0,3,4,-2,6.0,10.0
17485,2017-2018,10,Heracles Almelo,VVV-Venlo,3,0,1,3,0,3,3,7.0,4.0
17486,2017-2018,10,Roda JC Kerkrade,Feyenoord,1,1,3,1,1,2,0,7.0,5.0
17487,2017-2018,10,Willem II,AFC Ajax,1,3,2,0,3,4,-2,6.0,12.0
17488,2017-2018,10,PEC Zwolle,ADO Den Haag,2,0,1,3,0,2,2,11.0,9.0
17489,2017-2018,10,Vitesse,PSV,2,4,2,0,3,6,-2,8.0,15.0
17490,2017-2018,10,FC Utrecht,NAC Breda,2,2,3,1,1,4,0,5.0,4.0
17491,2017-2018,10,Sparta Rotterdam,FC Groningen,2,1,1,3,0,3,1,4.0,4.0
17492,2017-2018,10,sc Heerenveen,AZ Alkmaar,1,2,2,0,3,3,-1,3.0,7.0
17493,2017-2018,11,Sparta Rotterdam,sc Heerenveen,0,0,3,1,1,0,0,5.0,1.0
17494,2017-2018,11,AZ Alkmaar,Willem II,3,2,1,3,0,5,1,10.0,6.0
17495,2017-2018,11,SBV Excelsior,Roda JC Kerkrade,1,0,1,3,0,1,1,10.0,7.0
17496,2017-2018,11,Heracles Almelo,FC Groningen,2,1,1,3,0,3,1,7.0,1.0
17497,2017-2018,11,VVV-Venlo,NAC Breda,0,0,3,1,1,0,0,4.0,2.0
17498,2017-2018,11,ADO Den Haag,Feyenoord,2,2,3,1,1,4,0,7.0,6.0
17499,2017-2018,11,AFC Ajax,FC Utrecht,1,2,2,0,3,3,-1,12.0,8.0
17500,2017-2018,11,Vitesse,PEC Zwolle,0,0,3,1,1,0,0,6.0,11.0
17501,2017-2018,11,PSV,FC Twente,4,3,1,3,0,7,1,15.0,6.0
17502,2017-2018,12,FC Twente,sc Heerenveen,0,4,2,0,3,4,-4,3.0,4.0
17503,2017-2018,12,Feyenoord,VVV-Venlo,1,1,3,1,1,2,0,4.0,2.0
17504,2017-2018,12,NAC Breda,AFC Ajax,0,8,2,0,3,8,-8,2.0,12.0
17505,2017-2018,12,Willem II,Sparta Rotterdam,2,2,3,1,1,4,0,7.0,6.0
17506,2017-2018,12,ADO Den Haag,Heracles Almelo,4,1,1,3,0,5,3,7.0,7.0
17507,2017-2018,12,PEC Zwolle,PSV,0,1,2,0,3,1,-1,8.0,15.0
17508,2017-2018,12,FC Utrecht,SBV Excelsior,3,1,1,3,0,4,2,10.0,10.0
17509,2017-2018,12,FC Groningen,Vitesse,4,2,1,3,0,6,2,4.0,5.0
17510,2017-2018,12,Roda JC Kerkrade,AZ Alkmaar,0,1,2,0,3,1,-1,4.0,13.0
17511,2017-2018,13,AZ Alkmaar,FC Twente,2,0,1,3,0,2,2,15.0,3.0
17512,2017-2018,13,VVV-Venlo,Willem II,3,3,3,1,1,6,0,3.0,5.0
17513,2017-2018,13,Heracles Almelo,NAC Breda,2,1,1,3,0,3,1,9.0,2.0
17514,2017-2018,13,FC Groningen,Feyenoord,0,2,2,0,3,2,-2,3.0,6.0
17515,2017-2018,13,sc Heerenveen,PEC Zwolle,1,2,2,0,3,3,-1,4.0,10.0
17516,2017-2018,13,AFC Ajax,Roda JC Kerkrade,5,1,1,3,0,6,4,12.0,1.0
17517,2017-2018,13,SBV Excelsior,PSV,1,2,2,0,3,3,-1,7.0,15.0
17518,2017-2018,13,Sparta Rotterdam,FC Utrecht,1,3,2,0,3,4,-2,6.0,10.0
17519,2017-2018,13,Vitesse,ADO Den Haag,2,0,1,3,0,2,2,7.0,7.0
17520,2017-2018,14,PEC Zwolle,FC Utrecht,1,1,3,1,1,2,0,8.0,11.0
17521,2017-2018,14,ADO Den Haag,FC Groningen,0,3,2,0,3,3,-3,4.0,6.0
17522,2017-2018,14,FC Twente,AFC Ajax,3,3,3,1,1,6,0,1.0,10.0
17523,2017-2018,14,Feyenoord,Vitesse,1,0,1,3,0,1,1,9.0,4.0
17524,2017-2018,14,Willem II,Heracles Almelo,3,1,1,3,0,4,2,5.0,9.0
17525,2017-2018,14,VVV-Venlo,AZ Alkmaar,0,2,2,0,3,2,-2,3.0,15.0
17526,2017-2018,14,PSV,Sparta Rotterdam,1,0,1,3,0,1,1,15.0,5.0
17527,2017-2018,14,Roda JC Kerkrade,sc Heerenveen,2,1,1,3,0,3,1,4.0,4.0
17528,2017-2018,14,NAC Breda,SBV Excelsior,3,1,1,3,0,4,2,5.0,6.0
17529,2017-2018,15,Willem II,NAC Breda,1,1,3,1,1,2,0,6.0,5.0
17530,2017-2018,15,sc Heerenveen,VVV-Venlo,2,2,3,1,1,4,0,5.0,4.0
17531,2017-2018,15,AZ Alkmaar,Heracles Almelo,5,0,1,3,0,5,5,15.0,6.0
17532,2017-2018,15,SBV Excelsior,PEC Zwolle,1,2,2,0,3,3,-1,3.0,8.0
17533,2017-2018,15,FC Twente,ADO Den Haag,2,3,2,0,3,5,-1,1.0,7.0
17534,2017-2018,15,Roda JC Kerkrade,FC Groningen,2,2,3,1,1,4,0,4.0,7.0
17535,2017-2018,15,AFC Ajax,PSV,3,0,1,3,0,3,3,10.0,12.0
17536,2017-2018,15,Sparta Rotterdam,Vitesse,0,1,2,0,3,1,-1,2.0,7.0
17537,2017-2018,15,FC Utrecht,Feyenoord,1,1,3,1,1,2,0,11.0,9.0
17538,2017-2018,16,NAC Breda,FC Twente,1,2,2,0,3,3,-1,4.0,4.0
17539,2017-2018,16,PEC Zwolle,AZ Alkmaar,1,1,3,1,1,2,0,8.0,13.0
17540,2017-2018,16,Vitesse,Willem II,2,2,3,1,1,4,0,7.0,7.0
17541,2017-2018,16,FC Groningen,PSV,3,3,3,1,1,6,0,8.0,10.0
17542,2017-2018,16,VVV-Venlo,FC Utrecht,0,1,2,0,3,1,-1,3.0,11.0
17543,2017-2018,16,Feyenoord,sc Heerenveen,1,1,3,1,1,2,0,9.0,5.0
17544,2017-2018,16,ADO Den Haag,Roda JC Kerkrade,3,2,1,3,0,5,1,9.0,4.0
17545,2017-2018,16,Heracles Almelo,Sparta Rotterdam,3,2,1,3,0,5,1,6.0,1.0
17546,2017-2018,16,AFC Ajax,SBV Excelsior,3,1,1,3,0,4,2,13.0,0.0
17547,2017-2018,17,sc Heerenveen,NAC Breda,1,0,1,3,0,1,1,5.0,4.0
17548,2017-2018,17,Willem II,PEC Zwolle,2,3,2,0,3,5,-1,6.0,11.0
17549,2017-2018,17,PSV,ADO Den Haag,3,0,1,3,0,3,3,10.0,6.0
17550,2017-2018,17,FC Twente,Vitesse,1,1,3,1,1,2,0,5.0,8.0
17551,2017-2018,17,Roda JC Kerkrade,VVV-Venlo,0,1,2,0,3,1,-1,4.0,5.0
17552,2017-2018,17,Sparta Rotterdam,Feyenoord,0,7,2,0,3,7,-7,0.0,11.0
17553,2017-2018,17,FC Utrecht,Heracles Almelo,1,1,3,1,1,2,0,9.0,7.0
17554,2017-2018,17,AZ Alkmaar,AFC Ajax,1,2,2,0,3,3,-1,10.0,13.0
17555,2017-2018,17,SBV Excelsior,FC Groningen,2,0,1,3,0,2,2,3.0,5.0
17556,2017-2018,18,ADO Den Haag,PEC Zwolle,4,0,1,3,0,4,4,9.0,8.0
17557,2017-2018,18,NAC Breda,FC Utrecht,3,1,1,3,0,4,2,7.0,6.0
17558,2017-2018,18,AZ Alkmaar,sc Heerenveen,3,1,1,3,0,4,2,10.0,5.0
17559,2017-2018,18,PSV,Vitesse,2,1,1,3,0,3,1,10.0,5.0
17560,2017-2018,18,SBV Excelsior,FC Twente,0,0,3,1,1,0,0,4.0,6.0
17561,2017-2018,18,FC Groningen,Sparta Rotterdam,4,0,1,3,0,4,4,8.0,0.0
17562,2017-2018,18,VVV-Venlo,Heracles Almelo,3,1,1,3,0,4,2,7.0,4.0
17563,2017-2018,18,AFC Ajax,Willem II,3,1,1,3,0,4,2,13.0,5.0
17564,2017-2018,18,Feyenoord,Roda JC Kerkrade,5,1,1,3,0,6,4,11.0,4.0
17565,2017-2018,19,FC Utrecht,AZ Alkmaar,1,1,3,1,1,2,0,6.0,8.0
17566,2017-2018,19,Roda JC Kerkrade,FC Twente,1,1,3,1,1,2,0,2.0,6.0
17567,2017-2018,19,PEC Zwolle,NAC Breda,1,0,1,3,0,1,1,10.0,4.0
17568,2017-2018,19,ADO Den Haag,VVV-Venlo,1,1,3,1,1,2,0,10.0,8.0
17569,2017-2018,19,Vitesse,sc Heerenveen,1,1,3,1,1,2,0,6.0,6.0
17570,2017-2018,19,Sparta Rotterdam,SBV Excelsior,2,3,2,0,3,5,-1,0.0,7.0
17571,2017-2018,19,Willem II,FC Groningen,1,1,3,1,1,2,0,3.0,6.0
17572,2017-2018,19,AFC Ajax,Feyenoord,2,0,1,3,0,2,2,15.0,8.0
17573,2017-2018,19,Heracles Almelo,PSV,1,2,2,0,3,3,-1,4.0,10.0
17574,2017-2018,20,sc Heerenveen,Sparta Rotterdam,2,1,1,3,0,3,1,8.0,0.0
17575,2017-2018,20,FC Groningen,Heracles Almelo,3,3,3,1,1,6,0,6.0,5.0
17576,2017-2018,20,FC Twente,PSV,0,2,2,0,3,2,-2,6.0,13.0
17577,2017-2018,20,PEC Zwolle,Vitesse,1,2,2,0,3,3,-1,7.0,6.0
17578,2017-2018,20,NAC Breda,VVV-Venlo,0,1,2,0,3,1,-1,3.0,10.0
17579,2017-2018,20,FC Utrecht,AFC Ajax,0,0,3,1,1,0,0,6.0,13.0
17580,2017-2018,20,Feyenoord,ADO Den Haag,3,1,1,3,0,4,2,10.0,7.0
17581,2017-2018,20,Roda JC Kerkrade,SBV Excelsior,2,1,1,3,0,3,1,4.0,7.0
17582,2017-2018,20,Willem II,AZ Alkmaar,0,2,2,0,3,2,-2,2.0,8.0
17583,2017-2018,21,Vitesse,FC Groningen,2,0,1,3,0,2,2,8.0,5.0
17584,2017-2018,21,sc Heerenveen,FC Twente,1,0,1,3,0,1,1,10.0,3.0
17585,2017-2018,21,PSV,PEC Zwolle,4,0,1,3,0,4,4,15.0,6.0
17586,2017-2018,21,Heracles Almelo,ADO Den Haag,1,1,3,1,1,2,0,3.0,5.0
17587,2017-2018,21,SBV Excelsior,FC Utrecht,2,2,3,1,1,4,0,8.0,4.0
17588,2017-2018,21,AZ Alkmaar,Roda JC Kerkrade,2,2,3,1,1,4,0,8.0,5.0
17589,2017-2018,21,Sparta Rotterdam,Willem II,1,0,1,3,0,1,1,3.0,1.0
17590,2017-2018,21,VVV-Venlo,Feyenoord,1,0,1,3,0,1,1,13.0,9.0
17591,2017-2018,21,AFC Ajax,NAC Breda,3,1,1,3,0,4,2,13.0,3.0
17592,2017-2018,22,PEC Zwolle,sc Heerenveen,3,2,1,3,0,5,1,6.0,7.0
17593,2017-2018,22,FC Twente,AZ Alkmaar,0,4,2,0,3,4,-4,2.0,11.0
17594,2017-2018,22,FC Utrecht,Sparta Rotterdam,1,0,1,3,0,1,1,6.0,3.0
17595,2017-2018,22,PSV,SBV Excelsior,1,0,1,3,0,1,1,15.0,5.0
17596,2017-2018,22,Willem II,VVV-Venlo,3,0,1,3,0,3,3,4.0,10.0
17597,2017-2018,22,NAC Breda,Heracles Almelo,6,1,1,3,0,7,5,6.0,2.0
17598,2017-2018,22,Roda JC Kerkrade,AFC Ajax,2,4,2,0,3,6,-2,5.0,13.0
17599,2017-2018,22,ADO Den Haag,Vitesse,1,0,1,3,0,1,1,8.0,7.0
17600,2017-2018,22,Feyenoord,FC Groningen,3,0,1,3,0,3,3,9.0,5.0
17601,2017-2018,23,Heracles Almelo,Willem II,1,0,1,3,0,1,1,5.0,4.0
17602,2017-2018,23,FC Utrecht,PEC Zwolle,2,1,1,3,0,3,1,9.0,6.0
17603,2017-2018,23,Sparta Rotterdam,PSV,1,2,2,0,3,3,-1,3.0,15.0
17604,2017-2018,23,sc Heerenveen,Roda JC Kerkrade,1,1,3,1,1,2,0,8.0,6.0
17605,2017-2018,23,AZ Alkmaar,VVV-Venlo,0,0,3,1,1,0,0,9.0,8.0
17606,2017-2018,23,AFC Ajax,FC Twente,2,1,1,3,0,3,1,13.0,1.0
17607,2017-2018,23,Vitesse,Feyenoord,3,1,1,3,0,4,2,10.0,6.0
17608,2017-2018,23,SBV Excelsior,NAC Breda,0,0,3,1,1,0,0,5.0,4.0
17609,2017-2018,23,FC Groningen,ADO Den Haag,0,0,3,1,1,0,0,3.0,6.0
17610,2017-2018,24,VVV-Venlo,FC Groningen,1,1,3,1,1,2,0,8.0,3.0
17611,2017-2018,24,Vitesse,SBV Excelsior,1,2,2,0,3,3,-1,9.0,5.0
17612,2017-2018,24,NAC Breda,AZ Alkmaar,1,3,2,0,3,4,-2,4.0,11.0
17613,2017-2018,24,PSV,sc Heerenveen,2,2,3,1,1,4,0,13.0,8.0
17614,2017-2018,24,ADO Den Haag,Willem II,2,1,1,3,0,3,1,8.0,3.0
17615,2017-2018,24,Roda JC Kerkrade,FC Utrecht,1,4,2,0,3,5,-3,5.0,11.0
17616,2017-2018,24,Feyenoord,Heracles Almelo,1,0,1,3,0,1,1,9.0,5.0
17617,2017-2018,24,FC Twente,Sparta Rotterdam,1,1,3,1,1,2,0,1.0,4.0
17618,2017-2018,24,PEC Zwolle,AFC Ajax,0,1,2,0,3,1,-1,3.0,13.0
17619,2017-2018,25,FC Groningen,NAC Breda,1,1,3,1,1,2,0,3.0,5.0
17620,2017-2018,25,AZ Alkmaar,Sparta Rotterdam,2,1,1,3,0,3,1,11.0,4.0
17621,2017-2018,25,sc Heerenveen,SBV Excelsior,0,1,2,0,3,1,-1,5.0,8.0
17622,2017-2018,25,Heracles Almelo,PEC Zwolle,2,1,1,3,0,3,1,7.0,3.0
17623,2017-2018,25,VVV-Venlo,Vitesse,2,2,3,1,1,4,0,6.0,7.0
17624,2017-2018,25,AFC Ajax,ADO Den Haag,0,0,3,1,1,0,0,13.0,9.0
17625,2017-2018,25,Feyenoord,PSV,1,3,2,0,3,4,-2,6.0,13.0
17626,2017-2018,25,Willem II,Roda JC Kerkrade,1,0,1,3,0,1,1,6.0,2.0
17627,2017-2018,25,FC Utrecht,FC Twente,3,1,1,3,0,4,2,13.0,1.0
17628,2017-2018,26,Roda JC Kerkrade,Heracles Almelo,0,3,2,0,3,3,-3,1.0,9.0
17629,2017-2018,26,PSV,FC Utrecht,3,0,1,3,0,3,3,13.0,12.0
17630,2017-2018,26,SBV Excelsior,AZ Alkmaar,1,2,2,0,3,3,-1,7.0,13.0
17631,2017-2018,26,sc Heerenveen,Willem II,2,0,1,3,0,2,2,5.0,6.0
17632,2017-2018,26,NAC Breda,Feyenoord,2,1,1,3,0,3,1,8.0,6.0
17633,2017-2018,26,PEC Zwolle,VVV-Venlo,1,1,3,1,1,2,0,4.0,4.0
17634,2017-2018,26,Sparta Rotterdam,ADO Den Haag,2,1,1,3,0,3,1,4.0,8.0
17635,2017-2018,26,Vitesse,AFC Ajax,3,2,1,3,0,5,1,7.0,10.0
17636,2017-2018,26,FC Twente,FC Groningen,1,1,3,1,1,2,0,2.0,4.0
17637,2017-2018,27,Heracles Almelo,FC Twente,2,1,1,3,0,3,1,12.0,2.0
17638,2017-2018,27,ADO Den Haag,NAC Breda,0,2,2,0,3,2,-2,5.0,8.0
17639,2017-2018,27,VVV-Venlo,SBV Excelsior,2,3,2,0,3,5,-1,4.0,10.0
17640,2017-2018,27,Willem II,PSV,5,0,1,3,0,5,5,6.0,10.0
17641,2017-2018,27,Roda JC Kerkrade,Sparta Rotterdam,0,2,2,0,3,2,-2,1.0,7.0
17642,2017-2018,27,FC Groningen,PEC Zwolle,2,0,1,3,0,2,2,7.0,1.0
17643,2017-2018,27,FC Utrecht,Vitesse,5,1,1,3,0,6,4,12.0,7.0
17644,2017-2018,27,AFC Ajax,sc Heerenveen,4,1,1,3,0,5,3,10.0,5.0
17645,2017-2018,27,Feyenoord,AZ Alkmaar,2,1,1,3,0,3,1,6.0,10.0
17646,2017-2018,28,SBV Excelsior,ADO Den Haag,1,2,2,0,3,3,-1,9.0,7.0
17647,2017-2018,28,FC Twente,Willem II,2,2,3,1,1,4,0,3.0,7.0
17648,2017-2018,28,PSV,VVV-Venlo,3,0,1,3,0,3,3,10.0,3.0
17649,2017-2018,28,Vitesse,Heracles Almelo,0,0,3,1,1,0,0,5.0,10.0
17650,2017-2018,28,sc Heerenveen,FC Utrecht,2,2,3,1,1,4,0,5.0,10.0
17651,2017-2018,28,AZ Alkmaar,FC Groningen,3,2,1,3,0,5,1,12.0,6.0
17652,2017-2018,28,Sparta Rotterdam,AFC Ajax,2,5,2,0,3,7,-3,7.0,10.0
17653,2017-2018,28,NAC Breda,Roda JC Kerkrade,0,1,2,0,3,1,-1,7.0,3.0
17654,2017-2018,28,PEC Zwolle,Feyenoord,3,4,2,0,3,7,-1,1.0,9.0
17655,2017-2018,29,PEC Zwolle,Sparta Rotterdam,2,0,1,3,0,2,2,4.0,6.0
17656,2017-2018,29,Vitesse,Roda JC Kerkrade,0,3,2,0,3,3,-3,5.0,6.0
17657,2017-2018,29,PSV,NAC Breda,5,1,1,3,0,6,4,12.0,7.0
17658,2017-2018,29,Willem II,FC Utrecht,3,2,1,3,0,5,1,10.0,7.0
17659,2017-2018,29,ADO Den Haag,AZ Alkmaar,0,3,2,0,3,3,-3,4.0,12.0
17660,2017-2018,29,VVV-Venlo,FC Twente,0,0,3,1,1,0,0,3.0,3.0
17661,2017-2018,29,Heracles Almelo,sc Heerenveen,1,2,2,0,3,3,-1,10.0,7.0
17662,2017-2018,29,FC Groningen,AFC Ajax,1,2,2,0,3,3,-1,5.0,10.0
17663,2017-2018,29,Feyenoord,SBV Excelsior,5,0,1,3,0,5,5,9.0,6.0
17664,2017-2018,30,SBV Excelsior,Willem II,2,1,1,3,0,3,1,6.0,7.0
17665,2017-2018,30,NAC Breda,Vitesse,1,0,1,3,0,1,1,9.0,4.0
17666,2017-2018,30,Roda JC Kerkrade,PEC Zwolle,3,2,1,3,0,5,1,9.0,4.0
17667,2017-2018,30,AZ Alkmaar,PSV,2,3,2,0,3,5,-1,9.0,12.0
17668,2017-2018,30,Sparta Rotterdam,VVV-Venlo,3,2,1,3,0,5,1,9.0,2.0
17669,2017-2018,30,FC Utrecht,ADO Den Haag,3,3,3,1,1,6,0,5.0,4.0
17670,2017-2018,30,FC Twente,Feyenoord,1,3,2,0,3,4,-2,3.0,12.0
17671,2017-2018,30,sc Heerenveen,FC Groningen,1,1,3,1,1,2,0,8.0,5.0
17672,2017-2018,30,AFC Ajax,Heracles Almelo,1,0,1,3,0,1,1,12.0,7.0
17673,2017-2018,31,Heracles Almelo,AZ Alkmaar,0,3,2,0,3,3,-3,4.0,9.0
17674,2017-2018,31,ADO Den Haag,FC Twente,2,1,1,3,0,3,1,7.0,2.0
17675,2017-2018,31,Vitesse,Sparta Rotterdam,7,0,1,3,0,7,7,4.0,6.0
17676,2017-2018,31,VVV-Venlo,sc Heerenveen,0,2,2,0,3,2,-2,1.0,8.0
17677,2017-2018,31,PEC Zwolle,SBV Excelsior,1,1,3,1,1,2,0,4.0,7.0
17678,2017-2018,31,NAC Breda,Willem II,1,2,2,0,3,3,-1,6.0,10.0
17679,2017-2018,31,Feyenoord,FC Utrecht,3,1,1,3,0,4,2,15.0,5.0
17680,2017-2018,31,FC Groningen,Roda JC Kerkrade,2,1,1,3,0,3,1,7.0,9.0
17681,2017-2018,31,PSV,AFC Ajax,3,0,1,3,0,3,3,12.0,12.0
17682,2017-2018,32,FC Twente,PEC Zwolle,2,0,1,3,0,2,2,5.0,4.0
17683,2017-2018,32,sc Heerenveen,ADO Den Haag,2,0,1,3,0,2,2,11.0,7.0
17684,2017-2018,32,AZ Alkmaar,Vitesse,4,3,1,3,0,7,1,12.0,4.0
17685,2017-2018,32,Roda JC Kerkrade,PSV,2,2,3,1,1,4,0,10.0,13.0
17686,2017-2018,32,SBV Excelsior,Heracles Almelo,2,2,3,1,1,4,0,5.0,2.0
17687,2017-2018,32,Sparta Rotterdam,NAC Breda,2,1,1,3,0,3,1,6.0,3.0
17688,2017-2018,32,Willem II,Feyenoord,1,5,2,0,3,6,-4,7.0,15.0
17689,2017-2018,32,FC Utrecht,FC Groningen,1,1,3,1,1,2,0,3.0,5.0
17690,2017-2018,32,AFC Ajax,VVV-Venlo,4,1,1,3,0,5,3,12.0,1.0
17691,2017-2018,33,Feyenoord,Sparta Rotterdam,3,1,1,3,0,4,2,15.0,6.0
17692,2017-2018,33,NAC Breda,sc Heerenveen,3,0,1,3,0,3,3,6.0,10.0
17693,2017-2018,33,PEC Zwolle,Willem II,0,1,2,0,3,1,-1,4.0,9.0
17694,2017-2018,33,AFC Ajax,AZ Alkmaar,3,0,1,3,0,3,3,12.0,9.0
17695,2017-2018,33,Heracles Almelo,FC Utrecht,2,2,3,1,1,4,0,2.0,3.0
17696,2017-2018,33,Vitesse,FC Twente,5,0,1,3,0,5,5,6.0,4.0
17697,2017-2018,33,VVV-Venlo,Roda JC Kerkrade,1,4,2,0,3,5,-3,1.0,10.0
17698,2017-2018,33,FC Groningen,SBV Excelsior,4,0,1,3,0,4,4,8.0,5.0
17699,2017-2018,33,ADO Den Haag,PSV,3,3,3,1,1,6,0,5.0,11.0
17700,2017-2018,34,sc Heerenveen,Feyenoord,2,3,2,0,3,5,-1,7.0,15.0
17701,2017-2018,34,FC Utrecht,VVV-Venlo,1,0,1,3,0,1,1,6.0,0.0
17702,2017-2018,34,Sparta Rotterdam,Heracles Almelo,2,5,2,0,3,7,-3,6.0,5.0
17703,2017-2018,34,AZ Alkmaar,PEC Zwolle,6,0,1,3,0,6,6,9.0,1.0
17704,2017-2018,34,Willem II,Vitesse,2,2,3,1,1,4,0,7.0,7.0
17705,2017-2018,34,PSV,FC Groningen,0,0,3,1,1,0,0,9.0,9.0
17706,2017-2018,34,SBV Excelsior,AFC Ajax,1,2,2,0,3,3,-1,5.0,12.0
17707,2017-2018,34,Roda JC Kerkrade,ADO Den Haag,2,3,2,0,3,5,-1,7.0,8.0
17708,2017-2018,34,FC Twente,NAC Breda,1,1,3,1,1,2,0,4.0,7.0
17709,2018-2019,1,PEC Zwolle,sc Heerenveen,2,3,2,0,3,5,-1,1.0,9.0
17710,2018-2019,1,Willem II,VVV-Venlo,0,1,2,0,3,1,-1,7.0,3.0
17711,2018-2019,1,AFC Ajax,Heracles Almelo,1,1,3,1,1,2,0,10.0,6.0
17712,2018-2019,1,PSV,FC Utrecht,4,0,1,3,0,4,4,9.0,5.0
17713,2018-2019,1,SBV Excelsior,Fortuna Sittard,1,1,3,1,1,2,0,3.0,4.0
17714,2018-2019,1,ADO Den Haag,FC Emmen,1,2,2,0,3,3,-1,7.0,
17715,2018-2019,1,De Graafschap,Feyenoord,2,0,1,3,0,2,2,8.0,12.0
17716,2018-2019,1,Vitesse,FC Groningen,5,1,1,3,0,6,4,10.0,8.0
17717,2018-2019,1,AZ Alkmaar,NAC Breda,5,0,1,3,0,5,5,12.0,4.0
17718,2018-2019,2,FC Groningen,Willem II,0,1,2,0,3,1,-1,5.0,7.0
17719,2018-2019,2,NAC Breda,De Graafschap,3,0,1,3,0,3,3,7.0,7.0
17720,2018-2019,2,VVV-Venlo,AFC Ajax,0,1,2,0,3,1,-1,3.0,13.0
17721,2018-2019,2,Fortuna Sittard,PSV,1,2,2,0,3,3,-1,4.0,9.0
17722,2018-2019,2,Heracles Almelo,ADO Den Haag,4,2,1,3,0,6,2,9.0,4.0
17723,2018-2019,2,FC Utrecht,PEC Zwolle,2,0,1,3,0,2,2,8.0,0.0
17724,2018-2019,2,Feyenoord,SBV Excelsior,3,0,1,3,0,3,3,12.0,2.0
17725,2018-2019,2,FC Emmen,AZ Alkmaar,1,4,2,0,3,5,-3,,12.0
17726,2018-2019,2,sc Heerenveen,Vitesse,1,1,3,1,1,2,0,7.0,8.0
17727,2018-2019,3,ADO Den Haag,Fortuna Sittard,3,1,1,3,0,4,2,7.0,1.0
17728,2018-2019,3,AFC Ajax,FC Emmen,5,0,1,3,0,5,5,13.0,
17729,2018-2019,3,De Graafschap,FC Groningen,0,1,2,0,3,1,-1,4.0,7.0
17730,2018-2019,3,NAC Breda,SBV Excelsior,0,2,2,0,3,2,-2,7.0,4.0
17731,2018-2019,3,PEC Zwolle,PSV,1,2,2,0,3,3,-1,0.0,11.0
17732,2018-2019,3,Willem II,Heracles Almelo,5,0,1,3,0,5,5,10.0,8.0
17733,2018-2019,3,sc Heerenveen,Feyenoord,3,5,2,0,3,8,-2,4.0,12.0
17734,2018-2019,3,FC Utrecht,VVV-Venlo,1,1,3,1,1,2,0,8.0,4.0
17735,2018-2019,3,AZ Alkmaar,Vitesse,0,0,3,1,1,0,0,10.0,9.0
17736,2018-2019,4,FC Emmen,De Graafschap,1,1,3,1,1,2,0,,5.0
17737,2018-2019,4,VVV-Venlo,sc Heerenveen,1,1,3,1,1,2,0,5.0,5.0
17738,2018-2019,4,PSV,Willem II,6,1,1,3,0,7,5,13.0,7.0
17739,2018-2019,4,SBV Excelsior,ADO Den Haag,2,4,2,0,3,6,-2,4.0,9.0
17740,2018-2019,4,Fortuna Sittard,FC Utrecht,1,1,3,1,1,2,0,2.0,8.0
17741,2018-2019,4,FC Groningen,PEC Zwolle,0,1,2,0,3,1,-1,4.0,3.0
17742,2018-2019,4,Heracles Almelo,AZ Alkmaar,3,2,1,3,0,5,1,10.0,10.0
17743,2018-2019,4,Vitesse,AFC Ajax,0,4,2,0,3,4,-4,6.0,13.0
17744,2018-2019,4,Feyenoord,NAC Breda,4,2,1,3,0,6,2,12.0,4.0
17745,2018-2019,5,De Graafschap,VVV-Venlo,1,2,2,0,3,3,-1,4.0,8.0
17746,2018-2019,5,ADO Den Haag,PSV,0,7,2,0,3,7,-7,6.0,15.0
17747,2018-2019,5,Willem II,SBV Excelsior,2,2,3,1,1,4,0,7.0,5.0
17748,2018-2019,5,AFC Ajax,FC Groningen,3,0,1,3,0,3,3,13.0,3.0
17749,2018-2019,5,AZ Alkmaar,Feyenoord,1,1,3,1,1,2,0,8.0,10.0
17750,2018-2019,5,sc Heerenveen,Heracles Almelo,3,5,2,0,3,8,-2,5.0,10.0
17751,2018-2019,5,FC Utrecht,FC Emmen,1,2,2,0,3,3,-1,5.0,7.0
17752,2018-2019,5,NAC Breda,Fortuna Sittard,2,3,2,0,3,5,-1,3.0,5.0
17753,2018-2019,5,PEC Zwolle,Vitesse,0,2,2,0,3,2,-2,3.0,8.0
17754,2018-2019,6,Heracles Almelo,De Graafschap,4,0,1,3,0,4,4,12.0,1.0
17755,2018-2019,6,Fortuna Sittard,Willem II,4,4,3,1,1,8,0,5.0,8.0
17756,2018-2019,6,SBV Excelsior,sc Heerenveen,3,3,3,1,1,6,0,5.0,3.0
17757,2018-2019,6,VVV-Venlo,NAC Breda,3,0,1,3,0,3,3,8.0,3.0
17758,2018-2019,6,Vitesse,ADO Den Haag,1,1,3,1,1,2,0,6.0,7.0
17759,2018-2019,6,Feyenoord,FC Utrecht,1,0,1,3,0,1,1,13.0,5.0
17760,2018-2019,6,FC Emmen,PEC Zwolle,0,1,2,0,3,1,-1,4.0,6.0
17761,2018-2019,6,FC Groningen,AZ Alkmaar,1,3,2,0,3,4,-2,3.0,8.0
17762,2018-2019,6,PSV,AFC Ajax,3,0,1,3,0,3,3,15.0,12.0
17763,2018-2019,7,sc Heerenveen,ADO Den Haag,1,1,3,1,1,2,0,3.0,8.0
17764,2018-2019,7,NAC Breda,PSV,0,2,2,0,3,2,-2,0.0,15.0
17765,2018-2019,7,Fortuna Sittard,AFC Ajax,0,2,2,0,3,2,-2,5.0,12.0
17766,2018-2019,7,SBV Excelsior,VVV-Venlo,1,0,1,3,0,1,1,8.0,8.0
17767,2018-2019,7,Heracles Almelo,FC Emmen,2,1,1,3,0,3,1,12.0,4.0
17768,2018-2019,7,De Graafschap,Willem II,2,1,1,3,0,3,1,4.0,5.0
17769,2018-2019,7,AZ Alkmaar,PEC Zwolle,2,2,3,1,1,4,0,6.0,7.0
17770,2018-2019,7,FC Groningen,FC Utrecht,1,1,3,1,1,2,0,4.0,3.0
17771,2018-2019,7,Feyenoord,Vitesse,2,1,1,3,0,3,1,13.0,5.0
17772,2018-2019,8,FC Utrecht,NAC Breda,2,1,1,3,0,3,1,5.0,0.0
17773,2018-2019,8,ADO Den Haag,FC Groningen,1,0,1,3,0,1,1,8.0,1.0
17774,2018-2019,8,PEC Zwolle,SBV Excelsior,2,0,1,3,0,2,2,10.0,5.0
17775,2018-2019,8,PSV,VVV-Venlo,4,0,1,3,0,4,4,15.0,7.0
17776,2018-2019,8,De Graafschap,sc Heerenveen,0,5,2,0,3,5,-5,4.0,6.0
17777,2018-2019,8,FC Emmen,Fortuna Sittard,3,3,3,1,1,6,0,5.0,6.0
17778,2018-2019,8,Willem II,Feyenoord,1,1,3,1,1,2,0,3.0,11.0
17779,2018-2019,8,Vitesse,Heracles Almelo,4,0,1,3,0,4,4,7.0,12.0
17780,2018-2019,8,AFC Ajax,AZ Alkmaar,5,0,1,3,0,5,5,12.0,5.0
17781,2018-2019,9,PSV,FC Emmen,6,0,1,3,0,6,6,15.0,4.0
17782,2018-2019,9,SBV Excelsior,Vitesse,2,0,1,3,0,2,2,8.0,7.0
17783,2018-2019,9,sc Heerenveen,AFC Ajax,0,4,2,0,3,4,-4,5.0,12.0
17784,2018-2019,9,FC Utrecht,AZ Alkmaar,2,1,1,3,0,3,1,7.0,5.0
17785,2018-2019,9,NAC Breda,Willem II,2,2,3,1,1,4,0,1.0,4.0
17786,2018-2019,9,Heracles Almelo,FC Groningen,4,1,1,3,0,5,3,12.0,1.0
17787,2018-2019,9,Feyenoord,PEC Zwolle,3,0,1,3,0,3,3,11.0,7.0
17788,2018-2019,9,VVV-Venlo,ADO Den Haag,2,0,1,3,0,2,2,9.0,5.0
17789,2018-2019,9,Fortuna Sittard,De Graafschap,3,1,1,3,0,4,2,8.0,3.0
17790,2018-2019,10,FC Emmen,VVV-Venlo,1,1,3,1,1,2,0,2.0,7.0
17791,2018-2019,10,ADO Den Haag,NAC Breda,1,1,3,1,1,2,0,6.0,2.0
17792,2018-2019,10,De Graafschap,SBV Excelsior,4,1,1,3,0,5,3,6.0,7.0
17793,2018-2019,10,FC Groningen,PSV,1,2,2,0,3,3,-1,1.0,15.0
17794,2018-2019,10,PEC Zwolle,Heracles Almelo,1,1,3,1,1,2,0,8.0,10.0
17795,2018-2019,10,Vitesse,Fortuna Sittard,2,1,1,3,0,3,1,7.0,5.0
17796,2018-2019,10,Willem II,FC Utrecht,0,1,2,0,3,1,-1,3.0,10.0
17797,2018-2019,10,AFC Ajax,Feyenoord,3,0,1,3,0,3,3,12.0,10.0
17798,2018-2019,10,AZ Alkmaar,sc Heerenveen,2,3,2,0,3,5,-1,4.0,8.0
17799,2018-2019,11,SBV Excelsior,FC Groningen,2,4,2,0,3,6,-2,6.0,4.0
17800,2018-2019,11,NAC Breda,Heracles Almelo,2,1,1,3,0,3,1,5.0,7.0
17801,2018-2019,11,PSV,Vitesse,1,0,1,3,0,1,1,15.0,6.0
17802,2018-2019,11,AFC Ajax,Willem II,2,0,1,3,0,2,2,15.0,2.0
17803,2018-2019,11,AZ Alkmaar,De Graafschap,1,0,1,3,0,1,1,4.0,6.0
17804,2018-2019,11,sc Heerenveen,FC Emmen,1,1,3,1,1,2,0,8.0,3.0
17805,2018-2019,11,FC Utrecht,ADO Den Haag,3,0,1,3,0,3,3,13.0,5.0
17806,2018-2019,11,Fortuna Sittard,PEC Zwolle,3,0,1,3,0,3,3,7.0,5.0
17807,2018-2019,11,Feyenoord,VVV-Venlo,4,1,1,3,0,5,3,10.0,4.0
17808,2018-2019,12,PEC Zwolle,Willem II,2,3,2,0,3,5,-1,4.0,5.0
17809,2018-2019,12,FC Emmen,NAC Breda,2,0,1,3,0,2,2,6.0,5.0
17810,2018-2019,12,De Graafschap,PSV,1,4,2,0,3,5,-3,3.0,15.0
17811,2018-2019,12,Vitesse,FC Utrecht,2,1,1,3,0,3,1,9.0,12.0
17812,2018-2019,12,VVV-Venlo,Fortuna Sittard,3,2,1,3,0,5,1,7.0,7.0
17813,2018-2019,12,FC Groningen,sc Heerenveen,2,0,1,3,0,2,2,6.0,7.0
17814,2018-2019,12,SBV Excelsior,AFC Ajax,1,7,2,0,3,8,-6,3.0,15.0
17815,2018-2019,12,ADO Den Haag,AZ Alkmaar,0,1,2,0,3,1,-1,4.0,6.0
17816,2018-2019,12,Heracles Almelo,Feyenoord,0,2,2,0,3,2,-2,4.0,10.0
17817,2018-2019,13,PEC Zwolle,ADO Den Haag,2,3,2,0,3,5,-1,1.0,4.0
17818,2018-2019,13,NAC Breda,AFC Ajax,0,3,2,0,3,3,-3,5.0,15.0
17819,2018-2019,13,PSV,sc Heerenveen,3,0,1,3,0,3,3,15.0,4.0
17820,2018-2019,13,Fortuna Sittard,Heracles Almelo,3,0,1,3,0,3,3,9.0,4.0
17821,2018-2019,13,FC Emmen,SBV Excelsior,1,2,2,0,3,3,-1,5.0,6.0
17822,2018-2019,13,FC Utrecht,De Graafschap,5,0,1,3,0,5,5,12.0,3.0
17823,2018-2019,13,Feyenoord,FC Groningen,1,0,1,3,0,1,1,12.0,6.0
17824,2018-2019,13,Willem II,Vitesse,1,3,2,0,3,4,-2,4.0,9.0
17825,2018-2019,13,VVV-Venlo,AZ Alkmaar,2,2,3,1,1,4,0,8.0,7.0
17826,2018-2019,14,SBV Excelsior,FC Utrecht,3,3,3,1,1,6,0,4.0,10.0
17827,2018-2019,14,Vitesse,FC Emmen,1,1,3,1,1,2,0,10.0,6.0
17828,2018-2019,14,AZ Alkmaar,Willem II,0,2,2,0,3,2,-2,7.0,6.0
17829,2018-2019,14,De Graafschap,PEC Zwolle,0,2,2,0,3,2,-2,3.0,4.0
17830,2018-2019,14,sc Heerenveen,Fortuna Sittard,3,1,1,3,0,4,2,7.0,6.0
17831,2018-2019,14,AFC Ajax,ADO Den Haag,5,1,1,3,0,6,4,15.0,4.0
17832,2018-2019,14,Feyenoord,PSV,2,1,1,3,0,3,1,12.0,12.0
17833,2018-2019,14,Heracles Almelo,VVV-Venlo,4,1,1,3,0,5,3,4.0,5.0
17834,2018-2019,14,FC Groningen,NAC Breda,5,2,1,3,0,7,3,9.0,4.0
17835,2018-2019,15,Fortuna Sittard,AZ Alkmaar,0,3,2,0,3,3,-3,6.0,10.0
17836,2018-2019,15,PSV,SBV Excelsior,6,0,1,3,0,6,6,12.0,4.0
17837,2018-2019,15,Willem II,sc Heerenveen,1,5,2,0,3,6,-4,6.0,7.0
17838,2018-2019,15,PEC Zwolle,AFC Ajax,1,4,2,0,3,5,-3,3.0,15.0
17839,2018-2019,15,ADO Den Haag,De Graafschap,0,0,3,1,1,0,0,4.0,1.0
17840,2018-2019,15,FC Utrecht,Heracles Almelo,3,1,1,3,0,4,2,10.0,3.0
17841,2018-2019,15,VVV-Venlo,FC Groningen,0,0,3,1,1,0,0,5.0,10.0
17842,2018-2019,15,FC Emmen,Feyenoord,1,4,2,0,3,5,-3,5.0,15.0
17843,2018-2019,15,NAC Breda,Vitesse,2,1,1,3,0,3,1,6.0,7.0
17844,2018-2019,16,Willem II,ADO Den Haag,0,3,2,0,3,3,-3,6.0,7.0
17845,2018-2019,16,PEC Zwolle,NAC Breda,0,0,3,1,1,0,0,4.0,4.0
17846,2018-2019,16,AZ Alkmaar,SBV Excelsior,2,1,1,3,0,3,1,10.0,4.0
17847,2018-2019,16,Heracles Almelo,PSV,0,4,2,0,3,4,-4,3.0,12.0
17848,2018-2019,16,Vitesse,VVV-Venlo,2,1,1,3,0,3,1,10.0,5.0
17849,2018-2019,16,sc Heerenveen,FC Utrecht,2,3,2,0,3,5,-1,6.0,10.0
17850,2018-2019,16,AFC Ajax,De Graafschap,8,0,1,3,0,8,8,15.0,1.0
17851,2018-2019,16,FC Groningen,FC Emmen,1,2,2,0,3,3,-1,7.0,7.0
17852,2018-2019,16,Feyenoord,Fortuna Sittard,0,2,2,0,3,2,-2,12.0,6.0
17853,2018-2019,17,VVV-Venlo,PEC Zwolle,2,0,1,3,0,2,2,5.0,4.0
17854,2018-2019,17,Fortuna Sittard,FC Groningen,0,0,3,1,1,0,0,7.0,5.0
17855,2018-2019,17,NAC Breda,sc Heerenveen,4,2,1,3,0,6,2,7.0,6.0
17856,2018-2019,17,PSV,AZ Alkmaar,3,1,1,3,0,4,2,12.0,7.0
17857,2018-2019,17,SBV Excelsior,Heracles Almelo,0,3,2,0,3,3,-3,4.0,6.0
17858,2018-2019,17,FC Utrecht,AFC Ajax,1,3,2,0,3,4,-2,10.0,15.0
17859,2018-2019,17,De Graafschap,Vitesse,2,2,3,1,1,4,0,2.0,8.0
17860,2018-2019,17,ADO Den Haag,Feyenoord,2,2,3,1,1,4,0,8.0,10.0
17861,2018-2019,17,FC Emmen,Willem II,0,2,2,0,3,2,-2,4.0,6.0
17862,2018-2019,18,Vitesse,SBV Excelsior,3,2,1,3,0,5,1,8.0,1.0
17863,2018-2019,18,AZ Alkmaar,FC Utrecht,3,0,1,3,0,3,3,9.0,7.0
17864,2018-2019,18,PEC Zwolle,Feyenoord,3,1,1,3,0,4,2,7.0,7.0
17865,2018-2019,18,ADO Den Haag,VVV-Venlo,2,4,2,0,3,6,-2,5.0,7.0
17866,2018-2019,18,FC Groningen,Heracles Almelo,3,0,1,3,0,3,3,8.0,6.0
17867,2018-2019,18,Willem II,NAC Breda,2,0,1,3,0,2,2,9.0,7.0
17868,2018-2019,18,De Graafschap,Fortuna Sittard,5,1,1,3,0,6,4,5.0,4.0
17869,2018-2019,18,FC Emmen,PSV,2,2,3,1,1,4,0,5.0,10.0
17870,2018-2019,18,AFC Ajax,sc Heerenveen,4,4,3,1,1,8,0,13.0,7.0
17871,2018-2019,19,NAC Breda,ADO Den Haag,1,1,3,1,1,2,0,8.0,6.0
17872,2018-2019,19,Heracles Almelo,PEC Zwolle,0,2,2,0,3,2,-2,3.0,7.0
17873,2018-2019,19,SBV Excelsior,De Graafschap,2,0,1,3,0,2,2,3.0,5.0
17874,2018-2019,19,PSV,FC Groningen,2,1,1,3,0,3,1,13.0,5.0
17875,2018-2019,19,VVV-Venlo,FC Emmen,2,3,2,0,3,5,-1,7.0,7.0
17876,2018-2019,19,Fortuna Sittard,Vitesse,2,1,1,3,0,3,1,7.0,7.0
17877,2018-2019,19,FC Utrecht,Willem II,0,1,2,0,3,1,-1,6.0,9.0
17878,2018-2019,19,Feyenoord,AFC Ajax,6,2,1,3,0,8,4,7.0,10.0
17879,2018-2019,19,sc Heerenveen,AZ Alkmaar,0,2,2,0,3,2,-2,4.0,12.0
17880,2018-2019,20,De Graafschap,NAC Breda,3,0,1,3,0,3,3,7.0,5.0
17881,2018-2019,20,Vitesse,sc Heerenveen,2,2,3,1,1,4,0,8.0,2.0
17882,2018-2019,20,Willem II,FC Groningen,1,2,2,0,3,3,-1,9.0,7.0
17883,2018-2019,20,AFC Ajax,VVV-Venlo,6,0,1,3,0,6,6,10.0,6.0
17884,2018-2019,20,AZ Alkmaar,FC Emmen,5,0,1,3,0,5,5,12.0,7.0
17885,2018-2019,20,SBV Excelsior,Feyenoord,2,1,1,3,0,3,1,6.0,4.0
17886,2018-2019,20,PEC Zwolle,FC Utrecht,4,3,1,3,0,7,1,10.0,3.0
17887,2018-2019,20,PSV,Fortuna Sittard,5,0,1,3,0,5,5,13.0,7.0
17888,2018-2019,20,ADO Den Haag,Heracles Almelo,2,0,1,3,0,2,2,8.0,3.0
17889,2018-2019,21,NAC Breda,AZ Alkmaar,0,3,2,0,3,3,-3,4.0,12.0
17890,2018-2019,21,Heracles Almelo,AFC Ajax,1,0,1,3,0,1,1,6.0,7.0
17891,2018-2019,21,sc Heerenveen,PEC Zwolle,1,1,3,1,1,2,0,3.0,10.0
17892,2018-2019,21,VVV-Venlo,Willem II,2,1,1,3,0,3,1,9.0,9.0
17893,2018-2019,21,Feyenoord,De Graafschap,4,0,1,3,0,4,4,7.0,7.0
17894,2018-2019,21,Fortuna Sittard,SBV Excelsior,4,1,1,3,0,5,3,7.0,6.0
17895,2018-2019,21,FC Groningen,Vitesse,2,1,1,3,0,3,1,10.0,5.0
17896,2018-2019,21,FC Emmen,ADO Den Haag,3,2,1,3,0,5,1,7.0,5.0
17897,2018-2019,21,FC Utrecht,PSV,2,2,3,1,1,4,0,1.0,11.0
17898,2018-2019,22,ADO Den Haag,PEC Zwolle,1,0,1,3,0,1,1,7.0,10.0
17899,2018-2019,22,AZ Alkmaar,VVV-Venlo,3,0,1,3,0,3,3,15.0,6.0
17900,2018-2019,22,sc Heerenveen,PSV,2,2,3,1,1,4,0,4.0,9.0
17901,2018-2019,22,Heracles Almelo,Fortuna Sittard,6,0,1,3,0,6,6,6.0,6.0
17902,2018-2019,22,Vitesse,Willem II,3,2,1,3,0,5,1,7.0,6.0
17903,2018-2019,22,AFC Ajax,NAC Breda,5,0,1,3,0,5,5,7.0,1.0
17904,2018-2019,22,SBV Excelsior,FC Emmen,2,1,1,3,0,3,1,9.0,7.0
17905,2018-2019,22,FC Groningen,Feyenoord,1,0,1,3,0,1,1,12.0,6.0
17906,2018-2019,22,De Graafschap,FC Utrecht,0,1,2,0,3,1,-1,6.0,4.0
17907,2018-2019,23,VVV-Venlo,Heracles Almelo,0,1,2,0,3,1,-1,3.0,9.0
17908,2018-2019,23,FC Utrecht,SBV Excelsior,0,0,3,1,1,0,0,5.0,10.0
17909,2018-2019,23,PEC Zwolle,De Graafschap,0,3,2,0,3,3,-3,7.0,6.0
17910,2018-2019,23,Fortuna Sittard,sc Heerenveen,2,4,2,0,3,6,-2,6.0,6.0
17911,2018-2019,23,NAC Breda,FC Groningen,0,0,3,1,1,0,0,2.0,10.0
17912,2018-2019,23,ADO Den Haag,AFC Ajax,1,5,2,0,3,6,-4,7.0,9.0
17913,2018-2019,23,PSV,Feyenoord,1,1,3,1,1,2,0,9.0,7.0
17914,2018-2019,23,FC Emmen,Vitesse,0,3,2,0,3,3,-3,6.0,7.0
17915,2018-2019,23,Willem II,AZ Alkmaar,2,1,1,3,0,3,1,6.0,12.0
17916,2018-2019,24,De Graafschap,ADO Den Haag,1,1,3,1,1,2,0,7.0,7.0
17917,2018-2019,24,Heracles Almelo,FC Utrecht,1,5,2,0,3,6,-4,9.0,8.0
17918,2018-2019,24,SBV Excelsior,PSV,0,2,2,0,3,2,-2,7.0,9.0
17919,2018-2019,24,Vitesse,NAC Breda,4,1,1,3,0,5,3,10.0,1.0
17920,2018-2019,24,sc Heerenveen,Willem II,4,2,1,3,0,6,2,9.0,3.0
17921,2018-2019,24,FC Groningen,VVV-Venlo,3,2,1,3,0,5,1,13.0,3.0
17922,2018-2019,24,AZ Alkmaar,Fortuna Sittard,4,2,1,3,0,6,2,12.0,3.0
17923,2018-2019,24,Feyenoord,FC Emmen,4,0,1,3,0,4,4,7.0,3.0
17924,2018-2019,24,AFC Ajax,PEC Zwolle,2,1,1,3,0,3,1,12.0,4.0
17925,2018-2019,25,FC Utrecht,FC Groningen,0,0,3,1,1,0,0,9.0,11.0
17926,2018-2019,25,VVV-Venlo,SBV Excelsior,1,0,1,3,0,1,1,6.0,4.0
17927,2018-2019,25,PSV,NAC Breda,2,0,1,3,0,2,2,9.0,1.0
17928,2018-2019,25,ADO Den Haag,sc Heerenveen,2,3,2,0,3,5,-1,4.0,11.0
17929,2018-2019,25,Willem II,De Graafschap,3,2,1,3,0,5,1,6.0,4.0
17930,2018-2019,25,PEC Zwolle,AZ Alkmaar,0,0,3,1,1,0,0,2.0,10.0
17931,2018-2019,25,Vitesse,Feyenoord,1,1,3,1,1,2,0,10.0,8.0
17932,2018-2019,25,FC Emmen,Heracles Almelo,1,1,3,1,1,2,0,4.0,10.0
17933,2018-2019,25,AFC Ajax,Fortuna Sittard,4,0,1,3,0,4,4,12.0,3.0
17934,2018-2019,26,Fortuna Sittard,FC Emmen,3,1,1,3,0,4,2,3.0,1.0
17935,2018-2019,26,sc Heerenveen,De Graafschap,0,3,2,0,3,3,-3,10.0,7.0
17936,2018-2019,26,Feyenoord,Willem II,2,3,2,0,3,5,-1,5.0,9.0
17937,2018-2019,26,NAC Breda,FC Utrecht,0,4,2,0,3,4,-4,1.0,11.0
17938,2018-2019,26,Heracles Almelo,Vitesse,3,2,1,3,0,5,1,10.0,10.0
17939,2018-2019,26,VVV-Venlo,PSV,0,1,2,0,3,1,-1,3.0,11.0
17940,2018-2019,26,AZ Alkmaar,AFC Ajax,1,0,1,3,0,1,1,10.0,12.0
17941,2018-2019,26,FC Groningen,ADO Den Haag,1,0,1,3,0,1,1,11.0,4.0
17942,2018-2019,26,SBV Excelsior,PEC Zwolle,0,2,2,0,3,2,-2,4.0,4.0
17943,2018-2019,27,Willem II,Fortuna Sittard,3,2,1,3,0,5,1,12.0,3.0
17944,2018-2019,27,ADO Den Haag,Vitesse,3,3,3,1,1,6,0,2.0,8.0
17945,2018-2019,27,De Graafschap,Heracles Almelo,1,2,2,0,3,3,-1,7.0,10.0
17946,2018-2019,27,sc Heerenveen,SBV Excelsior,1,0,1,3,0,1,1,12.0,1.0
17947,2018-2019,27,AZ Alkmaar,FC Groningen,1,0,1,3,0,1,1,10.0,8.0
17948,2018-2019,27,NAC Breda,VVV-Venlo,1,1,3,1,1,2,0,2.0,4.0
17949,2018-2019,27,FC Utrecht,Feyenoord,3,2,1,3,0,5,1,11.0,5.0
17950,2018-2019,27,PEC Zwolle,FC Emmen,3,0,1,3,0,3,3,7.0,1.0
17951,2018-2019,27,AFC Ajax,PSV,3,1,1,3,0,4,2,12.0,10.0
17952,2018-2019,28,Vitesse,AZ Alkmaar,2,2,3,1,1,4,0,6.0,11.0
17953,2018-2019,28,Heracles Almelo,Willem II,3,4,2,0,3,7,-1,7.0,12.0
17954,2018-2019,28,FC Groningen,De Graafschap,1,0,1,3,0,1,1,10.0,4.0
17955,2018-2019,28,VVV-Venlo,FC Utrecht,2,6,2,0,3,8,-4,4.0,13.0
17956,2018-2019,28,SBV Excelsior,NAC Breda,1,2,2,0,3,3,-1,0.0,4.0
17957,2018-2019,28,Fortuna Sittard,ADO Den Haag,0,0,3,1,1,0,0,4.0,3.0
17958,2018-2019,28,FC Emmen,AFC Ajax,2,5,2,0,3,7,-3,1.0,12.0
17959,2018-2019,28,PSV,PEC Zwolle,4,0,1,3,0,4,4,12.0,7.0
17960,2018-2019,28,Feyenoord,sc Heerenveen,3,0,1,3,0,3,3,7.0,9.0
17961,2018-2019,29,Willem II,AFC Ajax,1,4,2,0,3,5,-3,12.0,12.0
17962,2018-2019,29,ADO Den Haag,FC Utrecht,5,0,1,3,0,5,5,5.0,10.0
17963,2018-2019,29,FC Groningen,SBV Excelsior,1,0,1,3,0,1,1,10.0,0.0
17964,2018-2019,29,De Graafschap,AZ Alkmaar,1,1,3,1,1,2,0,4.0,9.0
17965,2018-2019,29,Heracles Almelo,NAC Breda,1,0,1,3,0,1,1,10.0,4.0
17966,2018-2019,29,FC Emmen,sc Heerenveen,2,0,1,3,0,2,2,4.0,6.0
17967,2018-2019,29,PEC Zwolle,Fortuna Sittard,5,0,1,3,0,5,5,10.0,4.0
17968,2018-2019,29,VVV-Venlo,Feyenoord,0,3,2,0,3,3,-3,4.0,7.0
17969,2018-2019,29,Vitesse,PSV,3,3,3,1,1,6,0,4.0,10.0
17970,2018-2019,30,NAC Breda,FC Emmen,1,1,3,1,1,2,0,5.0,4.0
17971,2018-2019,30,AZ Alkmaar,ADO Den Haag,2,3,2,0,3,5,-1,8.0,8.0
17972,2018-2019,30,AFC Ajax,SBV Excelsior,6,2,1,3,0,8,4,12.0,0.0
17973,2018-2019,30,Feyenoord,Heracles Almelo,2,1,1,3,0,3,1,9.0,9.0
17974,2018-2019,30,Fortuna Sittard,VVV-Venlo,1,1,3,1,1,2,0,5.0,2.0
17975,2018-2019,30,PSV,De Graafschap,2,1,1,3,0,3,1,10.0,4.0
17976,2018-2019,30,Willem II,PEC Zwolle,2,0,1,3,0,2,2,12.0,9.0
17977,2018-2019,30,sc Heerenveen,FC Groningen,1,1,3,1,1,2,0,4.0,10.0
17978,2018-2019,30,FC Utrecht,Vitesse,0,0,3,1,1,0,0,10.0,4.0
17979,2018-2019,31,Heracles Almelo,sc Heerenveen,2,1,1,3,0,3,1,9.0,4.0
17980,2018-2019,31,FC Emmen,FC Utrecht,2,0,1,3,0,2,2,7.0,7.0
17981,2018-2019,31,FC Groningen,AFC Ajax,0,1,2,0,3,1,-1,7.0,15.0
17982,2018-2019,31,Vitesse,PEC Zwolle,4,1,1,3,0,5,3,7.0,6.0
17983,2018-2019,31,Feyenoord,AZ Alkmaar,2,1,1,3,0,3,1,12.0,5.0
17984,2018-2019,31,VVV-Venlo,De Graafschap,4,1,1,3,0,5,3,5.0,1.0
17985,2018-2019,31,SBV Excelsior,Willem II,1,1,3,1,1,2,0,1.0,10.0
17986,2018-2019,31,Fortuna Sittard,NAC Breda,2,1,1,3,0,3,1,5.0,5.0
17987,2018-2019,31,PSV,ADO Den Haag,3,1,1,3,0,4,2,10.0,8.0
17988,2018-2019,32,De Graafschap,FC Emmen,1,0,1,3,0,1,1,4.0,7.0
17989,2018-2019,32,sc Heerenveen,VVV-Venlo,2,2,3,1,1,4,0,2.0,5.0
17990,2018-2019,32,AZ Alkmaar,Heracles Almelo,2,1,1,3,0,3,1,5.0,6.0
17991,2018-2019,32,AFC Ajax,Vitesse,4,2,1,3,0,6,2,15.0,6.0
17992,2018-2019,32,FC Utrecht,Fortuna Sittard,2,1,1,3,0,3,1,7.0,5.0
17993,2018-2019,32,NAC Breda,Feyenoord,0,4,2,0,3,4,-4,4.0,15.0
17994,2018-2019,32,ADO Den Haag,SBV Excelsior,3,1,1,3,0,4,2,10.0,1.0
17995,2018-2019,32,Willem II,PSV,0,3,2,0,3,3,-3,7.0,13.0
17996,2018-2019,32,PEC Zwolle,FC Groningen,3,2,1,3,0,5,1,6.0,7.0
17997,2018-2019,33,FC Utrecht,sc Heerenveen,3,1,1,3,0,4,2,7.0,2.0
17998,2018-2019,33,NAC Breda,PEC Zwolle,0,0,3,1,1,0,0,2.0,7.0
17999,2018-2019,33,PSV,Heracles Almelo,3,1,1,3,0,4,2,13.0,6.0
18000,2018-2019,33,Fortuna Sittard,Feyenoord,1,4,2,0,3,5,-3,4.0,15.0
18001,2018-2019,33,SBV Excelsior,AZ Alkmaar,4,2,1,3,0,6,2,4.0,4.0
18002,2018-2019,33,De Graafschap,AFC Ajax,1,4,2,0,3,5,-3,4.0,15.0
18003,2018-2019,33,VVV-Venlo,Vitesse,1,3,2,0,3,4,-2,5.0,8.0
18004,2018-2019,33,ADO Den Haag,Willem II,6,2,1,3,0,8,4,12.0,4.0
18005,2018-2019,33,FC Emmen,FC Groningen,1,0,1,3,0,1,1,10.0,4.0
18006,2018-2019,34,sc Heerenveen,NAC Breda,2,1,1,3,0,3,1,5.0,2.0
18007,2018-2019,34,Feyenoord,ADO Den Haag,0,2,2,0,3,2,-2,12.0,12.0
18008,2018-2019,34,AZ Alkmaar,PSV,1,0,1,3,0,1,1,6.0,12.0
18009,2018-2019,34,Willem II,FC Emmen,2,3,2,0,3,5,-1,4.0,10.0
18010,2018-2019,34,PEC Zwolle,VVV-Venlo,2,4,2,0,3,6,-2,4.0,8.0
18011,2018-2019,34,AFC Ajax,FC Utrecht,4,1,1,3,0,5,3,15.0,7.0
18012,2018-2019,34,Heracles Almelo,SBV Excelsior,4,5,2,0,3,9,-1,3.0,7.0
18013,2018-2019,34,Vitesse,De Graafschap,6,1,1,3,0,7,5,10.0,3.0
18014,2018-2019,34,FC Groningen,Fortuna Sittard,3,0,1,3,0,3,3,4.0,4.0
18015,2019-2020,1,PEC Zwolle,Willem II,1,3,2,0,3,4,-2,4.0,4.0
18016,2019-2020,1,Vitesse,AFC Ajax,2,2,3,1,1,4,0,10.0,13.0
18017,2019-2020,1,FC Emmen,FC Groningen,0,1,2,0,3,1,-1,9.0,6.0
18018,2019-2020,1,VVV-Venlo,RKC Waalwijk,3,1,1,3,0,4,2,10.0,2.0
18019,2019-2020,1,FC Twente,PSV,1,1,3,1,1,2,0,5.0,10.0
18020,2019-2020,1,Heracles Almelo,sc Heerenveen,0,4,2,0,3,4,-4,3.0,7.0
18021,2019-2020,1,Feyenoord,Sparta Rotterdam,2,2,3,1,1,4,0,10.0,4.0
18022,2019-2020,1,ADO Den Haag,FC Utrecht,2,4,2,0,3,6,-2,9.0,9.0
18023,2019-2020,1,AZ Alkmaar,Fortuna Sittard,4,0,1,3,0,4,4,9.0,3.0
18024,2019-2020,2,Sparta Rotterdam,VVV-Venlo,4,1,1,3,0,5,3,7.0,7.0
18025,2019-2020,2,FC Groningen,FC Twente,1,3,2,0,3,4,-2,6.0,8.0
18026,2019-2020,2,AFC Ajax,FC Emmen,5,0,1,3,0,5,5,13.0,6.0
18027,2019-2020,2,Willem II,Vitesse,0,2,2,0,3,2,-2,3.0,10.0
18028,2019-2020,2,Fortuna Sittard,Heracles Almelo,1,1,3,1,1,2,0,1.0,1.0
18029,2019-2020,2,sc Heerenveen,Feyenoord,1,1,3,1,1,2,0,8.0,8.0
18030,2019-2020,2,RKC Waalwijk,AZ Alkmaar,0,2,2,0,3,2,-2,2.0,12.0
18031,2019-2020,2,FC Utrecht,PEC Zwolle,3,1,1,3,0,4,2,12.0,4.0
18032,2019-2020,2,PSV,ADO Den Haag,3,1,1,3,0,4,2,10.0,9.0
18033,2019-2020,3,Vitesse,PEC Zwolle,3,0,1,3,0,3,3,13.0,1.0
18034,2019-2020,3,ADO Den Haag,Sparta Rotterdam,1,2,2,0,3,3,-1,6.0,7.0
18035,2019-2020,3,VVV-Venlo,AFC Ajax,1,4,2,0,3,5,-3,6.0,13.0
18036,2019-2020,3,FC Emmen,sc Heerenveen,2,0,1,3,0,2,2,9.0,7.0
18037,2019-2020,3,Fortuna Sittard,Willem II,2,3,2,0,3,5,-1,1.0,6.0
18038,2019-2020,3,FC Twente,RKC Waalwijk,3,3,3,1,1,6,0,6.0,2.0
18039,2019-2020,3,Feyenoord,FC Utrecht,1,1,3,1,1,2,0,6.0,10.0
18040,2019-2020,3,AZ Alkmaar,FC Groningen,0,0,3,1,1,0,0,10.0,7.0
18041,2019-2020,3,Heracles Almelo,PSV,0,2,2,0,3,2,-2,1.0,10.0
18042,2019-2020,4,Willem II,FC Emmen,2,1,1,3,0,3,1,9.0,6.0
18043,2019-2020,4,Heracles Almelo,Vitesse,1,1,3,1,1,2,0,2.0,11.0
18044,2019-2020,4,sc Heerenveen,FC Twente,0,0,3,1,1,0,0,8.0,7.0
18045,2019-2020,4,RKC Waalwijk,ADO Den Haag,0,3,2,0,3,3,-3,1.0,6.0
18046,2019-2020,4,FC Utrecht,VVV-Venlo,1,2,2,0,3,3,-1,7.0,9.0
18047,2019-2020,4,PEC Zwolle,Sparta Rotterdam,2,2,3,1,1,4,0,1.0,8.0
18048,2019-2020,4,PSV,FC Groningen,3,1,1,3,0,4,2,10.0,7.0
18049,2019-2020,4,AFC Ajax,Fortuna Sittard,5,0,1,3,0,5,5,13.0,1.0
18050,2019-2020,4,Feyenoord,AZ Alkmaar,0,3,2,0,3,3,-3,3.0,13.0
18051,2019-2020,5,FC Emmen,PEC Zwolle,1,3,2,0,3,4,-2,3.0,4.0
18052,2019-2020,5,sc Heerenveen,Fortuna Sittard,1,1,3,1,1,2,0,6.0,2.0
18053,2019-2020,5,FC Groningen,Heracles Almelo,1,2,2,0,3,3,-1,4.0,5.0
18054,2019-2020,5,ADO Den Haag,VVV-Venlo,1,0,1,3,0,1,1,6.0,6.0
18055,2019-2020,5,FC Twente,FC Utrecht,3,1,1,3,0,4,2,9.0,7.0
18056,2019-2020,5,Sparta Rotterdam,AFC Ajax,1,4,2,0,3,5,-3,8.0,13.0
18057,2019-2020,5,Willem II,Feyenoord,0,1,2,0,3,1,-1,9.0,6.0
18058,2019-2020,5,Vitesse,AZ Alkmaar,2,1,1,3,0,3,1,11.0,10.0
18059,2019-2020,5,RKC Waalwijk,PSV,1,3,2,0,3,4,-2,1.0,13.0
18060,2019-2020,6,AZ Alkmaar,Sparta Rotterdam,5,1,1,3,0,6,4,10.0,7.0
18061,2019-2020,6,AFC Ajax,sc Heerenveen,4,1,1,3,0,5,3,15.0,3.0
18062,2019-2020,6,VVV-Venlo,FC Groningen,2,1,1,3,0,3,1,6.0,1.0
18063,2019-2020,6,PSV,Vitesse,5,0,1,3,0,5,5,15.0,10.0
18064,2019-2020,6,FC Utrecht,FC Emmen,3,1,1,3,0,4,2,7.0,3.0
18065,2019-2020,6,PEC Zwolle,RKC Waalwijk,6,2,1,3,0,8,4,7.0,1.0
18066,2019-2020,6,Feyenoord,ADO Den Haag,3,2,1,3,0,5,1,8.0,6.0
18067,2019-2020,6,Heracles Almelo,Willem II,4,1,1,3,0,5,3,8.0,6.0
18068,2019-2020,6,Fortuna Sittard,FC Twente,2,3,2,0,3,5,-1,2.0,11.0
18069,2019-2020,7,FC Twente,Heracles Almelo,2,3,2,0,3,5,-1,8.0,10.0
18070,2019-2020,7,Sparta Rotterdam,RKC Waalwijk,4,0,1,3,0,4,4,7.0,1.0
18071,2019-2020,7,FC Groningen,PEC Zwolle,2,0,1,3,0,2,2,4.0,7.0
18072,2019-2020,7,Willem II,VVV-Venlo,1,0,1,3,0,1,1,9.0,6.0
18073,2019-2020,7,Vitesse,Fortuna Sittard,4,2,1,3,0,6,2,10.0,1.0
18074,2019-2020,7,sc Heerenveen,FC Utrecht,1,1,3,1,1,2,0,3.0,5.0
18075,2019-2020,7,FC Emmen,Feyenoord,3,3,3,1,1,6,0,4.0,8.0
18076,2019-2020,7,ADO Den Haag,AZ Alkmaar,0,1,2,0,3,1,-1,6.0,10.0
18077,2019-2020,7,PSV,AFC Ajax,1,1,3,1,1,2,0,13.0,13.0
18078,2019-2020,8,FC Emmen,ADO Den Haag,3,0,1,3,0,3,3,4.0,6.0
18079,2019-2020,8,VVV-Venlo,sc Heerenveen,0,3,2,0,3,3,-3,6.0,6.0
18080,2019-2020,8,AFC Ajax,FC Groningen,2,0,1,3,0,2,2,13.0,3.0
18081,2019-2020,8,Fortuna Sittard,Sparta Rotterdam,0,0,3,1,1,0,0,2.0,5.0
18082,2019-2020,8,RKC Waalwijk,Vitesse,1,2,2,0,3,3,-1,0.0,10.0
18083,2019-2020,8,PEC Zwolle,PSV,0,4,2,0,3,4,-4,7.0,13.0
18084,2019-2020,8,FC Utrecht,Willem II,2,0,1,3,0,2,2,7.0,6.0
18085,2019-2020,8,AZ Alkmaar,Heracles Almelo,2,0,1,3,0,2,2,12.0,10.0
18086,2019-2020,8,Feyenoord,FC Twente,5,1,1,3,0,6,4,10.0,7.0
18087,2019-2020,9,FC Groningen,RKC Waalwijk,3,0,1,3,0,3,3,6.0,0.0
18088,2019-2020,9,Heracles Almelo,FC Emmen,2,0,1,3,0,2,2,12.0,4.0
18089,2019-2020,9,Sparta Rotterdam,FC Twente,2,1,1,3,0,3,1,7.0,6.0
18090,2019-2020,9,Vitesse,FC Utrecht,2,1,1,3,0,3,1,12.0,7.0
18091,2019-2020,9,sc Heerenveen,PEC Zwolle,1,0,1,3,0,1,1,8.0,6.0
18092,2019-2020,9,ADO Den Haag,AFC Ajax,0,2,2,0,3,2,-2,3.0,13.0
18093,2019-2020,9,Fortuna Sittard,Feyenoord,4,2,1,3,0,6,2,5.0,10.0
18094,2019-2020,9,PSV,VVV-Venlo,4,1,1,3,0,5,3,13.0,3.0
18095,2019-2020,9,Willem II,AZ Alkmaar,1,1,3,1,1,2,0,4.0,10.0
18096,2019-2020,10,AZ Alkmaar,sc Heerenveen,2,4,2,0,3,6,-2,10.0,10.0
18097,2019-2020,10,RKC Waalwijk,AFC Ajax,1,2,2,0,3,3,-1,0.0,13.0
18098,2019-2020,10,FC Twente,Willem II,0,1,2,0,3,1,-1,3.0,7.0
18099,2019-2020,10,FC Utrecht,PSV,3,0,1,3,0,3,3,10.0,10.0
18100,2019-2020,10,VVV-Venlo,Vitesse,0,4,2,0,3,4,-4,3.0,12.0
18101,2019-2020,10,PEC Zwolle,ADO Den Haag,3,1,1,3,0,4,2,6.0,0.0
18102,2019-2020,10,FC Emmen,Fortuna Sittard,2,1,1,3,0,3,1,7.0,4.0
18103,2019-2020,10,FC Groningen,Sparta Rotterdam,2,0,1,3,0,2,2,9.0,7.0
18104,2019-2020,10,Feyenoord,Heracles Almelo,1,1,3,1,1,2,0,8.0,10.0
18105,2019-2020,11,FC Twente,FC Emmen,4,1,1,3,0,5,3,3.0,7.0
18106,2019-2020,11,Willem II,RKC Waalwijk,2,1,1,3,0,3,1,10.0,0.0
18107,2019-2020,11,Fortuna Sittard,VVV-Venlo,4,1,1,3,0,5,3,7.0,0.0
18108,2019-2020,11,Vitesse,ADO Den Haag,0,2,2,0,3,2,-2,12.0,3.0
18109,2019-2020,11,Heracles Almelo,PEC Zwolle,4,0,1,3,0,4,4,10.0,3.0
18110,2019-2020,11,sc Heerenveen,FC Groningen,1,1,3,1,1,2,0,11.0,10.0
18111,2019-2020,11,PSV,AZ Alkmaar,0,4,2,0,3,4,-4,7.0,10.0
18112,2019-2020,11,Sparta Rotterdam,FC Utrecht,1,2,2,0,3,3,-1,7.0,10.0
18113,2019-2020,11,AFC Ajax,Feyenoord,4,0,1,3,0,4,4,13.0,5.0
18114,2019-2020,12,PEC Zwolle,AFC Ajax,2,4,2,0,3,6,-2,3.0,15.0
18115,2019-2020,12,RKC Waalwijk,Heracles Almelo,2,0,1,3,0,2,2,3.0,7.0
18116,2019-2020,12,Sparta Rotterdam,PSV,2,2,3,1,1,4,0,5.0,7.0
18117,2019-2020,12,AZ Alkmaar,FC Twente,3,0,1,3,0,3,3,10.0,3.0
18118,2019-2020,12,FC Emmen,Vitesse,2,1,1,3,0,3,1,9.0,9.0
18119,2019-2020,12,FC Utrecht,Fortuna Sittard,6,0,1,3,0,6,6,12.0,7.0
18120,2019-2020,12,VVV-Venlo,Feyenoord,0,3,2,0,3,3,-3,0.0,7.0
18121,2019-2020,12,FC Groningen,Willem II,2,0,1,3,0,2,2,10.0,7.0
18122,2019-2020,12,ADO Den Haag,sc Heerenveen,1,1,3,1,1,2,0,4.0,11.0
